uf	pred	sf
gynH	gyni	gyny
konuH	konuɯ	konuu
zɑmɑnDA	zɑmɑntɑ	zɑmɑndɑ
oHn	oɯn	oun
bølymH	bølymi	bølymy
durumH	durumɯ	durumu
biʧimDA	biʧimte	biʧimde
ɑlɑnDA	ɑlɑntɑ	ɑlɑndɑ
dynjɑDA	dynjɑtɑ	dynjɑdɑ
hɑlDA	hɑltɑ	hɑlde
yʧnʤH	yʧnʤi	yʧnʤy
jɑnDAn	jɑntɑn	jɑndɑn
ɑʃɑɰɯDA	ɑʃɑɰɯtɑ	ɑʃɑɰɯdɑ
durumlArDA	durumlɑrtɑ	durumlɑrdɑ
jukɑrɯDA	jukɑrɯtɑ	jukɑrɯdɑ
jyzDAn	jyzten	jyzden
kodH	kodɯ	kodu
sorumlH	sorumlɯ	sorumlu
gynmHzDA	gynmizte	gynmyzde
sorunH	sorunɯ	sorunu
bølgeDA	bølgete	bølgede
olDHklArH	oltɯklɑrɯ	olduklɑrɯ
konulArDA	konulɑrtɑ	konulɑrdɑ
ylkeDA	ylkete	ylkede
sonH	sonɯ	sonu
toplumHn	toplumɯn	toplumun
ɑnlɑmDA	ɑnlɑmtɑ	ɑnlɑmdɑ
dyzejDA	dyzejte	dyzejde
formH	formɯ	formu
enstityH	enstityi	enstityy
kɑnunH	kɑnunɯ	kɑnunu
jerlArDA	jerlerte	jerlerde
sɯrɑDA	sɯrɑtɑ	sɯrɑdɑ
okulH	okulɯ	okulu
jukɑrɯDAki	jukɑrɯtɑki	jukɑrɯdɑki
dereʤeDA	dereʤete	dereʤede
tyrH	tyri	tyry
burɑDAn	burɑtɑn	burɑdɑn
gynlArDA	gynlerte	gynlerde
komisjonH	komisjonɯ	komisjonu
hɑstɑlArDA	hɑstɑlɑrtɑ	hɑstɑlɑrdɑ
olmADAn	olmɑtɑn	olmɑdɑn
ønmHzDAki	ønmizteki	ønmyzdeki
jønDA	jønte	jønde
kurulHHn	kurulɯɯn	kuruluun
miktɑrDA	miktɑrtɑ	miktɑrdɑ
kontrolH	kontrolɯ	kontroly
kɑtkɯDA	kɑtkɯtɑ	kɑtkɯdɑ
ujumlH	ujumlɯ	ujumlu
sektørH	sektøri	sektøry
ɑlɑnlArDA	ɑlɑnlɑrtɑ	ɑlɑnlɑrdɑ
dɯʃɯnDAki	dɯʃɯntɑki	dɯʃɯndɑki
bojH	bojɯ	boju
ɑjDA	ɑjtɑ	ɑjdɑ
søzH	søzi	søzy
zɑmɑnlArDA	zɑmɑnlɑrtɑ	zɑmɑnlɑrdɑ
orɑnDA	orɑntɑ	orɑndɑ
gynHn	gynin	gynyn
yrynH	yryni	yryny
noktɑDA	noktɑtɑ	noktɑdɑ
toplɑntɯDA	toplɑntɯtɑ	toplɑntɯdɑ
ʧøzymH	ʧøzymi	ʧøzymy
nereDA	nerete	nerede
ønDA	ønte	ønde
koruHʤH	koruuʤɯ	koruuʤu
kuruluʃH	kuruluʃɯ	kuruluʃu
ekrɑnDA	ekrɑntɑ	ekrɑndɑ
ystH	ysti	ysty
sektørHn	sektørin	sektøryn
konuH	konuɯ	konuu
ørgytH	ørgyti	ørgyty
rolH	rolɯ	roly
kurumHn	kurumɯn	kurumun
dynjɑDAki	dynjɑtɑki	dynjɑdɑki
gynDAn	gynten	gynden
evDA	evte	evde
sektørDA	sektørte	sektørde
konuHn	konuɯn	konuun
mɑddeDA	mɑddete	mɑddede
ryjɑDA	ryjɑtɑ	ryjɑdɑ
ʧoʤuklArDA	ʧoʤuklɑrtɑ	ʧoʤuklɑrdɑ
sɑjeDA	sɑjete	sɑjede
kɑnunHHn	kɑnunɯɯn	kɑnunuun
konulH	konulɯ	konulu
kyltyrH	kyltyri	kyltyry
ɑʃɑmɑDA	ɑʃɑmɑtɑ	ɑʃɑmɑdɑ
hɑlH	hɑlɯ	hɑli
toplumH	toplumɯ	toplumu
bɑkɯmDAn	bɑkɯmtɑn	bɑkɯmdɑn
jolDA	joltɑ	joldɑ
køjH	køji	køjy
sɑɑtH	sɑɑtɯ	sɑɑti
durumHn	durumɯn	durumun
bølgelArDA	bølgelerte	bølgelerde
konuDAki	konutɑki	konudɑki
gøryʃH	gøryʃi	gøryʃy
hɑftɑDA	hɑftɑtɑ	hɑftɑdɑ
sɑlonH	sɑlonɯ	sɑlonu
telefonH	telefonɯ	telefonu
jɯlDAn	jɯltɑn	jɯldɑn
dønemlArDA	dønemlerte	dønemlerde
døkymH	døkymi	døkymy
tymH	tymi	tymy
ʧerʧeveDA	ʧerʧevete	ʧerʧevede
ɑlDHklArH	ɑltɯklɑrɯ	ɑldɯklɑrɯ
ʧɑlɯʃmAlArDA	ʧɑlɯʃmɑlɑrtɑ	ʧɑlɯʃmɑlɑrdɑ
jønDAn	jønten	jønden
sistemDA	sistemte	sistemde
dikkɑtlH	dikkɑtlɯ	dikkɑtli
ojunH	ojunɯ	ojunu
mutlulHk	mutlulɯk	mutluluk
sɑɑtlArH	sɑɑtlɑrɯ	sɑɑtleri
bølgeDAki	bølgeteki	bølgedeki
usulH	usulɯ	usuly
ødylH	ødyli	ødyly
jyzjɯlDA	jyzjɯltɑ	jyzjɯldɑ
bojutlH	bojutlɯ	bojutlu
hukukH	hukukɯ	hukuku
kɑblosHz	kɑblosɯz	kɑblosuz
notH	notɯ	notu
bizDA	bizte	bizde
nereDAn	nereten	nereden
bulunDHklArH	buluntɯklɑrɯ	bulunduklɑrɯ
hɑstɑDA	hɑstɑtɑ	hɑstɑdɑ
progrɑmDA	progrɑmtɑ	progrɑmdɑ
ɑzɯnDAn	ɑzɯntɑn	ɑzɯndɑn
bizDAn	bizten	bizden
koʃullArDA	koʃullɑrtɑ	koʃullɑrdɑ
orɑDAn	orɑtɑn	orɑdɑn
bɑɰlɑmDA	bɑɰlɑmtɑ	bɑɰlɑmdɑ
gynmHz	gynmiz	gynmyz
ileriDA	ilerite	ileride
bojutH	bojutɯ	bojutu
okulHn	okulɯn	okulun
rɑporDA	rɑportɑ	rɑpordɑ
mezunH	mezunɯ	mezunu
okulDA	okultɑ	okuldɑ
ɑʧɯklɑmADA	ɑʧɯklɑmɑtɑ	ɑʧɯklɑmɑdɑ
kiʃiDAn	kiʃiten	kiʃiden
nyfusH	nyfusɯ	nyfusu
fonH	fonɯ	fonu
jønlH	jønli	jønly
øzgyrlHk	øzgyrlik	øzgyrlyk
dɯʃɑrɯDAn	dɯʃɑrɯtɑn	dɯʃɑrɯdɑn
plɑnDA	plɑntɑ	plɑndɑ
sevijeDA	sevijete	sevijede
toplumDA	toplumtɑ	toplumdɑ
memurH	memurɯ	memuru
jyzH	jyzi	jyzy
ujgunlHk	ujgunlɯk	ujgunluk
jønH	jøni	jøny
kurulHn	kurulɯn	kurulun
komutH	komutɯ	komutu
fonksijonH	fonksijonɯ	fonksijonu
ortɑDA	ortɑtɑ	ortɑdɑ
bɑʃvuruH	bɑʃvuruɯ	bɑʃvuruu
olHnʤA	olɯnʤɑ	olunʤɑ
noktɑDAn	noktɑtɑn	noktɑdɑn
kuruluʃHn	kuruluʃɯn	kuruluʃun
eɰitimDA	eɰitimte	eɰitimde
pijɑsɑDA	pijɑsɑtɑ	pijɑsɑdɑ
sɑɑtlHk	sɑɑtlɯk	sɑɑtlik
jɑkɯnDA	jɑkɯntɑ	jɑkɯndɑ
kolH	kolɯ	kolu
verDHklArH	vertikleri	verdikleri
doɰruH	doɰruɯ	doɰruu
ølymH	ølymi	ølymy
oluʃumH	oluʃumɯ	oluʃumu
ɑjDAn	ɑjtɑn	ɑjdɑn
geriDA	gerite	geride
ɑlɑnDAki	ɑlɑntɑki	ɑlɑndɑki
orduH	orduɯ	orduu
sɑjfɑDA	sɑjfɑtɑ	sɑjfɑdɑ
jyksekokulH	jyksekokulɯ	jyksekokulu
gørHnʤA	gørinʤe	gørynʤe
tuʃH	tuʃɯ	tuʃu
ortɑmlArDA	ortɑmlɑrtɑ	ortɑmlɑrdɑ
sonsHz	sonsɯz	sonsuz
jɑpɯDA	jɑpɯtɑ	jɑpɯdɑ
sizDAn	sizten	sizden
suDA	sutɑ	sudɑ
dikkɑtH	dikkɑtɯ	dikkɑti
elDAn	elten	elden
konumH	konumɯ	konumu
doɰumlH	doɰumlɯ	doɰumlu
okullArDA	okullɑrtɑ	okullɑrdɑ
ʧoʤuklHk	ʧoʤuklɯk	ʧoʤukluk
uʧHʃ	uʧɯʃ	uʧuʃ
ʃɑrtlArDA	ʃɑrtlɑrtɑ	ʃɑrtlɑrdɑ
dilDA	dilte	dilde
iʃlArDA	iʃlerte	iʃlerde
jolHn	jolɯn	jolun
ʃejDAn	ʃejten	ʃejden
bølymHn	bølymin	bølymyn
jykH	jyki	jyky
bɑʃvuruDA	bɑʃvurutɑ	bɑʃvurudɑ
sorumluH	sorumluɯ	sorumluu
ylkemHzDAki	ylkemizteki	ylkemizdeki
tɑbloH	tɑbloɯ	tɑblou
orgɑnizɑsjonH	orgɑnizɑsjonɯ	orgɑnizɑsjonu
hɑvɑDA	hɑvɑtɑ	hɑvɑdɑ
kɑdɯnlArDA	kɑdɯnlɑrtɑ	kɑdɯnlɑrdɑ
rɑporHn	rɑporɯn	rɑporun
tytynHn	tytynin	tytynyn
merkezDA	merkezte	merkezde
ylkelArDAn	ylkelerten	ylkelerden
vermADAn	vermeten	vermeden
jyklH	jykli	jykly
bɑʃlɑmADAn	bɑʃlɑmɑtɑn	bɑʃlɑmɑdɑn
tɑbloDA	tɑblotɑ	tɑblodɑ
kɑliteDA	kɑlitete	kɑlitede
hukukHn	hukukɯn	hukukun
kɑpsɑmDA	kɑpsɑmtɑ	kɑpsɑmdɑ
nyfusHn	nyfusɯn	nyfusun
nolH	nolɯ	nolu
ʧoklH	ʧoklɯ	ʧoklu
soruH	soruɯ	soruu
yjeDAn	yjeten	yjeden
ɑlmADAn	ɑlmɑtɑn	ɑlmɑdɑn
koʃulH	koʃulɯ	koʃulu
sytH	syti	syty
duruʃmɑDA	duruʃmɑtɑ	duruʃmɑdɑ
hɑstɑneDA	hɑstɑnete	hɑstɑnede
listeDA	listete	listede
jɑzɯDA	jɑzɯtɑ	jɑzɯdɑ
proʒeDA	proʒete	proʒede
kiʃilArDA	kiʃilerte	kiʃilerde
jyryHʃ	jyryiʃ	jyryyʃ
doɰrultuDA	doɰrultutɑ	doɰrultudɑ
gøzH	gøzi	gøzy
køjHn	køjin	køjyn
etmADAn	etmeten	etmeden
byroH	byroɯ	byrou
kurulmHz	kurulmɯz	kurulmuz
vɑdeDA	vɑdete	vɑdede
sɯrɑDAn	sɯrɑtɑn	sɯrɑdɑn
yniversiteDA	yniversitete	yniversitede
gɑzeteDA	gɑzetete	gɑzetede
bølymDAn	bølymten	bølymden
gølH	gøli	gøly
gørynymH	gørynymi	gørynymy
siteDA	sitete	sitede
tɑsɑrrufH	tɑsɑrrufɯ	tɑsɑrrufu
ʃehirDA	ʃehirte	ʃehirde
dɑkikɑDA	dɑkikɑtɑ	dɑkikɑdɑ
tɑrihlArDA	tɑrihlerte	tɑrihlerde
gørevDAn	gørevten	gørevden
ɑrɑDAn	ɑrɑtɑn	ɑrɑdɑn
dostlHk	dostlɯk	dostluk
kursH	kursɯ	kursu
erkeklArDA	erkeklerte	erkeklerde
kɑdroH	kɑdroɯ	kɑdrou
kurumHHn	kurumɯɯn	kurumuun
seklHnDA	seklinte	seklinde
kontrollH	kontrollɯ	kontrolly
jɑpmADAn	jɑpmɑtɑn	jɑpmɑdɑn
jɯllArDAn	jɯllɑrtɑn	jɯllɑrdɑn
bilgisɑjɑrDA	bilgisɑjɑrtɑ	bilgisɑjɑrdɑ
kɑjnɑklArDAn	kɑjnɑklɑrtɑn	kɑjnɑklɑrdɑn
menyH	menyi	menyy
derslArDAn	derslerten	derslerden
dujguH	dujguɯ	dujguu
komisjonHn	komisjonɯn	komisjonun
dɑvɑDA	dɑvɑtɑ	dɑvɑdɑ
modylH	modyli	modyly
ujgulɑmɑlArDA	ujgulɑmɑlɑrtɑ	ujgulɑmɑlɑrdɑ
tɑrzDA	tɑrztɑ	tɑrzdɑ
sendromH	sendromɯ	sendromu
unsurH	unsurɯ	unsuru
ylkeDAn	ylketen	ylkeden
ylkelArDAki	ylkelerteki	ylkelerdeki
durumHHn	durumɯɯn	durumuun
køjDA	køjte	køjde
penʤereDA	penʤerete	penʤerede
plɑtformH	plɑtformɯ	plɑtformu
tyrDAn	tyrten	tyrden
burɑlArDA	burɑlɑrtɑ	burɑlɑrdɑ
sorumlHlHklArH	sorumlɯlɯklɑrɯ	sorumluluklɑrɯ
dɯʃɑrɯDA	dɯʃɑrɯtɑ	dɯʃɑrɯdɑ
olDHkDAn	oltɯktɑn	olduktɑn
bɑsɯnDA	bɑsɯntɑ	bɑsɯndɑ
ørgytHn	ørgytin	ørgytyn
zɑmɑnDAn	zɑmɑntɑn	zɑmɑndɑn
yretimDA	yretimte	yretimde
sulH	sulɯ	sulu
kutuH	kutuɯ	kutuu
olɑjDA	olɑjtɑ	olɑjdɑ
ojunHn	ojunɯn	ojunun
sɯnɑvDA	sɯnɑvtɑ	sɯnɑvdɑ
sorunHHn	sorunɯɯn	sorunuun
topH	topɯ	topu
ylkeDAki	ylketeki	ylkedeki
miktɑrlArDA	miktɑrlɑrtɑ	miktɑrlɑrdɑ
ilDA	ilte	ilde
penʤereDAn	penʤereten	penʤereden
federɑsjonH	federɑsjonɯ	federɑsjonu
dokuH	dokuɯ	dokuu
protokolH	protokolɯ	protokoly
sɑnijeDA	sɑnijete	sɑnijede
gørHp	gørip	gøryp
olHʃH	olɯʃɯ	oluʃu
opsijonH	opsijonɯ	opsijonu
ihtimɑlH	ihtimɑlɯ	ihtimɑli
dønHp	dønip	dønyp
dilmHzDA	dilmizte	dilmizde
sɑhɑDA	sɑhɑtɑ	sɑhɑdɑ
kurulDA	kurultɑ	kuruldɑ
nyfusHHn	nyfusɯɯn	nyfusuun
seneDA	senete	senede
durumDAn	durumtɑn	durumdɑn
geʧmADAn	geʧmeten	geʧmeden
øɰleDAn	øɰleten	øɰleden
kurumlArDA	kurumlɑrtɑ	kurumlɑrdɑ
jykymlH	jykymli	jykymly
ɑlDHkDAn	ɑltɯktɑn	ɑldɯktɑn
zorlHk	zorlɯk	zorluk
kullɑnDHklArH	kullɑntɯklɑrɯ	kullɑndɯklɑrɯ
normɑlDA	normɑltɑ	normɑlde
odɑDA	odɑtɑ	odɑdɑ
orɑnlArDA	orɑnlɑrtɑ	orɑnlɑrdɑ
soruH	soruɯ	soruu
sistemlArDA	sistemlerte	sistemlerde
joksullHk	joksullɯk	joksulluk
kɯsɯmDA	kɯsɯmtɑ	kɯsɯmdɑ
koordinɑsjonH	koordinɑsjonɯ	koordinɑsjonu
derslArDA	derslerte	derslerde
dostH	dostɯ	dostu
fɑktørH	fɑktøri	fɑktøry
dyʃHʃ	dyʃiʃ	dyʃyʃ
ruhH	ruhɯ	ruhu
operɑsjonH	operɑsjonɯ	operɑsjonu
binɑDA	binɑtɑ	binɑdɑ
øjkyH	øjkyi	øjkyy
istɑsjonH	istɑsjonɯ	istɑsjonu
illArDA	illerte	illerde
kɑlmADAn	kɑlmɑtɑn	kɑlmɑdɑn
tedɑviDA	tedɑvite	tedɑvide
øzlHk	øzlik	øzlyk
ʃekillArDA	ʃekillerte	ʃekillerde
ønʤylHk	ønʤylik	ønʤylyk
kyltyrHHn	kyltyriin	kyltyryyn
yniversitelArDA	yniversitelerte	yniversitelerde
ekonomiDA	ekonomite	ekonomide
hykymlH	hykymli	hykymly
menyDA	menyte	menyde
olɑjDAn	olɑjtɑn	olɑjdɑn
sektørDAki	sektørteki	sektørdeki
toplɑntɯlArDA	toplɑntɯlɑrtɑ	toplɑntɯlɑrdɑ
pɑzɑrDA	pɑzɑrtɑ	pɑzɑrdɑ
evDAn	evten	evden
kiʃilArDAn	kiʃilerten	kiʃilerden
konuʃmADA	konuʃmɑtɑ	konuʃmɑdɑ
myʤɑdeleDA	myʤɑdelete	myʤɑdelede
bolH	bolɯ	bolu
sɑɑtlAr	sɑɑtlɑr	sɑɑtler
sɑɑtlArDA	sɑɑtlɑrtɑ	sɑɑtlerde
gørDHklArH	gørtikleri	gørdykleri
søzDA	søzte	søzde
ɑjlArDA	ɑjlɑrtɑ	ɑjlɑrdɑ
kurulumH	kurulumɯ	kurulumu
sorunsHz	sorunsɯz	sorunsuz
ɑrɑʃtɯrmADA	ɑrɑʃtɯrmɑtɑ	ɑrɑʃtɯrmɑdɑ
menyDAn	menyten	menyden
jɑʃɑDHklArH	jɑʃɑtɯklɑrɯ	jɑʃɑdɯklɑrɯ
bulHp	bulɯp	bulup
orɑDAki	orɑtɑki	orɑdɑki
ɑlɯnDHkDAn	ɑlɯntɯktɑn	ɑlɯndɯktɑn
konumDA	konumtɑ	konumdɑ
olmADHkʧA	olmɑtɯkʧɑ	olmɑdɯkʧɑ
proʒelArDA	proʒelerte	proʒelerde
sunuʤuH	sunuʤuɯ	sunuʤuu
tuzlH	tuzlɯ	tuzlu
vɑkɑlArDA	vɑkɑlɑrtɑ	vɑkɑlɑrdɑ
temelDA	temelte	temelde
gøryntyH	gøryntyi	gøryntyy
kurumDA	kurumtɑ	kurumdɑ
okulDAn	okultɑn	okuldɑn
yniversitelArɑrɑsɯ	yniversitelɑrɑrɑsɯ	yniversitelerɑrɑsɯ
depremDAn	depremten	depremden
ekrɑnDAn	ekrɑntɑn	ekrɑndɑn
konuHHn	konuɯɯn	konuuun
kuruluʃlArDA	kuruluʃlɑrtɑ	kuruluʃlɑrdɑ
listeDAn	listeten	listeden
kuruluʃHHn	kuruluʃɯɯn	kuruluʃuun
kutlH	kutlɯ	kutlu
oturHp	oturɯp	oturup
jɑnDA	jɑntɑ	jɑndɑ
ʧevreDA	ʧevrete	ʧevrede
jerlArDAn	jerlerten	jerlerden
onDA	ontɑ	ondɑ
suDAn	sutɑn	sudɑn
dønemDAki	dønemteki	dønemdeki
kyltyrHn	kyltyrin	kyltyryn
bugynHn	bugynin	bugynyn
køjlArDA	køjlerte	køjlerde
zorunlulHk	zorunlulɯk	zorunluluk
jerDAki	jerteki	jerdeki
bɑtɯDA	bɑtɯtɑ	bɑtɯdɑ
durumDAki	durumtɑki	durumdɑki
gɑzetelArDA	gɑzetelerte	gɑzetelerde
øɰrenʤilArDAn	øɰrenʤilerten	øɰrenʤilerden
elmHzDA	elmizte	elmizde
iptɑlH	iptɑlɯ	iptɑli
ɑɰɯzDAn	ɑɰɯztɑn	ɑɰɯzdɑn
bojutlArDA	bojutlɑrtɑ	bojutlɑrdɑ
doɰɑDA	doɰɑtɑ	doɰɑdɑ
gynmHzHn	gynmizin	gynmyzyn
ojH	ojɯ	oju
suʧlH	suʧlɯ	suʧlu
jøreDA	jørete	jørede
ɑnDAn	ɑntɑn	ɑndɑn
merkezDAn	merkezten	merkezden
sɯrɑlArDA	sɯrɑlɑrtɑ	sɯrɑlɑrdɑ
øzH	øzi	øzy
binDA	binte	binde
bulunHp	bulunɯp	bulunup
hususH	hususɯ	hususu
huzurlH	huzurlɯ	huzurlu
søzleʃmeDA	søzleʃmete	søzleʃmede
suʧHn	suʧɯn	suʧun
toplumHHn	toplumɯɯn	toplumuun
tutumH	tutumɯ	tutumu
jɑʃlArDA	jɑʃlɑrtɑ	jɑʃlɑrdɑ
kokuH	kokuɯ	kokuu
krizDAn	krizten	krizden
sɑjɯDAki	sɑjɯtɑki	sɑjɯdɑki
stɑtyH	stɑtyi	stɑtyy
turH	turɯ	turu
usullArH	usullɑrɯ	usulleri
jollArDAn	jollɑrtɑn	jollɑrdɑn
ystynDAki	ystynteki	ystyndeki
kojHp	kojɯp	kojup
enflɑsjonHn	enflɑsjonɯn	enflɑsjonun
rɑporHHn	rɑporɯɯn	rɑporuun
sɑlonDA	sɑlontɑ	sɑlondɑ
jɑpɯlArDA	jɑpɯlɑrtɑ	jɑpɯlɑrdɑ
orduHHn	orduɯɯn	orduuun
ujumH	ujumɯ	ujumu
jollArDA	jollɑrtɑ	jollɑrdɑ
dujDHklArH	dujtɯklɑrɯ	dujduklɑrɯ
gørevDA	gørevte	gørevde
kokulH	kokulɯ	kokulu
okulmHz	okulmɯz	okulmuz
tijɑtroH	tijɑtroɯ	tijɑtrou
ølʧymH	ølʧymi	ølʧymy
progrɑmlArDA	progrɑmlɑrtɑ	progrɑmlɑrdɑ
ujruklH	ujruklɯ	ujruklu
ɑrɑziDA	ɑrɑzite	ɑrɑzide
borʧlH	borʧlɯ	borʧlu
hemDA	hemte	hemde
kɯlɑvuzH	kɯlɑvuzɯ	kɯlɑvuzu
kontrollArH	kontrollɑrɯ	kontrolleri
nedenlArDAn	nedenlerten	nedenlerden
sɑjfɑDAn	sɑjfɑtɑn	sɑjfɑdɑn
sistemDAn	sistemten	sistemden
kuruluʃlArDAn	kuruluʃlɑrtɑn	kuruluʃlɑrdɑn
jykymlHlHklArH	jykymlilikleri	jykymlylykleri
binɑlArDA	binɑlɑrtɑ	binɑlɑrdɑ
fɯkrɑDA	fɯkrɑtɑ	fɯkrɑdɑ
orduHn	orduɯn	orduun
sunumH	sunumɯ	sunumu
ɑrɑmHzDA	ɑrɑmɯztɑ	ɑrɑmɯzdɑ
gyndemDA	gyndemte	gyndemde
hɯzDA	hɯztɑ	hɯzdɑ
jolHHn	jolɯɯn	joluun
gøryʃmelArDA	gøryʃmelerte	gøryʃmelerde
girmADAn	girmeten	girmeden
iʃlemlArDA	iʃlemlerte	iʃlemlerde
lirɑDAn	lirɑtɑn	lirɑdɑn
virysH	virysi	virysy
jɑʃɑmDA	jɑʃɑmtɑ	jɑʃɑmdɑ
yʧlH	yʧli	yʧly
byjyklHkDA	byjyklikte	byjyklykte
bɑʃvuruHn	bɑʃvuruɯn	bɑʃvuruun
dønHʃH	døniʃi	dønyʃy
enfeksijonH	enfeksijonɯ	enfeksijonu
ørtyH	ørtyi	ørtyy
birɑrɑDA	birɑrɑtɑ	birɑrɑdɑ
herʃejDAn	herʃejten	herʃejden
yjelArDAn	yjelerten	yjelerden
konulArDAn	konulɑrtɑn	konulɑrdɑn
jɑrɯjɯlDA	jɑrɯjɯltɑ	jɑrɯjɯldɑ
sɑɑtA	sɑɑtɑ	sɑɑte
evlArDA	evlerte	evlerde
sizDA	sizte	sizde
toprɑklArDA	toprɑklɑrtɑ	toprɑklɑrdɑ
insɑnlArDA	insɑnlɑrtɑ	insɑnlɑrdɑ
olgulArDA	olgulɑrtɑ	olgulɑrdɑ
eɰitimDAn	eɰitimten	eɰitimden
gelmADAn	gelmeten	gelmeden
hɑllAr	hɑllɑr	hɑller
mɑsonlHk	mɑsonlɯk	mɑsonluk
ɑlkollH	ɑlkollɯ	ɑlkolly
rektørH	rektøri	rektøry
denizDAn	denizten	denizden
kiʃiDA	kiʃite	kiʃide
joɰunlHk	joɰunlɯk	joɰunluk
ɑrɑDAki	ɑrɑtɑki	ɑrɑdɑki
bytynH	bytyni	bytyny
doɰHʃ	doɰɯʃ	doɰuʃ
fonHn	fonɯn	fonun
pijɑsɑDAki	pijɑsɑtɑki	pijɑsɑdɑki
syrymH	syrymi	syrymy
tesislArDA	tesislerte	tesislerde
bɑroH	bɑroɯ	bɑrou
gøzHn	gøzin	gøzyn
mekɑnlArDA	mekɑnlɑrtɑ	mekɑnlɑrdɑ
bølymlArDA	bølymlerte	bølymlerde
doɰuDA	doɰutɑ	doɰudɑ
mesɑfeDA	mesɑfete	mesɑfede
progrɑmDAn	progrɑmtɑn	progrɑmdɑn
rektørlHk	rektørlik	rektørlyk
bølgeDAn	bølgeten	bølgeden
doktorH	doktorɯ	doktoru
gøsterDHklArH	gøstertikleri	gøsterdikleri
insɑnlArDAn	insɑnlɑrtɑn	insɑnlɑrdɑn
seʧimlArDA	seʧimlerte	seʧimlerde
jɑnnHzDA	jɑnnɯztɑ	jɑnnɯzdɑ
ørgytHHn	ørgytiin	ørgytyyn
dergiDA	dergite	dergide
hɑjɑlH	hɑjɑlɯ	hɑjɑli
søzHn	søzin	søzyn
doɰumDAn	doɰumtɑn	doɰumdɑn
kɑpɯDAn	kɑpɯtɑn	kɑpɯdɑn
mɑddelArDAn	mɑddelerten	mɑddelerden
ønH	øni	øny
bytynlHk	bytynlik	bytynlyk
bozuklHk	bozuklɯk	bozukluk
durmADAn	durmɑtɑn	durmɑdɑn
fɑɑlijetlArDA	fɑɑlijetlerte	fɑɑlijetlerde
hizmetlArDAn	hizmetlerten	hizmetlerden
syreDAn	syreten	syreden
bursH	bursɯ	bursu
dønemDAn	dønemten	dønemden
gøryntyH	gøryntyi	gøryntyy
sokɑklArDA	sokɑklɑrtɑ	sokɑklɑrdɑ
ilʧeDA	ilʧete	ilʧede
mɑkbuzH	mɑkbuzɯ	mɑkbuzu
hɑrfH	hɑrfɯ	hɑrfi
tɑbloHn	tɑbloɯn	tɑbloun
elnHzDA	elnizte	elnizde
senDAn	senten	senden
jolsuzlHk	jolsuzlɯk	jolsuzluk
yrynlArDA	yrynlerte	yrynlerde
bilgisɑjɑrDAn	bilgisɑjɑrtɑn	bilgisɑjɑrdɑn
depoH	depoɯ	depou
depremDA	depremte	depremde
ekrɑnDAki	ekrɑntɑki	ekrɑndɑki
hɑstɑnelArDA	hɑstɑnelerte	hɑstɑnelerde
mɑlzemeDAn	mɑlzemeten	mɑlzemeden
mekɑnDA	mekɑntɑ	mekɑndɑ
odɑlArDA	odɑlɑrtɑ	odɑlɑrdɑ
sektørlArDA	sektørlerte	sektørlerde
tonH	tonɯ	tonu
jɑrɯʃmɑDA	jɑrɯʃmɑtɑ	jɑrɯʃmɑdɑ
køpryH	køpryi	køpryy
kɑnDA	kɑntɑ	kɑndɑ
sɑɑtDAn	sɑɑttɑn	sɑɑtten
versijonH	versijonɯ	versijonu
esnɑDA	esnɑtɑ	esnɑdɑ
giriʃimlArDA	giriʃimlerte	giriʃimlerde
korkuH	korkuɯ	korkuu
onurlH	onurlɯ	onurlu
entegrɑsjonH	entegrɑsjonɯ	entegrɑsjonu
hɑvɑDAn	hɑvɑtɑn	hɑvɑdɑn
tørenDA	tørente	tørende
tɑmɑmlADHkDAn	tɑmɑmlɑtɯktɑn	tɑmɑmlɑdɯktɑn
ɑlɑnlArDAki	ɑlɑnlɑrtɑki	ɑlɑnlɑrdɑki
hɑftɑDAn	hɑftɑtɑn	hɑftɑdɑn
ilʧelArDA	ilʧelerte	ilʧelerde
mydyrHn	mydyrin	mydyryn
sonsHzA	sonsɯzɑ	sonsuzɑ
ømyrlH	ømyrli	ømyrly
ʃehirlArDA	ʃehirlerte	ʃehirlerde
ɑnDAki	ɑntɑki	ɑndɑki
ɑrɑʃtɯrmAlArDA	ɑrɑʃtɯrmɑlɑrtɑ	ɑrɑʃtɯrmɑlɑrdɑ
dynjɑDAn	dynjɑtɑn	dynjɑdɑn
yʧH	yʧi	yʧy
ɑrkɑDAn	ɑrkɑtɑn	ɑrkɑdɑn
festivɑlH	festivɑlɯ	festivɑli
komisjonHHn	komisjonɯɯn	komisjonuun
ønerilArDA	ønerilerte	ønerilerde
mydyrHHn	mydyriin	mydyryyn
progrɑmnDAn	progrɑmntɑn	progrɑmndɑn
sulArDA	sulɑrtɑ	sulɑrdɑ
dønyʃymH	dønyʃymi	dønyʃymy
derinDAn	derinten	derinden
syrɑtlH	syrɑtlɯ	syrɑtli
sembolH	sembolɯ	semboly
sitemHzDA	sitemizte	sitemizde
ørgytlH	ørgytli	ørgytly
ɑlɯnmADAn	ɑlɯnmɑtɑn	ɑlɯnmɑdɑn
deɰerlendirmADA	deɰerlendirmete	deɰerlendirmede
tutHp	tutɯp	tutup
jorgunlHk	jorgunlɯk	jorgunluk
bozuklHklAr	bozuklɯklɑr	bozukluklɑr
kylH	kyli	kyly
sonrɑDA	sonrɑtɑ	sonrɑdɑ
bɑzDA	bɑztɑ	bɑzdɑ
hususlArDA	hususlɑrtɑ	hususlɑrdɑ
sonlH	sonlɯ	sonlu
denizDA	denizte	denizde
netiʤeDA	netiʤete	netiʤede
okulmHzDA	okulmɯztɑ	okulmuzdɑ
reformH	reformɯ	reformu
zorlHklAr	zorlɯklɑr	zorluklɑr
dosjɑDA	dosjɑtɑ	dosjɑdɑ
ulusHn	ulusɯn	ulusun
ʧɑlɯʃmɑmHzDA	ʧɑlɯʃmɑmɯztɑ	ʧɑlɯʃmɑmɯzdɑ
dyʃynHp	dyʃynip	dyʃynyp
hizmetlArDA	hizmetlerte	hizmetlerde
mɑkɑleDA	mɑkɑlete	mɑkɑlede
sɑjfɑlArDA	sɑjfɑlɑrtɑ	sɑjfɑlɑrdɑ
tymHHn	tymiin	tymyyn
tɑrihinDAki	tɑrihinteki	tɑrihindeki
toplumlArDA	toplumlɑrtɑ	toplumlɑrdɑ
formHn	formɯn	formun
kɑlDHklArH	kɑltɯklɑrɯ	kɑldɯklɑrɯ
ojunDA	ojuntɑ	ojundɑ
fuɑrDA	fuɑrtɑ	fuɑrdɑ
gynmHzDAki	gynmizteki	gynmyzdeki
jɑnDAki	jɑntɑki	jɑndɑki
zeminDA	zeminte	zeminde
ʧɯkmADAn	ʧɯkmɑtɑn	ʧɯkmɑdɑn
noktɑlArDA	noktɑlɑrtɑ	noktɑlɑrdɑ
oturumDA	oturumtɑ	oturumdɑ
pijɑsɑlArDA	pijɑsɑlɑrtɑ	pijɑsɑlɑrdɑ
tytynlArDA	tytynlerte	tytynlerde
elmHzDAn	elmizten	elmizden
kɑrɑrDA	kɑrɑrtɑ	kɑrɑrdɑ
muɑjeneDA	muɑjenete	muɑjenede
sɑnɑjiDA	sɑnɑjite	sɑnɑjide
tyrDA	tyrte	tyrde
ɑrɑjyzH	ɑrɑjyzi	ɑrɑjyzy
bojlH	bojlɯ	bojlu
bugynlArDA	bugynlerte	bugynlerde
devirDA	devirte	devirde
firmɑlArDAn	firmɑlɑrtɑn	firmɑlɑrdɑn
formHHn	formɯɯn	formuun
gynejDA	gynejte	gynejde
ilArDA	ilerte	ilerde
iliʃkilArDA	iliʃkilerte	iliʃkilerde
kɑblolH	kɑblolɯ	kɑblolu
sɯnɯflArDA	sɯnɯflɑrtɑ	sɯnɯflɑrdɑ
yʧnʤHH	yʧnʤii	yʧnʤyy
ɑlɑnlArDAn	ɑlɑnlɑrtɑn	ɑlɑnlɑrdɑn
dyzejDAki	dyzejteki	dyzejdeki
geʤeDA	geʤete	geʤede
sporH	sporɯ	sporu
ørtylH	ørtyli	ørtyly
hɑstɑlɯklArDAn	hɑstɑlɯklɑrtɑn	hɑstɑlɯklɑrdɑn
tɑmɑmlɑnDHkDAn	tɑmɑmlɑntɯktɑn	tɑmɑmlɑndɯktɑn
ɑrkɑDA	ɑrkɑtɑ	ɑrkɑdɑ
kongreDA	kongrete	kongrede
tuzH	tuzɯ	tuzu
jyzlH	jyzli	jyzly
jɑsɑDA	jɑsɑtɑ	jɑsɑdɑ
ʧɑɰDA	ʧɑɰtɑ	ʧɑɰdɑ
ɑdɑDA	ɑdɑtɑ	ɑdɑdɑ
birDA	birte	birde
merkeznDAki	merkeznteki	merkezndeki
jurtiʧinDA	jurtiʧinte	jurtiʧinde
dozH	dozɯ	dozu
inʤelemAlArDA	inʤelemelerte	inʤelemelerde
milletlArɑrɑsɯ	milletlɑrɑrɑsɯ	milletlerɑrɑsɯ
misjonH	misjonɯ	misjonu
pɑzɑrlArDA	pɑzɑrlɑrtɑ	pɑzɑrlɑrdɑ
bordroH	bordroɯ	bordrou
formDA	formtɑ	formdɑ
jerjyzynDA	jerjyzynte	jerjyzynde
yniversiteDAn	yniversiteten	yniversiteden
geliʃmAlArDAn	geliʃmelerten	geliʃmelerden
kɑmpysH	kɑmpysi	kɑmpysy
merkezlArDA	merkezlerte	merkezlerde
pozisjonDA	pozisjontɑ	pozisjondɑ
jorumH	jorumɯ	jorumu
iʃlArDAn	iʃlerten	iʃlerden
sunHʃ	sunɯʃ	sunuʃ
usullAr	usullɑr	usuller
doɰHʃDAn	doɰɯʃtɑn	doɰuʃtɑn
girDHkDAn	girtikten	girdikten
kusurlH	kusurlɯ	kusurlu
tozH	tozɯ	tozu
enflɑsjonH	enflɑsjonɯ	enflɑsjonu
kɑtegoriDA	kɑtegorite	kɑtegoride
kullɑnmADAn	kullɑnmɑtɑn	kullɑnmɑdɑn
kurumlArDAn	kurumlɑrtɑn	kurumlɑrdɑn
ʃimdilArDA	ʃimdilerte	ʃimdilerde
yzHʤH	yzyʤi	yzyʤy
bilgisɑjɑrlArDA	bilgisɑjɑrlɑrtɑ	bilgisɑjɑrlɑrdɑ
normɑlA	normɑlɑ	normɑle
olɑjlArDAn	olɑjlɑrtɑn	olɑjlɑrdɑn
jørelArDA	jørelerte	jørelerde
øɰretimDA	øɰretimte	øɰretimde
gelDHkDAn	geltikten	geldikten
iʃgɑlH	iʃgɑlɯ	iʃgɑli
kurDAn	kurtɑn	kurdɑn
televizjonDA	televizjontɑ	televizjondɑ
toplumDAki	toplumtɑki	toplumdɑki
ʧevreDAki	ʧevreteki	ʧevredeki
ɑileDA	ɑilete	ɑilede
gøryntyHn	gøryntyin	gøryntyyn
gelDHklArH	geltikleri	geldikleri
iʃletmelArDA	iʃletmelerte	iʃletmelerde
konsɑntrɑsjonH	konsɑntrɑsjonɯ	konsɑntrɑsjonu
operɑtørH	operɑtøri	operɑtøry
søzHHn	søziin	søzyyn
sɑtɯrDA	sɑtɯrtɑ	sɑtɯrdɑ
tyrHHn	tyriin	tyryyn
bilgisɑjɑrnHzDA	bilgisɑjɑrnɯztɑ	bilgisɑjɑrnɯzdɑ
bulHʃ	bulɯʃ	buluʃ
butonH	butonɯ	butonu
doɰrulHk	doɰrulɯk	doɰruluk
fɑkylteDA	fɑkyltete	fɑkyltede
iletiʃimDA	iletiʃimte	iletiʃimde
okuHp	okuɯp	okuup
pɑnelDA	pɑnelte	pɑnelde
pozisjonH	pozisjonɯ	pozisjonu
syrHp	syrip	syryp
jønDAki	jønteki	jøndeki
doktorHn	doktorɯn	doktorun
getirDHklArH	getirtikleri	getirdikleri
hɑstɑlɯklArDA	hɑstɑlɯklɑrtɑ	hɑstɑlɯklɑrdɑ
køʃeDA	køʃete	køʃede
kurHp	kurɯp	kurup
notHHn	notɯɯn	notuun
ortɑmDAn	ortɑmtɑn	ortɑmdɑn
susHz	susɯz	susuz
ujgulɑmADAn	ujgulɑmɑtɑn	ujgulɑmɑdɑn
jyryHʃH	jyryiʃi	jyryyʃy
bølgelArDAki	bølgelerteki	bølgelerdeki
gitmADAn	gitmeten	gitmeden
kuzejDA	kuzejte	kuzejde
telefonDAn	telefontɑn	telefondɑn
ølʧylArDA	ølʧylerte	ølʧylerde
dɑlDA	dɑltɑ	dɑldɑ
dereʤeDAn	dereʤeten	dereʤeden
iʃlemDAn	iʃlemten	iʃlemden
iʃletmeDA	iʃletmete	iʃletmede
otelDA	otelte	otelde
jyzjɯlDAn	jyzjɯltɑn	jyzjɯldɑn
ølʧyH	ølʧyi	ølʧyy
bɑʃlɑDHkDAn	bɑʃlɑtɯktɑn	bɑʃlɑdɯktɑn
bugynDAn	bugynten	bugynden
elmDA	elmte	elmde
gøryntylH	gøryntyli	gøryntyly
ilmHzDA	ilmizte	ilmizde
insɑnDA	insɑntɑ	insɑndɑ
kesimDA	kesimte	kesimde
orgɑnizɑsjonHn	orgɑnizɑsjonɯn	orgɑnizɑsjonun
sɑhneDA	sɑhnete	sɑhnede
bilgilArDAn	bilgilerten	bilgilerden
proʒeksijonH	proʒeksijonɯ	proʒeksijonu
vizjonH	vizjonɯ	vizjonu
kollHk	kollɯk	kolluk
okulmHzHn	okulmɯzɯn	okulmuzun
sorunlArDAn	sorunlɑrtɑn	sorunlɑrdɑn
giriʃimDA	giriʃimte	giriʃimde
iʃlemlArDAn	iʃlemlerten	iʃlemlerden
øzgyrlHklAr	øzgyrlikler	øzgyrlykler
hɑrflArH	hɑrflɑrɯ	hɑrfleri
kɑmuHn	kɑmuɯn	kɑmuun
kurDHklArH	kurtɯklɑrɯ	kurduklɑrɯ
syslH	sysli	sysly
sebeplArDAn	sebeplerten	sebeplerden
ɑlɑnDAn	ɑlɑntɑn	ɑlɑndɑn
burslH	burslɯ	burslu
doktornHz	doktornɯz	doktornuz
kullɑnɯmDA	kullɑnɯmtɑ	kullɑnɯmdɑ
miljonDAn	miljontɑn	miljondɑn
miljonH	miljonɯ	miljonu
syrHʃ	syriʃ	syryʃ
sytHn	sytin	sytyn
tɑrɯmDA	tɑrɯmtɑ	tɑrɯmdɑ
jɑrdɯmDA	jɑrdɯmtɑ	jɑrdɯmdɑ
bugynH	bugyni	bugyny
direktørH	direktøri	direktøry
gøryʃHn	gøryʃin	gøryʃyn
konforlH	konforlɯ	konforlu
lɑborɑtuvɑrDA	lɑborɑtuvɑrtɑ	lɑborɑtuvɑrdɑ
mɑddeDAki	mɑddeteki	mɑddedeki
otomɑsjonH	otomɑsjonɯ	otomɑsjonu
tɑbloH	tɑbloɯ	tɑblou
telefonHn	telefonɯn	telefonun
ʤɑnDAn	ʤɑntɑn	ʤɑndɑn
deDHklArH	detikleri	dedikleri
elDAki	elteki	eldeki
ilerleDHkʧA	ilerletikʧe	ilerledikʧe
motorHn	motorɯn	motorun
olmADHklArH	olmɑtɯklɑrɯ	olmɑdɯklɑrɯ
ruhHn	ruhɯn	ruhun
topHn	topɯn	topun
jukɑrɯDAn	jukɑrɯtɑn	jukɑrɯdɑn
byjyklHk	byjyklik	byjyklyk
bilmADAn	bilmeten	bilmeden
mɑnɑDA	mɑnɑtɑ	mɑnɑdɑ
mɑterjɑllAr	mɑterjɑllɑr	mɑterjɑller
resimDA	resimte	resimde
tonlHk	tonlɯk	tonluk
jyzejDA	jyzejte	jyzejde
øzgyrlHklArH	øzgyrlikleri	øzgyrlykleri
bebeklArDA	bebeklerte	bebeklerde
boruH	boruɯ	boruu
dilDAn	dilten	dilden
durHp	durɯp	durup
iʧeriDA	iʧerite	iʧeride
kytyphɑneDA	kytyphɑnete	kytyphɑnede
mɑterjɑlH	mɑterjɑlɯ	mɑterjɑli
seʧimDA	seʧimte	seʧimde
terminɑlH	terminɑlɯ	terminɑli
topʧH	topʧɯ	topʧu
ølymHn	ølymin	ølymyn
yniversitemHzDA	yniversitemizte	yniversitemizde
eserDA	eserte	eserde
gøryʃmeDA	gøryʃmete	gøryʃmede
gyryltylH	gyryltyli	gyryltyly
hɑrflAr	hɑrflɑr	hɑrfler
lyzumlH	lyzumlɯ	lyzumlu
operɑsjonHn	operɑsjonɯn	operɑsjonun
sorunlH	sorunlɯ	sorunlu
jɯllArDAki	jɯllɑrtɑki	jɯllɑrdɑki
ønmHzA	ønmize	ønmyze
dyzenleDHklArH	dyzenletikleri	dyzenledikleri
filmDA	filmte	filmde
kurumDAn	kurumtɑn	kurumdɑn
mɑddeDAn	mɑddeten	mɑddeden
modH	modɯ	modu
tyjlH	tyjli	tyjly
terørHn	terørin	terøryn
tutulumH	tutulumɯ	tutulumu
zorlHklArH	zorlɯklɑrɯ	zorluklɑrɯ
ʤepheDA	ʤephete	ʤephede
etkinliklArDA	etkinliklerte	etkinliklerde
gølHn	gølin	gølyn
hɑberDA	hɑberte	hɑberde
misɑlH	misɑlɯ	misɑli
pɑrlɑmentoH	pɑrlɑmentoɯ	pɑrlɑmentou
sonbɑhɑrDA	sonbɑhɑrtɑ	sonbɑhɑrdɑ
verDHkDAn	vertikten	verdikten
jøntemDA	jøntemte	jøntemde
jɑnmDA	jɑnmtɑ	jɑnmdɑ
fɯrɯnDA	fɯrɯntɑ	fɯrɯndɑ
fɑktørlArDAn	fɑktørlerten	fɑktørlerden
køprylH	køpryli	køpryly
sɯnɑvlArDA	sɯnɑvlɑrtɑ	sɯnɑvlɑrdɑ
sɑhɑlArDA	sɑhɑlɑrtɑ	sɑhɑlɑrdɑ
telefonDA	telefontɑ	telefondɑ
biʧimlArDA	biʧimlerte	biʧimlerde
gørynymlH	gørynymli	gørynymly
køjDAn	køjten	køjden
sporHn	sporɯn	sporun
jykymlHlHk	jykymlilik	jykymlylyk
bɑskɯDA	bɑskɯtɑ	bɑskɯdɑ
dɑvɑlArDA	dɑvɑlɑrtɑ	dɑvɑlɑrdɑ
distribytørH	distribytøri	distribytøry
dujmADAn	dujmɑtɑn	dujmɑdɑn
ekonomiDAki	ekonomiteki	ekonomideki
elnHzDAki	elnizteki	elnizdeki
enstityHn	enstityin	enstityyn
firmɑlArDA	firmɑlɑrtɑ	firmɑlɑrdɑ
petrolHn	petrolɯn	petrolyn
stɑndɑrtlArDA	stɑndɑrtlɑrtɑ	stɑndɑrtlɑrdɑ
ʧøzymHn	ʧøzymin	ʧøzymyn
ystynlHk	ystynlik	ystynlyk
dujuruH	dujuruɯ	dujuruu
gønylDAn	gønylten	gønylden
gønyllHlArH	gønyllileri	gønyllyleri
kɑmuDA	kɑmutɑ	kɑmudɑ
kɑpɑsiteDA	kɑpɑsitete	kɑpɑsitede
tɑɑhhytlH	tɑɑhhytli	tɑɑhhytly
tɑrɑfmHzDAn	tɑrɑfmɯztɑn	tɑrɑfmɯzdɑn
jønetimDA	jønetimte	jønetimde
jurtdɯʃɯnDAki	jurtdɯʃɯntɑki	jurtdɯʃɯndɑki
yretimDAn	yretimten	yretimden
bytʧeDAn	bytʧeten	bytʧeden
dokuHn	dokuɯn	dokuun
gørynHʃ	gøryniʃ	gørynyʃ
kɑjbetmADAn	kɑjbetmeten	kɑjbetmeden
kumH	kumɯ	kumu
mɑddelArDA	mɑddelerte	mɑddelerde
renklArDA	renklerte	renklerde
syryʤyH	syryʤyi	syryʤyy
senɑtoH	senɑtoɯ	senɑtou
sorumlHlArH	sorumlɯlɑrɯ	sorumlulɑrɯ
tɑrɑflArDAn	tɑrɑflɑrtɑn	tɑrɑflɑrdɑn
tepeDAn	tepeten	tepeden
devreDA	devrete	devrede
dozDA	doztɑ	dozdɑ
kɑjnɑklArDA	kɑjnɑklɑrtɑ	kɑjnɑklɑrdɑ
koʃulDA	koʃultɑ	koʃuldɑ
kusurH	kusurɯ	kusuru
okulDAki	okultɑki	okuldɑki
ødemADAn	ødemeten	ødemeden
ʃirketlArDA	ʃirketlerte	ʃirketlerde
ɑʃɑɰɯDAkilArDAn	ɑʃɑɰɯtɑkilerten	ɑʃɑɰɯdɑkilerden
beklemADAn	beklemeten	beklemeden
hykymlHlArHn	hykymlilerin	hykymlylerin
hukukHHn	hukukɯɯn	hukukuun
inʤelemADA	inʤelemete	inʤelemede
operɑsjonDA	operɑsjontɑ	operɑsjondɑ
jɑrH	jɑrɯ	jɑri
nyfuslH	nyfuslɯ	nyfuslu
typH	typi	typy
tɑbloDAn	tɑblotɑn	tɑblodɑn
jerlArDAki	jerlerteki	jerlerdeki
bølgelArDAn	bølgelerten	bølgelerden
bɑʃvuruH	bɑʃvuruɯ	bɑʃvuruu
dɑhilDA	dɑhilte	dɑhilde
devreDAn	devreten	devreden
ihlɑlH	ihlɑlɯ	ihlɑli
kɑpɯDA	kɑpɯtɑ	kɑpɯdɑ
seminerDA	seminerte	seminerde
soruDA	sorutɑ	sorudɑ
ɑdɯmDA	ɑdɯmtɑ	ɑdɯmdɑ
bildirimDA	bildirimte	bildirimde
etydH	etydi	etydy
hɑstɑlArDAn	hɑstɑlɑrtɑn	hɑstɑlɑrdɑn
køtylHk	køtylik	køtylyk
kɑbloH	kɑbloɯ	kɑblou
kumlH	kumlɯ	kumlu
listeDAki	listeteki	listedeki
jorHʤH	joruʤɯ	joruʤu
doɰHʃH	doɰɯʃɯ	doɰuʃu
dokuHHn	dokuɯɯn	dokuuun
evDAki	evteki	evdeki
fɑbrikɑDA	fɑbrikɑtɑ	fɑbrikɑdɑ
sinjɑlH	sinjɑlɯ	sinjɑli
sistemDAki	sistemteki	sistemdeki
usulA	usulɑ	usule
ujgulɑmɑlArDAn	ujgulɑmɑlɑrtɑn	ujgulɑmɑlɑrdɑn
jɑpɯDAki	jɑpɯtɑki	jɑpɯdɑki
ønDAn	ønten	ønden
øzellHklArDAn	øzelliklerten	øzelliklerden
ʤoʃkulH	ʤoʃkulɯ	ʤoʃkulu
firmɑDAn	firmɑtɑn	firmɑdɑn
huzurH	huzurɯ	huzuru
kɑlkɯnmADA	kɑlkɯnmɑtɑ	kɑlkɯnmɑdɑ
krediDAn	krediten	krediden
medjɑDA	medjɑtɑ	medjɑdɑ
memurHn	memurɯn	memurun
rollAr	rollɑr	roller
søzʤyH	søzʤyi	søzʤyy
syryʤyHn	syryʤyin	syryʤyyn
tyrHn	tyrin	tyryn
dyrystlHk	dyrystlik	dyrystlyk
firmɑDA	firmɑtɑ	firmɑdɑ
modelDA	modelte	modelde
okuHʤHA	okuuʤɯɑ	okuuʤuɑ
ʧorlH	ʧorlɯ	ʧorlu
yniversitelArDAn	yniversitelerten	yniversitelerden
noterDAn	noterten	noterden
pɑzɑrDAki	pɑzɑrtɑki	pɑzɑrdɑki
tytynH	tytyni	tytyny
jykHHn	jykiin	jykyyn
ønmHzDA	ønmizte	ønmyzde
ɑʧɯklɑmAlArDA	ɑʧɯklɑmɑlɑrtɑ	ɑʧɯklɑmɑlɑrdɑ
ɑʧɯlArDAn	ɑʧɯlɑrtɑn	ɑʧɯlɑrdɑn
ɑrzuH	ɑrzuɯ	ɑrzuu
gørmADAn	gørmeten	gørmeden
kɑdrolH	kɑdrolɯ	kɑdrolu
kɑnDAki	kɑntɑki	kɑndɑki
kontrollAr	kontrollɑr	kontroller
minerɑllArH	minerɑllɑrɯ	minerɑlleri
bølymmHz	bølymmiz	bølymmyz
belirlemADA	belirlemete	belirlemede
dyzejlArDA	dyzejlerte	dyzejlerde
doɰruH	doɰruɯ	doɰruu
dojurHʤH	dojuruʤɯ	dojuruʤu
gørynHʃH	gøryniʃi	gørynyʃy
merkezmHzDA	merkezmizte	merkezmizde
minerɑllAr	minerɑllɑr	minerɑller
odɑDAn	odɑtɑn	odɑdɑn
rɑporlArDA	rɑporlɑrtɑ	rɑporlɑrdɑ
sergiDA	sergite	sergide
jyznʤH	jyznʤi	jyznʤy
ʃejlArDAn	ʃejlerten	ʃejlerden
ɑileDAn	ɑileten	ɑileden
bɑhʧeDA	bɑhʧete	bɑhʧede
bɑnkɑDAn	bɑnkɑtɑn	bɑnkɑdɑn
bɑtɯDAn	bɑtɯtɑn	bɑtɯdɑn
døkymHHn	døkymiin	døkymyyn
doluH	doluɯ	doluu
eriʃkinlArDA	eriʃkinlerte	eriʃkinlerde
evnHzDA	evnizte	evnizde
hɑllArH	hɑllɑrɯ	hɑlleri
huzursHzlHk	huzursɯzlɯk	huzursuzluk
iʧimDA	iʧimte	iʧimde
iliʃkiDA	iliʃkite	iliʃkide
komisjonDA	komisjontɑ	komisjondɑ
mɑterjɑlHn	mɑterjɑlɯn	mɑterjɑlin
tedɑviDAn	tedɑviten	tedɑviden
jyzejlArDA	jyzejlerte	jyzejlerde
ʧɑrʃɯDA	ʧɑrʃɯtɑ	ʧɑrʃɯdɑ
ønʤyH	ønʤyi	ønʤyy
ʃɑmpijonH	ʃɑmpijonɯ	ʃɑmpijonu
ɑʃɑmɑDAn	ɑʃɑmɑtɑn	ɑʃɑmɑdɑn
birimlArDA	birimlerte	birimlerde
olgunlHk	olgunlɯk	olgunluk
pijɑsɑDAn	pijɑsɑtɑn	pijɑsɑdɑn
sɑjmHzDA	sɑjmɯztɑ	sɑjmɯzdɑ
toplummHzHn	toplummɯzɯn	toplummuzun
øzDAn	øzten	øzden
binDAn	binten	binden
kɑrɑrlArDA	kɑrɑrlɑrtɑ	kɑrɑrlɑrdɑ
mydyrmHz	mydyrmiz	mydyrmyz
modellArDA	modellerte	modellerde
olguDA	olgutɑ	olgudɑ
sɯnɑvDAn	sɯnɑvtɑn	sɯnɑvdɑn
sevijeDAki	sevijeteki	sevijedeki
solDA	soltɑ	soldɑ
solDAn	soltɑn	soldɑn
jɑrɯDAn	jɑrɯtɑn	jɑrɯdɑn
jɑzɯlArDA	jɑzɯlɑrtɑ	jɑzɯlɑrdɑ
ɑdɑjlArDAn	ɑdɑjlɑrtɑn	ɑdɑjlɑrdɑn
ɑrɑʧlArDA	ɑrɑʧlɑrtɑ	ɑrɑʧlɑrdɑ
dønDHkDAn	døntikten	døndykten
døvHʃ	døviʃ	døvyʃ
dillArDA	dillerte	dillerde
formɑsjonH	formɑsjonɯ	formɑsjonu
gøzlH	gøzli	gøzly
ortɑmDAki	ortɑmtɑki	ortɑmdɑki
sɑfhɑDA	sɑfhɑtɑ	sɑfhɑdɑ
sɑnɑjinDA	sɑnɑjinte	sɑnɑjinde
toplumDAn	toplumtɑn	toplumdɑn
bølymlArDAn	bølymlerten	bølymlerden
hɑklArDAn	hɑklɑrtɑn	hɑklɑrdɑn
oturumH	oturumɯ	oturumu
seferDA	seferte	seferde
jɑjɯnlArDA	jɑjɯnlɑrtɑ	jɑjɯnlɑrdɑ
jurtlArDA	jurtlɑrtɑ	jurtlɑrdɑ
øteDAn	øteten	øteden
byjyDHkʧA	byjytikʧe	byjydykʧe
dɑvrɑnHʃlArDA	dɑvrɑnɯʃlɑrtɑ	dɑvrɑnɯʃlɑrdɑ
hɑstɑDAn	hɑstɑtɑn	hɑstɑdɑn
insɑnDAn	insɑntɑn	insɑndɑn
literɑtyrDA	literɑtyrte	literɑtyrde
noktɑlArDAn	noktɑlɑrtɑn	noktɑlɑrdɑn
normɑlDAn	normɑltɑn	normɑlden
sembollAr	sembollɑr	semboller
soruHHn	soruɯɯn	soruuun
uluslH	uluslɯ	uluslu
ulusH	ulusɯ	ulusu
virysHn	virysin	virysyn
hykymlHlAr	hykymliler	hykymlyler
kombinɑsjonH	kombinɑsjonɯ	kombinɑsjonu
otellArDA	otellerte	otellerde
sinjɑllArH	sinjɑllɑrɯ	sinjɑlleri
jykHn	jykin	jykyn
jɑrɯDA	jɑrɯtɑ	jɑrɯdɑ
dikkɑtnHzH	dikkɑtnɯzɯ	dikkɑtnizi
evreDA	evrete	evrede
forumH	forumɯ	forumu
hyʤrelArDA	hyʤrelerte	hyʤrelerde
køkH	køki	køky
menyDAki	menyteki	menydeki
olHʃ	olɯʃ	oluʃ
sizlerDAn	sizlerten	sizlerden
ujumlHlHk	ujumlɯlɯk	ujumluluk
jyzjɯllArDA	jyzjɯllɑrtɑ	jyzjɯllɑrdɑ
ʧɑɰmHzDA	ʧɑɰmɯztɑ	ʧɑɰmɯzdɑ
øzgyrlHklArHn	øzgyrliklerin	øzgyrlyklerin
yrynDA	yrynte	yrynde
bølymmHzDA	bølymmizte	bølymmyzde
hɯzlArDA	hɯzlɑrtɑ	hɯzlɑrdɑ
kodlH	kodlɯ	kodlu
kontrolA	kontrolɑ	kontrole
pɑmuklH	pɑmuklɯ	pɑmuklu
sevijelArDA	sevijelerte	sevijelerde
tɑnɯDA	tɑnɯtɑ	tɑnɯdɑ
ølymDAn	ølymten	ølymden
belgelArDAn	belgelerten	belgelerden
impɑrɑtorlHk	impɑrɑtorlɯk	impɑrɑtorluk
køjlHlArHn	køjlilerin	køjlylerin
reɑksijonH	reɑksijonɯ	reɑksijonu
rollArH	rollɑrɯ	rolleri
vɑkɑDA	vɑkɑtɑ	vɑkɑdɑ
ʧɑlɯʃmADAn	ʧɑlɯʃmɑtɑn	ʧɑlɯʃmɑdɑn
ysH	ysi	ysy
bozHʤH	bozuʤɯ	bozuʤu
durgunlHk	durgunlɯk	durgunluk
dujHnʤA	dujɯnʤɑ	dujunʤɑ
ellArDA	ellerte	ellerde
hukukʧH	hukukʧɯ	hukukʧu
kontrolnA	kontrolnɑ	kontrolne
konumHz	konumɯz	konumuz
pɑnoH	pɑnoɯ	pɑnou
poliʧeDA	poliʧete	poliʧede
toplummHzDA	toplummɯztɑ	toplummuzdɑ
ɑkɯlDA	ɑkɯltɑ	ɑkɯldɑ
bildiriDA	bildirite	bildiride
dyʃynmADAn	dyʃynmeten	dyʃynmeden
doktornHzA	doktornɯzɑ	doktornuzɑ
dozlArDA	dozlɑrtɑ	dozlɑrdɑ
girDHklArH	girtikleri	girdikleri
mɑhɑllinDA	mɑhɑllinte	mɑhɑllinde
metɑllAr	metɑllɑr	metɑller
sɑldɯrɯDA	sɑldɯrɯtɑ	sɑldɯrɯdɑ
sɑntrɑlH	sɑntrɑlɯ	sɑntrɑli
televizjonH	televizjonɯ	televizjonu
jøreDAki	jøreteki	jøredeki
borsɑDA	borsɑtɑ	borsɑdɑ
elmHzDAki	elmizteki	elmizdeki
hɑvɑDAki	hɑvɑtɑki	hɑvɑdɑki
okulHHn	okulɯɯn	okuluun
sɑɰDA	sɑɰtɑ	sɑɰdɑ
sɑjfɑmHzDA	sɑjfɑmɯztɑ	sɑjfɑmɯzdɑ
ʧøzHʤH	ʧøzyʤi	ʧøzyʤy
demADAn	demeten	demeden
gruplArDA	gruplɑrtɑ	gruplɑrdɑ
hyzynlH	hyzynli	hyzynly
hɑjɑtmHzDA	hɑjɑtmɯztɑ	hɑjɑtmɯzdɑ
iʧmHzDA	iʧmizte	iʧmizde
mɑsɑDA	mɑsɑtɑ	mɑsɑdɑ
syrelArDA	syrelerte	syrelerde
sytʧH	sytʧi	sytʧy
sytunDA	sytuntɑ	sytundɑ
senDA	sente	sende
jɑjɯnDA	jɑjɯntɑ	jɑjɯndɑ
ødyllH	ødylli	ødylly
ødemelArDA	ødemelerte	ødemelerde
yrynlArDAn	yrynlerten	yrynlerden
dikkɑtlArH	dikkɑtlɑrɯ	dikkɑtleri
hɑlsHzlHk	hɑlsɯzlɯk	hɑlsizlik
illArDAn	illerten	illerden
kuruluH	kuruluɯ	kuruluu
mɑterjɑllArH	mɑterjɑllɑrɯ	mɑterjɑlleri
personelDAn	personelten	personelden
protokollAr	protokollɑr	protokoller
sporDA	sportɑ	spordɑ
ʧoʤuklArDAn	ʧoʤuklɑrtɑn	ʧoʤuklɑrdɑn
bulguH	bulguɯ	bulguu
denizlArDA	denizlerte	denizlerde
deriDA	derite	deride
dokuznʤH	dokuznʤɯ	dokuznʤu
hɑftɑlArDA	hɑftɑlɑrtɑ	hɑftɑlɑrdɑ
kytyphɑneDAn	kytyphɑneten	kytyphɑneden
konsoloslHk	konsoloslɯk	konsolosluk
nerelArDA	nerelerte	nerelerde
orɑlArDA	orɑlɑrtɑ	orɑlɑrdɑ
progrɑmlArDAn	progrɑmlɑrtɑn	progrɑmlɑrdɑn
rektørHn	rektørin	rektøryn
telefonnHzHn	telefonnɯzɯn	telefonnuzun
televizjonlArDA	televizjonlɑrtɑ	televizjonlɑrdɑ
toplɑntɯDAn	toplɑntɯtɑn	toplɑntɯdɑn
betonHn	betonɯn	betonun
editørH	editøri	editøry
gynHHn	gyniin	gynyyn
kømyrH	kømyri	kømyry
kɑtɯlDHklArH	kɑtɯltɯklɑrɯ	kɑtɯldɯklɑrɯ
menfɑɑtlArH	menfɑɑtlɑrɯ	menfɑɑtleri
merkezDAki	merkezteki	merkezdeki
metinDA	metinte	metinde
telefonnHzA	telefonnɯzɑ	telefonnuzɑ
ʧɑɰrɯDA	ʧɑɰrɯtɑ	ʧɑɰrɯdɑ
bɑnkɑlArDAn	bɑnkɑlɑrtɑn	bɑnkɑlɑrdɑn
gyʧsHz	gyʧsiz	gyʧsyz
metɑllArHn	metɑllɑrɯn	metɑllerin
olHnʤAA	olɯnʤɑɑ	olunʤɑɑ
pyryzsHz	pyryzsiz	pyryzsyz
sɑɑtHn	sɑɑtɯn	sɑɑtin
terørH	terøri	terøry
tozlH	tozlɯ	tozlu
ʧɑlɯʃmAlArmHzDA	ʧɑlɯʃmɑlɑrmɯztɑ	ʧɑlɯʃmɑlɑrmɯzdɑ
ødemADA	ødemete	ødemede
ʃehirDAki	ʃehirteki	ʃehirdeki
bɑkmADAn	bɑkmɑtɑn	bɑkmɑdɑn
bejɑnDA	bejɑntɑ	bejɑndɑ
bizDAki	bizteki	bizdeki
buluʃH	buluʃɯ	buluʃu
buzlH	buzlɯ	buzlu
dønHʃDA	døniʃte	dønyʃte
enfeksijonHn	enfeksijonɯn	enfeksijonun
etkenlArDAn	etkenlerten	etkenlerden
hɑjɑtmDA	hɑjɑtmtɑ	hɑjɑtmdɑ
kɑdroHn	kɑdroɯn	kɑdroun
kɑrʃɯmHzDA	kɑrʃɯmɯztɑ	kɑrʃɯmɯzdɑ
koʃulsHz	koʃulsɯz	koʃulsuz
plɑtformlArDA	plɑtformlɑrtɑ	plɑtformlɑrdɑ
sɑɰlɑDHklArH	sɑɰlɑtɯklɑrɯ	sɑɰlɑdɯklɑrɯ
tijɑtroHn	tijɑtroɯn	tijɑtroun
øɰrenʤiDAn	øɰrenʤiten	øɰrenʤiden
ørneklArDAn	ørneklerten	ørneklerden
ʃehirlArɑrɑsɯ	ʃehirlɑrɑrɑsɯ	ʃehirlerɑrɑsɯ
ɑnlArDA	ɑnlɑrtɑ	ɑnlɑrdɑ
byjyklHklArH	byjyklikleri	byjyklykleri
byjyklHkDAki	byjyklikteki	byjyklykteki
borʧlHHn	borʧlɯɯn	borʧluun
gørDHkDAn	gørtikten	gørdykten
lezjonHn	lezjonɯn	lezjonun
mɑhɑlleDA	mɑhɑllete	mɑhɑllede
mɑmullArH	mɑmullɑrɯ	mɑmulleri
nedenDAn	nedenten	nedenden
sɑjfɑDAki	sɑjfɑtɑki	sɑjfɑdɑki
sinjɑllAr	sinjɑllɑr	sinjɑller
unsurlArDAn	unsurlɑrtɑn	unsurlɑrdɑn
jykymlHlHklAr	jykymlilikler	jykymlylykler
ynH	yni	yny
dɑkikɑDAn	dɑkikɑtɑn	dɑkikɑdɑn
doɰuDAn	doɰutɑn	doɰudɑn
dolɑrDAn	dolɑrtɑn	dolɑrdɑn
gøʧH	gøʧi	gøʧy
gørevlArDA	gørevlerte	gørevlerde
kitɑplArDAn	kitɑplɑrtɑn	kitɑplɑrdɑn
miktɑrDAki	miktɑrtɑki	miktɑrdɑki
telefonnHzH	telefonnɯzɯ	telefonnuzu
usullArA	usullɑrɑ	usullere
jøntemlArDAn	jøntemlerten	jøntemlerden
jɑʃɑmDAn	jɑʃɑmtɑn	jɑʃɑmdɑn
zirveDA	zirvete	zirvede
ɑrɑʧlArDAn	ɑrɑʧlɑrtɑn	ɑrɑʧlɑrdɑn
birimDA	birimte	birimde
eserlArDAn	eserlerten	eserlerden
gøkjyzynDA	gøkjyzynte	gøkjyzynde
køjHHn	køjiin	køjyyn
kɑdemeDA	kɑdemete	kɑdemede
kɑnunlArDA	kɑnunlɑrtɑ	kɑnunlɑrdɑ
memurHHn	memurɯɯn	memuruun
rɑdjoH	rɑdjoɯ	rɑdjou
tytynDA	tytynte	tytynde
terminɑllArH	terminɑllɑrɯ	terminɑlleri
uɰurlH	uɰurlɯ	uɰurlu
jɑnmHzDA	jɑnmɯztɑ	jɑnmɯzdɑ
ʧɑlɯʃmɑlArnHzDA	ʧɑlɯʃmɑlɑrnɯztɑ	ʧɑlɯʃmɑlɑrnɯzdɑ
ɑdɑDAki	ɑdɑtɑki	ɑdɑdɑki
bɑnkɑDA	bɑnkɑtɑ	bɑnkɑdɑ
birimlArDAn	birimlerten	birimlerden
deɰerDA	deɰerte	deɰerde
gyvenDA	gyvente	gyvende
hɑstɑneDAn	hɑstɑneten	hɑstɑneden
iʧmDAn	iʧmten	iʧmden
kɑrDAn	kɑrtɑn	kɑrdɑn
kontrolHHn	kontrolɯɯn	kontrolyyn
oʤɑklArDA	oʤɑklɑrtɑ	oʤɑklɑrdɑ
portføjH	portføji	portføjy
rolA	rolɑ	role
tɑbloDAki	tɑblotɑki	tɑblodɑki
bølymDAki	bølymteki	bølymdeki
dyzenDA	dyzente	dyzende
dikkɑtmH	dikkɑtmɯ	dikkɑtmi
ekonomiDAn	ekonomiten	ekonomiden
endystriDA	endystrite	endystride
gøtyrHp	gøtyrip	gøtyryp
kɑzɑnDHklArH	kɑzɑntɯklɑrɯ	kɑzɑndɯklɑrɯ
kitɑplArDA	kitɑplɑrtɑ	kitɑplɑrdɑ
kodHHn	kodɯɯn	koduun
metreDAn	metreten	metreden
pɑrtiDAn	pɑrtiten	pɑrtiden
tymørHn	tymørin	tymøryn
uʧlH	uʧlɯ	uʧlu
ulɑʃmADA	ulɑʃmɑtɑ	ulɑʃmɑdɑ
zɑrɑrlArDAn	zɑrɑrlɑrtɑn	zɑrɑrlɑrdɑn
byroDA	byrotɑ	byrodɑ
dynDAn	dynten	dynden
dolmɑDAn	dolmɑtɑn	dolmɑdɑn
etmADA	etmete	etmede
ithɑlH	ithɑlɯ	ithɑli
kurummHz	kurummɯz	kurummuz
olguHn	olguɯn	olguun
olumsuzlHklArA	olumsuzlɯklɑrɑ	olumsuzluklɑrɑ
ojunlArDA	ojunlɑrtɑ	ojunlɑrdɑ
skorH	skorɯ	skoru
sonuʧsHz	sonuʧsɯz	sonuʧsuz
suʧlArDAn	suʧlɑrtɑn	suʧlɑrdɑn
tɑsɑrɯmDA	tɑsɑrɯmtɑ	tɑsɑrɯmdɑ
teknoloʒiDA	teknoloʒite	teknoloʒide
telefonnHz	telefonnɯz	telefonnuz
ujɑrɯDA	ujɑrɯtɑ	ujɑrɯdɑ
ʧɑɰlArDA	ʧɑɰlɑrtɑ	ʧɑɰlɑrdɑ
øneriDA	ønerite	øneride
ørneklArDA	ørneklerte	ørneklerde
ʃirketlArDAn	ʃirketlerten	ʃirketlerden
ʤoɰrɑfjɑDA	ʤoɰrɑfjɑtɑ	ʤoɰrɑfjɑdɑ
dynH	dyni	dyny
hɑtlArDA	hɑtlɑrtɑ	hɑtlɑrdɑ
kɑtkɯlArDA	kɑtkɯlɑrtɑ	kɑtkɯlɑrdɑ
mɑlzemelArDAn	mɑlzemelerten	mɑlzemelerden
sɑɑtlArHHn	sɑɑtlɑrɯɯn	sɑɑtleriin
jɑɰDA	jɑɰtɑ	jɑɰdɑ
jɑrɯʃmɑlArDA	jɑrɯʃmɑlɑrtɑ	jɑrɯʃmɑlɑrdɑ
jerjyzynDAki	jerjyzynteki	jerjyzyndeki
ʧizgiDA	ʧizgite	ʧizgide
ɑlbymHn	ɑlbymin	ɑlbymyn
bɑnkɑlArDA	bɑnkɑlɑrtɑ	bɑnkɑlɑrdɑ
belgeDA	belgete	belgede
gøʧHn	gøʧin	gøʧyn
ihɑlelArDA	ihɑlelerte	ihɑlelerde
kɯsɯmDAn	kɯsɯmtɑn	kɯsɯmdɑn
kutuplH	kutuplɯ	kutuplu
mɑhkemeDAn	mɑhkemeten	mɑhkemeden
onurH	onurɯ	onuru
sɑlonHn	sɑlonɯn	sɑlonun
sezonH	sezonɯ	sezonu
turDA	turtɑ	turdɑ
ujkusHzlHk	ujkusɯzlɯk	ujkusuzluk
vɑrmADAn	vɑrmɑtɑn	vɑrmɑdɑn
jineDA	jinete	jinede
bitmADAn	bitmeten	bitmeden
doɰɑDAki	doɰɑtɑki	doɰɑdɑki
dokulArDA	dokulɑrtɑ	dokulɑrdɑ
durHʃ	durɯʃ	duruʃ
gruplArDAn	gruplɑrtɑn	gruplɑrdɑn
ilɑnDA	ilɑntɑ	ilɑndɑ
komʃulHk	komʃulɯk	komʃuluk
mɑterjɑllArHn	mɑterjɑllɑrɯn	mɑterjɑllerin
proʒeDAn	proʒeten	proʒeden
sɑtHʃlArDA	sɑtɯʃlɑrtɑ	sɑtɯʃlɑrdɑ
sitemHzDAn	sitemizten	sitemizden
suɑltɯnDA	suɑltɯntɑ	suɑltɯndɑ
teknoloʒiDAn	teknoloʒiten	teknoloʒiden
jyzHn	jyzin	jyzyn
jɑʃɑmnHzDA	jɑʃɑmnɯztɑ	jɑʃɑmnɯzdɑ
jolDAki	joltɑki	joldɑki
ʧɑmurHn	ʧɑmurɯn	ʧɑmurun
ʧoɰumHz	ʧoɰumɯz	ʧoɰumuz
ʃɑblonH	ʃɑblonɯ	ʃɑblonu
bitkilArDA	bitkilerte	bitkilerde
dyzlemDA	dyzlemte	dyzlemde
dɑllArDA	dɑllɑrtɑ	dɑllɑrdɑ
fonksijonHn	fonksijonɯn	fonksijonun
gɑjrimenkullArHn	gɑjrimenkullɑrɯn	gɑjrimenkullerin
hyʤreDA	hyʤrete	hyʤrede
kyltyrlH	kyltyrli	kyltyrly
koleksijonH	koleksijonɯ	koleksijonu
kuzejDAn	kuzejten	kuzejden
mɑkbuzHn	mɑkbuzɯn	mɑkbuzun
okuDHkDAn	okutɯktɑn	okuduktɑn
olumsuzlHklArH	olumsuzlɯklɑrɯ	olumsuzluklɑrɯ
ortɑokulH	ortɑokulɯ	ortɑokulu
siteDAn	siteten	siteden
sosH	sosɯ	sosu
tɑʃɯDHklArH	tɑʃɯtɯklɑrɯ	tɑʃɯdɯklɑrɯ
tohumlHk	tohumlɯk	tohumluk
uzɑjDA	uzɑjtɑ	uzɑjdɑ
ølʧylH	ølʧyli	ølʧyly
ʃuurH	ʃuurɯ	ʃuuru
yrynHHn	yryniin	yrynyyn
ɑlbymDA	ɑlbymte	ɑlbymde
bɑʃvuruHHn	bɑʃvuruɯɯn	bɑʃvuruuun
bɑskɯnDA	bɑskɯntɑ	bɑskɯndɑ
bilDHklArH	biltikleri	bildikleri
hususHn	hususɯn	hususun
huzursHz	huzursɯz	huzursuz
iʃtirɑkH	iʃtirɑkɯ	iʃtirɑki
kontrolsHz	kontrolsɯz	kontrolsyz
mydɑhɑleDA	mydɑhɑlete	mydɑhɑlede
menfɑɑtH	menfɑɑtɯ	menfɑɑti
mevsimDA	mevsimte	mevsimde
pɑrɑDAn	pɑrɑtɑn	pɑrɑdɑn
seʧimlArDAn	seʧimlerten	seʧimlerden
solunumH	solunumɯ	solunumu
tɑpuDA	tɑputɑ	tɑpudɑ
unlH	unlɯ	unlu
ujduH	ujduɯ	ujduu
zorlHklArA	zorlɯklɑrɑ	zorluklɑrɑ
ʧɑɰlArDAn	ʧɑɰlɑrtɑn	ʧɑɰlɑrdɑn
ʧevrenHzDAki	ʧevrenizteki	ʧevrenizdeki
ʃehirDAn	ʃehirten	ʃehirden
ɑrɑmAlArDA	ɑrɑmɑlɑrtɑ	ɑrɑmɑlɑrdɑ
belkiDA	belkite	belkide
bilgisɑjɑrlArDAn	bilgisɑjɑrlɑrtɑn	bilgisɑjɑrlɑrdɑn
dɯʃɑrɯDAki	dɯʃɑrɯtɑki	dɯʃɑrɯdɑki
dereʤelArDA	dereʤelerte	dereʤelerde
dujguH	dujguɯ	dujguu
enʒeksijonH	enʒeksijonɯ	enʒeksijonu
enstityDA	enstityte	enstityde
erkeklArDAn	erkeklerten	erkeklerden
filmlArDA	filmlerte	filmlerde
geʧirDHklArH	geʧirtikleri	geʧirdikleri
gelDHkʧA	geltikʧe	geldikʧe
hyʤrelArDAn	hyʤrelerten	hyʤrelerden
iʃlemDA	iʃlemte	iʃlemde
kɯzlArDA	kɯzlɑrtɑ	kɯzlɑrdɑ
kɑmpɑnjɑDA	kɑmpɑnjɑtɑ	kɑmpɑnjɑdɑ
kesimDAn	kesimten	kesimden
konuʃHp	konuʃɯp	konuʃup
kutuHHn	kutuɯɯn	kutuuun
okullArDAn	okullɑrtɑn	okullɑrdɑn
sɯʤɑklɯklArDA	sɯʤɑklɯklɑrtɑ	sɯʤɑklɯklɑrdɑ
sɯrɑDAki	sɯrɑtɑki	sɯrɑdɑki
sɑvɑʃlArDA	sɑvɑʃlɑrtɑ	sɑvɑʃlɑrdɑ
seʧimDAn	seʧimten	seʧimden
sempozjumDA	sempozjumtɑ	sempozjumdɑ
tɑnsijonH	tɑnsijonɯ	tɑnsijonu
tɑrihmHzDA	tɑrihmizte	tɑrihmizde
jɑʃlHlArDA	jɑʃlɯlɑrtɑ	jɑʃlɯlɑrdɑ
ølʧytH	ølʧyti	ølʧyty
ɑrɑmHzDAn	ɑrɑmɯztɑn	ɑrɑmɯzdɑn
bɯrɑkmADAn	bɯrɑkmɑtɑn	bɯrɑkmɑdɑn
dønyʃymlH	dønyʃymli	dønyʃymly
doɰumDA	doɰumtɑ	doɰumdɑ
doɰumH	doɰumɯ	doɰumu
elmDAn	elmten	elmden
hɑmurH	hɑmurɯ	hɑmuru
kømyrHn	kømyrin	kømyryn
kɑrɑDA	kɑrɑtɑ	kɑrɑdɑ
mutlulHklAr	mutlulɯklɑr	mutluluklɑr
pilotH	pilotɯ	pilotu
sytHHn	sytiin	sytyyn
sɑɰDAn	sɑɰtɑn	sɑɰdɑn
sektørDAn	sektørten	sektørden
stɑtyDA	stɑtyte	stɑtyde
suDAki	sutɑki	sudɑki
jyryHʃA	jyryiʃe	jyryyʃe
jelpɑzeDA	jelpɑzete	jelpɑzede
ʃirketmHzDA	ʃirketmizte	ʃirketmizde
ɑʃɑmɑlArDA	ɑʃɑmɑlɑrtɑ	ɑʃɑmɑlɑrdɑ
byjylH	byjyli	byjyly
bɑʃvurDHklArH	bɑʃvurtɯklɑrɯ	bɑʃvurduklɑrɯ
dønymlHk	dønymlik	dønymlyk
dynjɑmHzDA	dynjɑmɯztɑ	dynjɑmɯzdɑ
dereʤeDAki	dereʤeteki	dereʤedeki
fonksijonHHn	fonksijonɯɯn	fonksijonuun
gøryʃlH	gøryʃli	gøryʃly
gyndemDAki	gyndemteki	gyndemdeki
køjlyHn	køjlyin	køjlyyn
kɑbuklH	kɑbuklɯ	kɑbuklu
kɑrɑDAn	kɑrɑtɑn	kɑrɑdɑn
kɑrɑrDAn	kɑrɑrtɑn	kɑrɑrdɑn
kɑzɑDA	kɑzɑtɑ	kɑzɑdɑ
kolHHn	kolɯɯn	koluun
lɑborɑtuvɑrlArDA	lɑborɑtuvɑrlɑrtɑ	lɑborɑtuvɑrlɑrdɑ
mɑhkemeDA	mɑhkemete	mɑhkemede
olguHHn	olguɯɯn	olguuun
operɑsjonDAn	operɑsjontɑn	operɑsjondɑn
ormɑnDA	ormɑntɑ	ormɑndɑ
ortɑDAki	ortɑtɑki	ortɑdɑki
pɑrʧɑDAn	pɑrʧɑtɑn	pɑrʧɑdɑn
pɑrtiDA	pɑrtite	pɑrtide
profesørH	profesøri	profesøry
senelArDA	senelerte	senelerde
tɑrifeDA	tɑrifete	tɑrifede
tɑvsijelArDA	tɑvsijelerte	tɑvsijelerde
ujgulɑDHklArH	ujgulɑtɯklɑrɯ	ujgulɑdɯklɑrɯ
ujkuDA	ujkutɑ	ujkudɑ
jɑzDHklArH	jɑztɯklɑrɯ	jɑzdɯklɑrɯ
jerjyzyHn	jerjyzyin	jerjyzyyn
ɑlkolHn	ɑlkolɯn	ɑlkolyn
ɑskɯDA	ɑskɯtɑ	ɑskɯdɑ
ɑtmosferDA	ɑtmosferte	ɑtmosferde
bɑtɯDAki	bɑtɯtɑki	bɑtɯdɑki
dyʃHp	dyʃip	dyʃyp
duvɑrDAn	duvɑrtɑn	duvɑrdɑn
itirɑzDA	itirɑztɑ	itirɑzdɑ
kɑrʃɯDAn	kɑrʃɯtɑn	kɑrʃɯdɑn
logoH	logoɯ	logou
orduH	orduɯ	orduu
søzleʃmelArDA	søzleʃmelerte	søzleʃmelerde
sigɑrɑDAn	sigɑrɑtɑn	sigɑrɑdɑn
sistemlArDAn	sistemlerten	sistemlerden
solDAki	soltɑki	soldɑki
soluklH	soluklɯ	soluklu
sorunlArDA	sorunlɑrtɑ	sorunlɑrdɑ
jɑsɑlArDA	jɑsɑlɑrtɑ	jɑsɑlɑrdɑ
yniteDA	ynitete	ynitede
yniversiteDAki	yniversiteteki	yniversitedeki
bɑsɯnDAn	bɑsɯntɑn	bɑsɯndɑn
beledijelArDA	beledijelerte	beledijelerde
boɰɑzDA	boɰɑztɑ	boɰɑzdɑ
bojutHHn	bojutɯɯn	bojutuun
bulDHklArH	bultɯklɑrɯ	bulduklɑrɯ
dɑɰlArDA	dɑɰlɑrtɑ	dɑɰlɑrdɑ
fonksijonlH	fonksijonlɯ	fonksijonlu
gønderDHklArH	gøndertikleri	gønderdikleri
gøzlArDA	gøzlerte	gøzlerde
ileriDAki	ileriteki	ilerideki
køtyH	køtyi	køtyy
kɑzɑDAn	kɑzɑtɑn	kɑzɑdɑn
kesimlArDA	kesimlerte	kesimlerde
konforH	konforɯ	konforu
kutuHn	kutuɯn	kutuun
sytunH	sytunɯ	sytunu
typHn	typin	typyn
topʧHlAr	topʧɯlɑr	topʧulɑr
ulusHHn	ulusɯɯn	ulusuun
jønHHn	jøniin	jønyyn
jɑɰmurlH	jɑɰmurlɯ	jɑɰmurlu
jɑprɑklArDA	jɑprɑklɑrtɑ	jɑprɑklɑrdɑ
jɑzmADAn	jɑzmɑtɑn	jɑzmɑdɑn
joɰunlHklH	joɰunlɯklɯ	joɰunluklu
ʧoʤuklH	ʧoʤuklɯ	ʧoʤuklu
øɰrenʤilArDA	øɰrenʤilerte	øɰrenʤilerde
ɑnɑjɑsɑDA	ɑnɑjɑsɑtɑ	ɑnɑjɑsɑdɑ
ɑsɯrDA	ɑsɯrtɑ	ɑsɯrdɑ
bɑʃvurulArDA	bɑʃvurulɑrtɑ	bɑʃvurulɑrdɑ
bilgiDAn	bilgiten	bilgiden
ʤetvelDA	ʤetvelte	ʤetvelde
dønemlArDAn	dønemlerten	dønemlerden
deɰiʃmADAn	deɰiʃmeten	deɰiʃmeden
dujguHHn	dujguɯɯn	dujguuun
gøryʃHHn	gøryʃiin	gøryʃyyn
gɑjrimenkulHn	gɑjrimenkulɯn	gɑjrimenkulyn
hɑjvɑnlArDAn	hɑjvɑnlɑrtɑn	hɑjvɑnlɑrdɑn
kɑdɯnDA	kɑdɯntɑ	kɑdɯndɑ
kollH	kollɯ	kollu
konutlArDA	konutlɑrtɑ	konutlɑrdɑ
kotH	kotɯ	kotu
kurumDAki	kurumtɑki	kurumdɑki
kutuH	kutuɯ	kutuu
liselArDA	liselerte	liselerde
okuHʤHnHn	okuuʤɯnɯn	okuuʤunun
sɑlonDAn	sɑlontɑn	sɑlondɑn
seneDAn	seneten	seneden
tɑrlɑDA	tɑrlɑtɑ	tɑrlɑdɑ
tɑsɑrɯDA	tɑsɑrɯtɑ	tɑsɑrɯdɑ
teknoloʒiDAki	teknoloʒiteki	teknoloʒideki
ujkusHz	ujkusɯz	ujkusuz
ujumHn	ujumɯn	ujumun
jyzHHn	jyziin	jyzyyn
øzellHklArDA	øzelliklerte	øzelliklerde
ʃekilDAki	ʃekilteki	ʃekildeki
ɑʃɑɰɯDAn	ɑʃɑɰɯtɑn	ɑʃɑɰɯdɑn
ɑzotlH	ɑzotlɯ	ɑzotlu
bɑlkɑnlArDA	bɑlkɑnlɑrtɑ	bɑlkɑnlɑrdɑ
berɑbernDAki	berɑbernteki	berɑberndeki
døkymDA	døkymte	døkymde
døngyH	døngyi	døngyy
dekontH	dekontɯ	dekontu
dilDAki	dilteki	dildeki
dostlHklAr	dostlɯklɑr	dostluklɑr
fɑbrikɑlArDA	fɑbrikɑlɑrtɑ	fɑbrikɑlɑrdɑ
hɑriʤinDAki	hɑriʤinteki	hɑriʤindeki
hɑvuzHn	hɑvuzɯn	hɑvuzun
hɑjɑtnHzDA	hɑjɑtnɯztɑ	hɑjɑtnɯzdɑ
hormonH	hormonɯ	hormonu
hujlH	hujlɯ	hujlu
ilDAki	ilteki	ildeki
ilkbɑhɑrDA	ilkbɑhɑrtɑ	ilkbɑhɑrdɑ
klɑvjeDAn	klɑvjeten	klɑvjeden
mɑhkemelArDA	mɑhkemelerte	mɑhkemelerde
minerɑlH	minerɑlɯ	minerɑli
minerɑllArHn	minerɑllɑrɯn	minerɑllerin
progrɑmDAki	progrɑmtɑki	progrɑmdɑki
rizikoHn	rizikoɯn	rizikoun
søzleʃmeDAn	søzleʃmeten	søzleʃmeden
sɑɑtHHn	sɑɑtɯɯn	sɑɑtiin
sɑntrɑllAr	sɑntrɑllɑr	sɑntrɑller
suʧlHlHk	suʧlɯlɯk	suʧluluk
tohumH	tohumɯ	tohumu
umutsHz	umutsɯz	umutsuz
verilArDAn	verilerten	verilerden
jyksekokullArDA	jyksekokullɑrtɑ	jyksekokullɑrdɑ
bɑʃlɑDHklArH	bɑʃlɑtɯklɑrɯ	bɑʃlɑdɯklɑrɯ
bɑbɑDAn	bɑbɑtɑn	bɑbɑdɑn
bozmADAn	bozmɑtɑn	bozmɑdɑn
bulDHkʧA	bultɯkʧɑ	buldukʧɑ
ʤɑmDAn	ʤɑmtɑn	ʤɑmdɑn
dɑɰDA	dɑɰtɑ	dɑɰdɑ
dengeDA	dengete	dengede
hɑlykɑrDA	hɑlykɑrtɑ	hɑlykɑrdɑ
ilʧemHzDA	ilʧemizte	ilʧemizde
izolɑsjonH	izolɑsjonɯ	izolɑsjonu
kontrolDAn	kontroltɑn	kontrolden
konutH	konutɯ	konutu
kullɑnɯmDAn	kullɑnɯmtɑn	kullɑnɯmdɑn
okʧHlHk	okʧɯlɯk	okʧuluk
olɑnɑklArDAn	olɑnɑklɑrtɑn	olɑnɑklɑrdɑn
restorɑsjonH	restorɑsjonɯ	restorɑsjonu
sɑjfɑmHzDAn	sɑjfɑmɯztɑn	sɑjfɑmɯzdɑn
sorulArDAn	sorulɑrtɑn	sorulɑrdɑn
sponsorH	sponsorɯ	sponsoru
sunDHklArH	suntɯklɑrɯ	sunduklɑrɯ
tymørlArDA	tymørlerte	tymørlerde
tyrkyH	tyrkyi	tyrkyy
televizjonHn	televizjonɯn	televizjonun
tesislArDAn	tesislerten	tesislerden
bilɑnʧoH	bilɑnʧoɯ	bilɑnʧou
bilgilArDA	bilgilerte	bilgilerde
bilimDA	bilimte	bilimde
binɑlArDAn	binɑlɑrtɑn	binɑlɑrdɑn
dileDHklArH	diletikleri	diledikleri
dillArDAn	dillerten	dillerden
ejlemDA	ejlemte	ejlemde
gydymlH	gydymli	gydymly
hɑreketlArDA	hɑreketlerte	hɑreketlerde
kɯjɯDA	kɯjɯtɑ	kɯjɯdɑ
kɑdromHz	kɑdromɯz	kɑdromuz
kɑsɑbɑDA	kɑsɑbɑtɑ	kɑsɑbɑdɑ
kolHn	kolɯn	kolun
krizDA	krizte	krizde
lyzumH	lyzumɯ	lyzumu
odunHn	odunɯn	odunun
ojlAmADA	ojlɑmɑtɑ	ojlɑmɑdɑ
siteDAki	siteteki	sitedeki
ujgunsHz	ujgunsɯz	ujgunsuz
vergiDAn	vergiten	vergiden
vizjonmHz	vizjonmɯz	vizjonmuz
zɑmɑnmHzDA	zɑmɑnmɯztɑ	zɑmɑnmɯzdɑ
zɑrɑrDAn	zɑrɑrtɑn	zɑrɑrdɑn
ønmDA	ønmte	ønmde
bytʧeDA	bytʧete	bytʧede
dosjɑDAn	dosjɑtɑn	dosjɑdɑn
fɑkyltelArDA	fɑkyltelerte	fɑkyltelerde
gømylH	gømyli	gømyly
gørynHʃDA	gøryniʃte	gørynyʃte
gynejDAn	gynejten	gynejden
gelirDAn	gelirten	gelirden
genʧlArDA	genʧlerte	genʧlerde
gururH	gururɯ	gururu
hɑrflArHn	hɑrflɑrɯn	hɑrflerin
hɑtɑlArDAn	hɑtɑlɑrtɑn	hɑtɑlɑrdɑn
hɑjɑllAr	hɑjɑllɑr	hɑjɑller
hoʃgørylH	hoʃgøryli	hoʃgøryly
iʃleDHklArH	iʃletikleri	iʃledikleri
køpryHn	køpryin	køpryyn
kɑlDHkDAn	kɑltɯktɑn	kɑldɯktɑn
kenɑrDA	kenɑrtɑ	kenɑrdɑ
klɑsørH	klɑsøri	klɑsøry
komʃuH	komʃuɯ	komʃuu
kompozisjonH	kompozisjonɯ	kompozisjonu
kurulmHzHn	kurulmɯzɯn	kurulmuzun
modDA	modtɑ	moddɑ
olAnDAn	olɑntɑn	olɑndɑn
oturDHklArH	oturtɯklɑrɯ	oturduklɑrɯ
ruhHHn	ruhɯɯn	ruhuun
seʧeneklArDAn	seʧeneklerten	seʧeneklerden
sinemɑDA	sinemɑtɑ	sinemɑdɑ
øɰrenDHklArH	øɰrentikleri	øɰrendikleri
bilimlArDA	bilimlerte	bilimlerde
deɰerDAn	deɰerten	deɰerden
deɰerlArDAn	deɰerlerten	deɰerlerden
dekorɑsjonH	dekorɑsjonɯ	dekorɑsjonu
dosjɑDAki	dosjɑtɑki	dosjɑdɑki
duvɑrDA	duvɑrtɑ	duvɑrdɑ
enstityHHn	enstityiin	enstityyyn
eserlArDA	eserlerte	eserlerde
gøkjyzyHn	gøkjyzyin	gøkjyzyyn
geʧirmADAn	geʧirmeten	geʧirmeden
hɑstɑnemHzDA	hɑstɑnemizte	hɑstɑnemizde
iʧeriDAn	iʧeriten	iʧeriden
kɯsɯmlArDA	kɯsɯmlɑrtɑ	kɯsɯmlɑrdɑ
kɑbulA	kɑbulɑ	kɑbule
kɑzɯlArDA	kɑzɯlɑrtɑ	kɑzɯlɑrdɑ
kurtulHʃH	kurtulɯʃɯ	kurtuluʃu
okullArmHzDA	okullɑrmɯztɑ	okullɑrmɯzdɑ
oluklH	oluklɯ	oluklu
operɑtørHn	operɑtørin	operɑtøryn
otH	otɯ	otu
pɑrtilArDAn	pɑrtilerten	pɑrtilerden
sytunHn	sytunɯn	sytunun
sɑvunmADA	sɑvunmɑtɑ	sɑvunmɑdɑ
sektørlArDAn	sektørlerten	sektørlerden
uʧsHz	uʧsɯz	uʧsuz
jønergeDA	jønergete	jønergede
jɑɰmurH	jɑɰmurɯ	jɑɰmuru
jɑpɯDAn	jɑpɯtɑn	jɑpɯdɑn
jɑzDHkDAn	jɑztɯktɑn	jɑzdɯktɑn
zeminlArDA	zeminlerte	zeminlerde
ʧɑmurH	ʧɑmurɯ	ʧɑmuru
ødeDHklArH	ødetikleri	ødedikleri
yʧnʤHlHk	yʧnʤilik	yʧnʤylyk
yrynDAn	yrynten	yrynden
ɑʧmADAn	ɑʧmɑtɑn	ɑʧmɑdɑn
ɑlmADA	ɑlmɑtɑ	ɑlmɑdɑ
ɑnneDAn	ɑnneten	ɑnneden
blokH	blokɯ	bloku
bonoH	bonoɯ	bonou
deɰiʃiklHklArDAn	deɰiʃikliklerten	deɰiʃikliklerden
dosjɑlArDA	dosjɑlɑrtɑ	dosjɑlɑrdɑ
frekɑnslArDA	frekɑnslɑrtɑ	frekɑnslɑrdɑ
gørynymDA	gørynymte	gørynymde
gørDHkʧA	gørtikʧe	gørdykʧe
gøzHHn	gøziin	gøzyyn
hykymlHHn	hykymliin	hykymlyyn
hɑlHHn	hɑlɯɯn	hɑliin
hɑrflH	hɑrflɯ	hɑrfli
istɑsjonHHn	istɑsjonɯɯn	istɑsjonuun
køjlHlArH	køjlileri	køjlyleri
kɑnɑlDA	kɑnɑltɑ	kɑnɑldɑ
kɑjɯtlArDA	kɑjɯtlɑrtɑ	kɑjɯtlɑrdɑ
kimDAn	kimten	kimden
kimseDAn	kimseten	kimseden
klɑsørHn	klɑsørin	klɑsøryn
konuʃmADAn	konuʃmɑtɑn	konuʃmɑdɑn
kuʃH	kuʃɯ	kuʃu
myzeDA	myzete	myzede
memleketmHzDA	memleketmizte	memleketmizde
neDA	nete	nede
orgɑnizɑsjonDA	orgɑnizɑsjontɑ	orgɑnizɑsjondɑ
tɑbloHHn	tɑbloɯɯn	tɑblouun
jønlArDAn	jønlerten	jønlerden
jyryHʃlArH	jyryiʃleri	jyryyʃleri
jɑtɯrɯmlArDA	jɑtɯrɯmlɑrtɑ	jɑtɯrɯmlɑrdɑ
jɑtɑklArDA	jɑtɑklɑrtɑ	jɑtɑklɑrdɑ
jenilHklArDAn	jeniliklerten	jeniliklerden
ødylHn	ødylin	ødylyn
ɑdɑptørH	ɑdɑptøri	ɑdɑptøry
bɑroHn	bɑroɯn	bɑroun
birejlArDAn	birejlerten	birejlerden
bitymlH	bitymli	bitymly
bojDAn	bojtɑn	bojdɑn
durHʃH	durɯʃɯ	duruʃu
elimDAki	elimteki	elimdeki
erDAn	erten	erden
fɑɑlijetlArDAn	fɑɑlijetlerten	fɑɑlijetlerden
geʤikmADAn	geʤikmeten	geʤikmeden
hizmetnHzDA	hizmetnizte	hizmetnizde
illArDAki	illerteki	illerdeki
kɑbloHn	kɑbloɯn	kɑbloun
korkuHn	korkuɯn	korkuun
oluʃumHn	oluʃumɯn	oluʃumun
sevDHklArH	sevtikleri	sevdikleri
sonunʤuH	sonunʤuɯ	sonunʤuu
sorunmHz	sorunmɯz	sorunmuz
tyrDAki	tyrteki	tyrdeki
tɑblolArDA	tɑblolɑrtɑ	tɑblolɑrdɑ
uʧurumHn	uʧurumɯn	uʧurumun
umutlH	umutlɯ	umutlu
ʧevrenHzDA	ʧevrenizte	ʧevrenizde
ɑlemDA	ɑlemte	ɑlemde
ɑntrenørH	ɑntrenøri	ɑntrenøry
ɑrɑmADA	ɑrɑmɑtɑ	ɑrɑmɑdɑ
ɑrɑzilArDA	ɑrɑzilerte	ɑrɑzilerde
denetimlArDA	denetimlerte	denetimlerde
devirlArDA	devirlerte	devirlerde
fɑkylteDAn	fɑkylteten	fɑkylteden
fɑzDA	fɑztɑ	fɑzdɑ
gyʧsHzlHk	gyʧsizlik	gyʧsyzlyk
gyryltyH	gyryltyi	gyryltyy
hɑritɑDA	hɑritɑtɑ	hɑritɑdɑ
kɑmpusH	kɑmpusɯ	kɑmpusu
kɑrDA	kɑrtɑ	kɑrdɑ
klorlH	klorlɯ	klorlu
kolesterolH	kolesterolɯ	kolesteroly
kontrolHn	kontrolɯn	kontrolyn
konuʃmAlArDA	konuʃmɑlɑrtɑ	konuʃmɑlɑrdɑ
konutHn	konutɯn	konutun
miljonHn	miljonɯn	miljonun
optimizɑsjonH	optimizɑsjonɯ	optimizɑsjonu
ojunlArDAn	ojunlɑrtɑn	ojunlɑrdɑn
protokolHn	protokolɯn	protokolyn
sɯnɯrlArDA	sɯnɯrlɑrtɑ	sɯnɯrlɑrdɑ
sɑɰDAki	sɑɰtɑki	sɑɰdɑki
sɑɑtlArA	sɑɑtlɑrɑ	sɑɑtlere
sunuʤuHn	sunuʤuɯn	sunuʤuun
tymørH	tymøri	tymøry
tɑkvimDA	tɑkvimte	tɑkvimde
tijɑtroDA	tijɑtrotɑ	tijɑtrodɑ
turizmDA	turizmte	turizmde
tutHʃ	tutɯʃ	tutuʃ
tutukluHn	tutukluɯn	tutukluun
unutHp	unutɯp	unutup
jɯlDAki	jɯltɑki	jɯldɑki
jønetimDAn	jønetimten	jønetimden
ʧɑtɯʃmADA	ʧɑtɯʃmɑtɑ	ʧɑtɯʃmɑdɑ
ɑrenɑDA	ɑrenɑtɑ	ɑrenɑdɑ
byjyHp	byjyip	byjyyp
bɑʃørtyH	bɑʃørtyi	bɑʃørtyy
birejlArDA	birejlerte	birejlerde
bulɑʃmADAn	bulɑʃmɑtɑn	bulɑʃmɑdɑn
ʤepheDAn	ʤepheten	ʤepheden
ʤiroH	ʤiroɯ	ʤirou
depolArDA	depolɑrtɑ	depolɑrdɑ
depresjonH	depresjonɯ	depresjonu
eʤzɑnelArDA	eʤzɑnelerte	eʤzɑnelerde
gynlH	gynli	gynly
hɑllArA	hɑllɑrɑ	hɑllere
idrɑrDA	idrɑrtɑ	idrɑrdɑ
ikiDAn	ikiten	ikiden
køjlArDAn	køjlerten	køjlerden
kyltyrDA	kyltyrte	kyltyrde
kɑhvɑltɯDAn	kɑhvɑltɯtɑn	kɑhvɑltɯdɑn
kɑnɑllArDAn	kɑnɑllɑrtɑn	kɑnɑllɑrdɑn
kɑzɑlArDA	kɑzɑlɑrtɑ	kɑzɑlɑrdɑ
kemiklArDA	kemiklerte	kemiklerde
korkuDAn	korkutɑn	korkudɑn
korkulH	korkulɯ	korkulu
koroH	koroɯ	korou
koruHp	koruɯp	koruup
kurullArDA	kurullɑrtɑ	kurullɑrdɑ
mejdɑnDA	mejdɑntɑ	mejdɑndɑ
motivɑsjonH	motivɑsjonɯ	motivɑsjonu
nɑmuslH	nɑmuslɯ	nɑmuslu
normɑlHn	normɑlɯn	normɑlin
oluʃumHHn	oluʃumɯɯn	oluʃumuun
rezeksijonH	rezeksijonɯ	rezeksijonu
rolHHn	rolɯɯn	rolyyn
sɑhilDA	sɑhilte	sɑhilde
sembollArH	sembollɑrɯ	sembolleri
senɑrjoH	senɑrjoɯ	senɑrjou
temelDAn	temelten	temelden
tempoH	tempoɯ	tempou
tenʤereDA	tenʤerete	tenʤerede
uzɑklArDAn	uzɑklɑrtɑn	uzɑklɑrdɑn
jɑpɯlArDAn	jɑpɯlɑrtɑn	jɑpɯlɑrdɑn
jɑrɯjɯlDAn	jɑrɯjɯltɑn	jɑrɯjɯldɑn
jollH	jollɯ	jollu
ylkemHzDAn	ylkemizten	ylkemizden
ɑʃɑmɑlArDAn	ɑʃɑmɑlɑrtɑn	ɑʃɑmɑlɑrdɑn
ɑnɑlizDA	ɑnɑlizte	ɑnɑlizde
ɑjrɯlmɑDAn	ɑjrɯlmɑtɑn	ɑjrɯlmɑdɑn
bɑʃlArDA	bɑʃlɑrtɑ	bɑʃlɑrdɑ
dønHnʤA	døninʤe	dønynʤe
dyzenlemAlArDA	dyzenlemelerte	dyzenlemelerde
deriDAn	deriten	deriden
dolHp	dolɯp	dolup
dostmHz	dostmɯz	dostmuz
gøkjyzynH	gøkjyzyni	gøkjyzyny
girmAnHzDAn	girmenizten	girmenizden
hɑjɑllArH	hɑjɑllɑrɯ	hɑjɑlleri
kɑdɯnlArDAn	kɑdɯnlɑrtɑn	kɑdɯnlɑrdɑn
kɑslArDA	kɑslɑrtɑ	kɑslɑrdɑ
kullHk	kullɯk	kulluk
lɑborɑtuɑrDA	lɑborɑtuɑrtɑ	lɑborɑtuɑrdɑ
mɑkinɑlArDA	mɑkinɑlɑrtɑ	mɑkinɑlɑrdɑ
odɑlArDAn	odɑlɑrtɑn	odɑlɑrdɑn
pɑrlɑmentoDA	pɑrlɑmentotɑ	pɑrlɑmentodɑ
pɑrlɑmentoHn	pɑrlɑmentoɯn	pɑrlɑmentoun
politikɑDA	politikɑtɑ	politikɑdɑ
tɑrɑmɑDAn	tɑrɑmɑtɑn	tɑrɑmɑdɑn
testlArDA	testlerte	testlerde
torunH	torunɯ	torunu
ujumsHz	ujumsɯz	ujumsuz
jyzejDAn	jyzejten	jyzejden
ʃɑrtlArDAn	ʃɑrtlɑrtɑn	ʃɑrtlɑrdɑn
ʃɑrtnɑmeDA	ʃɑrtnɑmete	ʃɑrtnɑmede
ɑldɯrmADAn	ɑldɯrmɑtɑn	ɑldɯrmɑdɑn
ɑrɑbɑDA	ɑrɑbɑtɑ	ɑrɑbɑdɑ
bɑnjoH	bɑnjoɯ	bɑnjou
bizlerDAn	bizlerten	bizlerden
dɑmɑrlArDA	dɑmɑrlɑrtɑ	dɑmɑrlɑrdɑ
dolulHk	dolulɯk	doluluk
dujuH	dujuɯ	dujuu
gøryH	gøryi	gøryy
ilgiDAn	ilgiten	ilgiden
kɑbulnH	kɑbulnɯ	kɑbulny
kɑdemeDAki	kɑdemeteki	kɑdemedeki
kɑdroHHn	kɑdroɯɯn	kɑdrouun
kɑliteDAki	kɑliteteki	kɑlitedeki
koʃullH	koʃullɯ	koʃullu
konserDA	konserte	konserde
kurtulHp	kurtulɯp	kurtulup
lezjonH	lezjonɯ	lezjonu
limɑnDA	limɑntɑ	limɑndɑ
listelArDA	listelerte	listelerde
modylɑsjonH	modylɑsjonɯ	modylɑsjonu
notHn	notɯn	notun
otobysH	otobysi	otobysy
pijɑsɑlArDAki	pijɑsɑlɑrtɑki	pijɑsɑlɑrdɑki
pulH	pulɯ	pulu
rekorH	rekorɯ	rekoru
senɑtoHn	senɑtoɯn	senɑtoun
toplummHz	toplummɯz	toplummuz
turlH	turlɯ	turlu
jykselDHkʧA	jykseltikʧe	jykseldikʧe
jolsuzlHklArHn	jolsuzlɯklɑrɯn	jolsuzluklɑrɯn
ʧøkHʃ	ʧøkiʃ	ʧøkyʃ
ølymsHz	ølymsiz	ølymsyz
ølHnʤAA	ølinʤee	ølynʤee
øzgyrlHklArHHn	øzgyrlikleriin	øzgyrlykleriin
ɑɰɯzDA	ɑɰɯztɑ	ɑɰɯzdɑ
ɑlɯʃveriʃlArDA	ɑlɯʃveriʃlerte	ɑlɯʃveriʃlerde
ɑnɑdilDA	ɑnɑdilte	ɑnɑdilde
ɑrɑbɑDAn	ɑrɑbɑtɑn	ɑrɑbɑdɑn
bojDA	bojtɑ	bojdɑ
bulHʃlAr	bulɯʃlɑr	buluʃlɑr
burunDA	buruntɑ	burundɑ
ʤihɑzlArDA	ʤihɑzlɑrtɑ	ʤihɑzlɑrdɑ
doɰHp	doɰɯp	doɰup
durumlArDAn	durumlɑrtɑn	durumlɑrdɑn
enstitymHz	enstitymiz	enstitymyz
fɑktørHHn	fɑktøriin	fɑktøryyn
fotoɰrɑflArDAn	fotoɰrɑflɑrtɑn	fotoɰrɑflɑrdɑn
hɑkikɑtH	hɑkikɑtɯ	hɑkikɑti
hɑlDAki	hɑltɑki	hɑldeki
hesɑplArDA	hesɑplɑrtɑ	hesɑplɑrdɑ
hukukʧHlAr	hukukʧɯlɑr	hukukʧulɑr
inDA	inte	inde
kɯlɑvuzDA	kɯlɑvuztɑ	kɯlɑvuzdɑ
kesitlArDA	kesitlerte	kesitlerde
mɑɰdurH	mɑɰdurɯ	mɑɰduru
metinlArDA	metinlerte	metinlerde
misjonmHz	misjonmɯz	misjonmuz
modelDAn	modelten	modelden
noktɑDAki	noktɑtɑki	noktɑdɑki
okullArDAki	okullɑrtɑki	okullɑrdɑki
sɯfɯrDAn	sɯfɯrtɑn	sɯfɯrdɑn
sɯrɑlAmADA	sɯrɑlɑmɑtɑ	sɯrɑlɑmɑdɑ
sɑntrɑllArH	sɑntrɑllɑrɯ	sɑntrɑlleri
tɑhɑkkukH	tɑhɑkkukɯ	tɑhɑkkuku
telefonlArDA	telefonlɑrtɑ	telefonlɑrdɑ
tonDAn	tontɑn	tondɑn
jyrytDHklArH	jyryttikleri	jyryttykleri
ʧɯrpɯDA	ʧɯrpɯtɑ	ʧɯrpɯdɑ
ʧevrelArDA	ʧevrelerte	ʧevrelerde
ʧevremHzDA	ʧevremizte	ʧevremizde
ørtyHHn	ørtyiin	ørtyyyn
yrynmHz	yrynmiz	yrynmyz
ɑnlɑmADAn	ɑnlɑmɑtɑn	ɑnlɑmɑdɑn
bytynHn	bytynin	bytynyn
bɑhʧelArDA	bɑhʧelerte	bɑhʧelerde
bojHHn	bojɯɯn	bojuun
bozuklHklArHn	bozuklɯklɑrɯn	bozukluklɑrɯn
ʤymleDA	ʤymlete	ʤymlede
dyʃynʤeDA	dyʃynʤete	dyʃynʤede
demokrɑsilArDA	demokrɑsilerte	demokrɑsilerde
etmADHklArH	etmetikleri	etmedikleri
gøryʃHp	gøryʃip	gøryʃyp
hɑvuzlH	hɑvuzlɯ	hɑvuzlu
ilʧeDAki	ilʧeteki	ilʧedeki
kɑfɑmDA	kɑfɑmtɑ	kɑfɑmdɑ
kɑrɑʤiɰerDA	kɑrɑʤiɰerte	kɑrɑʤiɰerde
kɑrɑjoluHn	kɑrɑjoluɯn	kɑrɑjoluun
liseDA	lisete	lisede
okuDHklArH	okutɯklɑrɯ	okuduklɑrɯ
rehɑbilitɑsjonH	rehɑbilitɑsjonɯ	rehɑbilitɑsjonu
resimlArDA	resimlerte	resimlerde
resulH	resulɯ	resuly
telefonHHn	telefonɯɯn	telefonuun
terminɑllAr	terminɑllɑr	terminɑller
tesislArmHzDA	tesislermizte	tesislermizde
tutkuH	tutkuɯ	tutkuu
tuzlHlHk	tuzlɯlɯk	tuzluluk
ulɑʃɯmDA	ulɑʃɯmtɑ	ulɑʃɯmdɑ
jɑɰmurHn	jɑɰmurɯn	jɑɰmurun
ʧɑmurlH	ʧɑmurlɯ	ʧɑmurlu
ølymHHn	ølymiin	ølymyyn
ʃubeDA	ʃubete	ʃubede
ɑilelArDA	ɑilelerte	ɑilelerde
ɑrɑnHzDA	ɑrɑnɯztɑ	ɑrɑnɯzdɑ
bollHk	bollɯk	bolluk
dɑvɑDAn	dɑvɑtɑn	dɑvɑdɑn
dersnDAn	dersnten	dersnden
dujgulH	dujgulɯ	dujgulu
eklemlArDA	eklemlerte	eklemlerde
evnHzDAki	evnizteki	evnizdeki
evlArDAn	evlerten	evlerden
formDAki	formtɑki	formdɑki
iktidɑrDA	iktidɑrtɑ	iktidɑrdɑ
kɯtɑDA	kɯtɑtɑ	kɯtɑdɑ
kykyrtlH	kykyrtli	kykyrtly
kodHn	kodɯn	kodun
kujuH	kujuɯ	kujuu
lyzumsHz	lyzumsɯz	lyzumsuz
motorlArDA	motorlɑrtɑ	motorlɑrdɑ
okʧH	okʧɯ	okʧu
otelDAn	otelten	otelden
romɑnDA	romɑntɑ	romɑndɑ
sɑɰlɑmADA	sɑɰlɑmɑtɑ	sɑɰlɑmɑdɑ
sɑrɑjDA	sɑrɑjtɑ	sɑrɑjdɑ
simylɑsjonH	simylɑsjonɯ	simylɑsjonu
jɑjɯnlArDAn	jɑjɯnlɑrtɑn	jɑjɯnlɑrdɑn
joɰunlHkDA	joɰunlɯktɑ	joɰunluktɑ
ølDHkDAn	øltikten	øldykten
øzgyrlHklArA	øzgyrliklere	øzgyrlyklere
ɑrɑmHzDAki	ɑrɑmɯztɑki	ɑrɑmɯzdɑki
bɑʃørtylH	bɑʃørtyli	bɑʃørtyly
bɑkɯmDA	bɑkɯmtɑ	bɑkɯmdɑ
binɑDAn	binɑtɑn	binɑdɑn
ʤɑnlɯlArDA	ʤɑnlɯlɑrtɑ	ʤɑnlɯlɑrdɑ
ʤephelArDA	ʤephelerte	ʤephelerde
dyʃHʃH	dyʃiʃi	dyʃyʃy
dyʃynʤeDAn	dyʃynʤeten	dyʃynʤeden
deɰerlendirmAlArDA	deɰerlendirmelerte	deɰerlendirmelerde
devletlArɑrɑsɯ	devletlɑrɑrɑsɯ	devletlerɑrɑsɯ
doɰuDAki	doɰutɑki	doɰudɑki
eɰitimDAki	eɰitimteki	eɰitimdeki
erozjonH	erozjonɯ	erozjonu
etkilArDAn	etkilerten	etkilerden
etkinliklArDAn	etkinliklerten	etkinliklerden
evrenDA	evrente	evrende
gønyllylHk	gønyllylik	gønyllylyk
gynejDAki	gynejteki	gynejdeki
hykymsHz	hykymsiz	hykymsyz
hɑzɯrDA	hɑzɯrtɑ	hɑzɯrdɑ
iʃgyʤyHn	iʃgyʤyin	iʃgyʤyyn
inʤelemADAn	inʤelemeten	inʤelemeden
køjDAki	køjteki	køjdeki
kytyphɑnemHzDA	kytyphɑnemizte	kytyphɑnemizde
kɑdroDA	kɑdrotɑ	kɑdrodɑ
kɑrɑrlArDAn	kɑrɑrlɑrtɑn	kɑrɑrlɑrdɑn
kɑsɑbɑlArDA	kɑsɑbɑlɑrtɑ	kɑsɑbɑlɑrdɑ
kokusHz	kokusɯz	kokusuz
lezjonlArDA	lezjonlɑrtɑ	lezjonlɑrdɑ
mɑkineDA	mɑkinete	mɑkinede
modernizɑsjonH	modernizɑsjonɯ	modernizɑsjonu
orgɑnlArDA	orgɑnlɑrtɑ	orgɑnlɑrdɑ
protokolA	protokolɑ	protokole
siDA	site	side
sormADAn	sormɑtɑn	sormɑdɑn
sorumsHz	sorumsɯz	sorumsuz
suʧlArDA	suʧlɑrtɑ	suʧlɑrdɑ
teʃekkylH	teʃekkyli	teʃekkyly
televizjonDAn	televizjontɑn	televizjondɑn
tutDHklArH	tuttɯklɑrɯ	tuttuklɑrɯ
uɰrɑmADAn	uɰrɑmɑtɑn	uɰrɑmɑdɑn
ujkuDAn	ujkutɑn	ujkudɑn
uzmɑnlArDAn	uzmɑnlɑrtɑn	uzmɑnlɑrdɑn
jyryHʃlAr	jyryiʃler	jyryyʃler
jɑzɯmHzDA	jɑzɯmɯztɑ	jɑzɯmɯzdɑ
jetiʃkinlArDA	jetiʃkinlerte	jetiʃkinlerde
ʧekinmADAn	ʧekinmeten	ʧekinmeden
ʧizelgeDA	ʧizelgete	ʧizelgede
ønnHzA	ønnize	ønnyze
øjkyHn	øjkyin	øjkyyn
ʃoførH	ʃoføri	ʃoføry
ystynlHklArH	ystynlikleri	ystynlykleri
ɑrɑbuluʤulHk	ɑrɑbuluʤulɯk	ɑrɑbuluʤuluk
bɑhɑrDA	bɑhɑrtɑ	bɑhɑrdɑ
bulunmADHkʧA	bulunmɑtɯkʧɑ	bulunmɑdɯkʧɑ
ʤihɑzDA	ʤihɑztɑ	ʤihɑzdɑ
dɑireDA	dɑirete	dɑirede
doɰuH	doɰuɯ	doɰuu
dolgunlHk	dolgunlɯk	dolgunluk
elnHzDAn	elnizten	elnizden
etmADHk	etmetik	etmedik
gølHHn	gøliin	gølyyn
gølDA	gølte	gølde
gølgeDA	gølgete	gølgede
gylH	gyli	gyly
gyryltyHn	gyryltyin	gyryltyyn
gemiDA	gemite	gemide
geziDA	gezite	gezide
ideɑlH	ideɑlɯ	ideɑli
imkɑnlArDAn	imkɑnlɑrtɑn	imkɑnlɑrdɑn
kɯjɯlArDA	kɯjɯlɑrtɑ	kɯjɯlɑrdɑ
kyltyrmHzHn	kyltyrmizin	kyltyrmyzyn
kɑliteDAn	kɑliteten	kɑliteden
kɑmplArDA	kɑmplɑrtɑ	kɑmplɑrdɑ
ligDA	ligte	ligde
mɑlzemeDA	mɑlzemete	mɑlzemede
olumsuzlHk	olumsuzlɯk	olumsuzluk
problemlArDAn	problemlerten	problemlerden
rɑdjɑsjonHn	rɑdjɑsjonɯn	rɑdjɑsjonun
sɯnɑvlArDAn	sɯnɑvlɑrtɑn	sɯnɑvlɑrdɑn
sempozjumHn	sempozjumɯn	sempozjumun
sorHp	sorɯp	sorup
suʧlHlAr	suʧlɯlɑr	suʧlulɑr
tɑrtɯʃmAlArDA	tɑrtɯʃmɑlɑrtɑ	tɑrtɯʃmɑlɑrdɑ
temɑslArDA	temɑslɑrtɑ	temɑslɑrdɑ
testlArDAn	testlerten	testlerden
umutsHzlHk	umutsɯzlɯk	umutsuzluk
uzɑklArDA	uzɑklɑrtɑ	uzɑklɑrdɑ
vermADA	vermete	vermede
vurHʃ	vurɯʃ	vuruʃ
jɑzɯmDA	jɑzɯmtɑ	jɑzɯmdɑ
ʧøzymHHn	ʧøzymiin	ʧøzymyyn
ʧoɰumHzHn	ʧoɰumɯzɯn	ʧoɰumuzun
ønDAki	ønteki	øndeki
ørgytlArDA	ørgytlerte	ørgytlerde
yjelArmHzDAn	yjelermizten	yjelermizden
bɑjrɑmlArDA	bɑjrɑmlɑrtɑ	bɑjrɑmlɑrdɑ
deɰerlArDA	deɰerlerte	deɰerlerde
dinDAn	dinten	dinden
doɰuHn	doɰuɯn	doɰuun
dokuDA	dokutɑ	dokudɑ
dojumsHz	dojumsɯz	dojumsuz
enfeksijonlArDA	enfeksijonlɑrtɑ	enfeksijonlɑrdɑ
fijɑtlArDA	fijɑtlɑrtɑ	fijɑtlɑrdɑ
gynlArDAki	gynlerteki	gynlerdeki
geʧirDHkDAn	geʧirtikten	geʧirdikten
hɑnDAn	hɑntɑn	hɑndɑn
ilɑʧlArDAn	ilɑʧlɑrtɑn	ilɑʧlɑrdɑn
ilkokulH	ilkokulɯ	ilkokulu
ijiDAn	ijiten	ijiden
kɯsɯmDAki	kɯsɯmtɑki	kɯsɯmdɑki
kɑtɑlogH	kɑtɑlogɯ	kɑtɑlogu
konuDAn	konutɑn	konudɑn
kuʃkulH	kuʃkulɯ	kuʃkulu
myʃterilArDAn	myʃterilerten	myʃterilerden
mɑɰɑzɑlArDA	mɑɰɑzɑlɑrtɑ	mɑɰɑzɑlɑrdɑ
mɑɰdurHn	mɑɰdurɯn	mɑɰdurun
mɑhkumHn	mɑhkumɯn	mɑhkumun
miktɑrDAn	miktɑrtɑn	miktɑrdɑn
minerɑllArHHn	minerɑllɑrɯɯn	minerɑlleriin
ojunDAn	ojuntɑn	ojundɑn
penʤerelArDAn	penʤerelerten	penʤerelerden
rektørlHkʧA	rektørlikʧe	rektørlykʧe
sɑntrɑlHn	sɑntrɑlɯn	sɑntrɑlin
sɑjfɑlArmHzDA	sɑjfɑlɑrmɯztɑ	sɑjfɑlɑrmɯzdɑ
seklHnDAki	seklinteki	seklindeki
sektørmHzHn	sektørmizin	sektørmyzyn
seminerlArDA	seminerlerte	seminerlerde
sistemmHzDA	sistemmizte	sistemmizde
sistemnHzDA	sistemnizte	sistemnizde
sitelArDA	sitelerte	sitelerde
sonuʧlArDAn	sonuʧlɑrtɑn	sonuʧlɑrdɑn
stokH	stokɯ	stoku
tytynlArDAn	tytynlerten	tytynlerden
tɑvɑDA	tɑvɑtɑ	tɑvɑdɑ
telefonlArDAn	telefonlɑrtɑn	telefonlɑrdɑn
triljonlHk	triljonlɯk	triljonluk
tutuklulHk	tutuklulɯk	tutukluluk
uɰurDA	uɰurtɑ	uɰurdɑ
unsurHn	unsurɯn	unsurun
usulDA	usultɑ	usulde
jykymlHlHklArHn	jykymliliklerin	jykymlylyklerin
jyksekokulDA	jyksekokultɑ	jyksekokuldɑ
jyksekokulmHz	jyksekokulmɯz	jyksekokulmuz
jyzejDAki	jyzejteki	jyzejdeki
jɑrgɯDA	jɑrgɯtɑ	jɑrgɯdɑ
jɑzɯnDA	jɑzɯntɑ	jɑzɯndɑ
ʧoɰulʤulHk	ʧoɰulʤulɯk	ʧoɰulʤuluk
øteDA	øtete	øtede
yʧHHn	yʧiin	yʧyyn
beledijeDAn	beledijeten	beledijeden
bitkilArDAn	bitkilerten	bitkilerden
boruHHn	boruɯɯn	boruuun
bojunDAki	bojuntɑki	bojundɑki
devletlArDA	devletlerte	devletlerde
doɰɑDAn	doɰɑtɑn	doɰɑdɑn
enerʒiDAn	enerʒiten	enerʒiden
ejlemlArDA	ejlemlerte	ejlemlerde
gøstermADAn	gøstermeten	gøstermeden
gɑjrimenkullAr	gɑjrimenkullɑr	gɑjrimenkuller
gɑzetelArDAn	gɑzetelerten	gɑzetelerden
genʧlArDAn	genʧlerten	genʧlerden
ilʧelArDAn	ilʧelerten	ilʧelerden
ilDAn	ilten	ilden
kɯlɑvuzlHk	kɯlɑvuzlɯk	kɯlɑvuzluk
kɑdɯnDAn	kɑdɯntɑn	kɑdɯndɑn
kɑrʃɯnHzDA	kɑrʃɯnɯztɑ	kɑrʃɯnɯzdɑ
kendimDAn	kendimten	kendimden
kimselArDAn	kimselerten	kimselerden
koʃuH	koʃuɯ	koʃuu
komʃumHz	komʃumɯz	komʃumuz
konsɑntrɑsjonHHn	konsɑntrɑsjonɯɯn	konsɑntrɑsjonuun
konHʃ	konɯʃ	konuʃ
kurslArDA	kurslɑrtɑ	kurslɑrdɑ
kuruluʃmHz	kuruluʃmɯz	kuruluʃmuz
kuzejDAki	kuzejteki	kuzejdeki
liseDAn	liseten	liseden
mɑɰɑzɑDA	mɑɰɑzɑtɑ	mɑɰɑzɑdɑ
mɑhɑllelArDA	mɑhɑllelerte	mɑhɑllelerde
metinDAn	metinten	metinden
opsijonHn	opsijonɯn	opsijonun
orduDA	ordutɑ	ordudɑ
otojolH	otojolɯ	otojolu
oturumHn	oturumɯn	oturumun
pɑrɑʃytH	pɑrɑʃyti	pɑrɑʃyty
pɑtronH	pɑtronɯ	pɑtronu
plɑtformHn	plɑtformɯn	plɑtformun
resimDAn	resimten	resimden
søkHp	søkip	søkyp
sɑjɯDAn	sɑjɯtɑn	sɑjɯdɑn
tɑhɑmmylH	tɑhɑmmyli	tɑhɑmmyly
tedɑvilArDA	tedɑvilerte	tedɑvilerde
ujduHn	ujduɯn	ujduun
jɑsɑDAn	jɑsɑtɑn	jɑsɑdɑn
jorgunlHkDAn	jorgunlɯktɑn	jorgunluktɑn
zɑmɑnlArDAn	zɑmɑnlɑrtɑn	zɑmɑnlɑrdɑn
ølHnʤA	ølinʤe	ølynʤe
ønʤeDA	ønʤete	ønʤede
øzyrlylHk	øzyrlylik	øzyrlylyk
yniversitelArDAki	yniversitelerteki	yniversitelerdeki
yretimDAki	yretimteki	yretimdeki
ɑʒɑnDA	ɑʒɑntɑ	ɑʒɑndɑ
ɑtmosferDAki	ɑtmosferteki	ɑtmosferdeki
ɑjɯnDAki	ɑjɯntɑki	ɑjɯndɑki
byltenDA	byltente	byltende
bɑjɑnlArDA	bɑjɑnlɑrtɑ	bɑjɑnlɑrdɑ
bozuklHklArHHn	bozuklɯklɑrɯɯn	bozukluklɑrɯɯn
brɑnʃlArDA	brɑnʃlɑrtɑ	brɑnʃlɑrdɑ
dønyʃymHn	dønyʃymin	dønyʃymyn
dørtlH	dørtli	dørtly
demokrɑsiDAn	demokrɑsiten	demokrɑsiden
dikkɑtmHzH	dikkɑtmɯzɯ	dikkɑtmizi
duvɑrlArDA	duvɑrlɑrtɑ	duvɑrlɑrdɑ
etkiDA	etkite	etkide
fermɑntɑsjonHn	fermɑntɑsjonɯn	fermɑntɑsjonun
formlArDA	formlɑrtɑ	formlɑrdɑ
futbolH	futbolɯ	futbolu
gørevlArDAn	gørevlerten	gørevlerden
geliʃmADA	geliʃmete	geliʃmede
globɑllAʃAn	globɑllɑʃɑn	globɑlleʃen
hɑlHn	hɑlɯn	hɑlin
husulA	husulɑ	husule
køʃeDAki	køʃeteki	køʃedeki
koʃullArDAn	koʃullɑrtɑn	koʃullɑrdɑn
kopHp	kopɯp	kopup
orgɑnizɑsjonlArDA	orgɑnizɑsjonlɑrtɑ	orgɑnizɑsjonlɑrdɑ
ojlArDA	ojlɑrtɑ	ojlɑrdɑ
ojunHHn	ojunɯɯn	ojunuun
pɑrʧɑlArDAn	pɑrʧɑlɑrtɑn	pɑrʧɑlɑrdɑn
penʤereDAki	penʤereteki	penʤeredeki
søjlemADAn	søjlemeten	søjlemeden
sɑnɯklArDAn	sɑnɯklɑrtɑn	sɑnɯklɑrdɑn
sorumlulHklArHHn	sorumlulɯklɑrɯɯn	sorumluluklɑrɯɯn
tørenlArDA	tørenlerte	tørenlerde
tɑrɑfnHzDAn	tɑrɑfnɯztɑn	tɑrɑfnɯzdɑn
tehlikeDA	tehlikete	tehlikede
telefonnHzDAn	telefonnɯztɑn	telefonnuzdɑn
tiplArDA	tiplerte	tiplerde
toplɑDHklArH	toplɑtɯklɑrɯ	toplɑdɯklɑrɯ
ujgulɑmɑDAki	ujgulɑmɑtɑki	ujgulɑmɑdɑki
ujkuH	ujkuɯ	ujkuu
jønetimlArDA	jønetimlerte	jønetimlerde
jønetmeliklArDA	jønetmeliklerte	jønetmeliklerde
jɑʃɑmmHzDA	jɑʃɑmmɯztɑ	jɑʃɑmmɯzdɑ
jɑtɯrɯmlArDAn	jɑtɯrɯmlɑrtɑn	jɑtɯrɯmlɑrdɑn
zorlHklArHn	zorlɯklɑrɯn	zorluklɑrɯn
ʧøkHʃH	ʧøkiʃi	ʧøkyʃy
ʧoʤuklArDAki	ʧoʤuklɑrtɑki	ʧoʤuklɑrdɑki
ølmADAn	ølmeten	ølmeden
ønHHn	øniin	ønyyn
øzgyrlHkʧH	øzgyrlikʧi	øzgyrlykʧy
ʃejDA	ʃejte	ʃejde
ɑʧɯmHzDAn	ɑʧɯmɯztɑn	ɑʧɯmɯzdɑn
ɑɰDAki	ɑɰtɑki	ɑɰdɑki
bɑɰlɑntɯDA	bɑɰlɑntɯtɑ	bɑɰlɑntɯdɑ
bɑjrɑmDA	bɑjrɑmtɑ	bɑjrɑmdɑ
bilgisɑjɑrDAki	bilgisɑjɑrtɑki	bilgisɑjɑrdɑki
bozuklHklArA	bozuklɯklɑrɑ	bozukluklɑrɑ
broʃyrH	broʃyri	broʃyry
bulutlH	bulutlɯ	bulutlu
ʤɑddeDA	ʤɑddete	ʤɑddede
døkymHn	døkymin	døkymyn
dɑvrɑnHʃlArDAn	dɑvrɑnɯʃlɑrtɑn	dɑvrɑnɯʃlɑrdɑn
denejlArDA	denejlerte	denejlerde
depremlArDA	depremlerte	depremlerde
eɰitimlArDA	eɰitimlerte	eɰitimlerde
ebɑtlArDA	ebɑtlɑrtɑ	ebɑtlɑrdɑ
edinDHklArH	edintikleri	edindikleri
ekimDA	ekimte	ekimde
finɑlA	finɑlɑ	finɑle
geʧmADHkʧA	geʧmetikʧe	geʧmedikʧe
geriDAn	geriten	geriden
iʃletmelArDAn	iʃletmelerten	iʃletmelerden
kɯrɯklArDA	kɯrɯklɑrtɑ	kɯrɯklɑrdɑ
kɑnunDAn	kɑnuntɑn	kɑnundɑn
kɑrɑkolDA	kɑrɑkoltɑ	kɑrɑkoldɑ
kɑtɯnDAki	kɑtɯntɑki	kɑtɯndɑki
kɑjɑʧlArDA	kɑjɑʧlɑrtɑ	kɑjɑʧlɑrdɑ
komisjonlArDA	komisjonlɑrtɑ	komisjonlɑrdɑ
konuʃmAlArDAn	konuʃmɑlɑrtɑn	konuʃmɑlɑrdɑn
mɑllArDA	mɑllɑrtɑ	mɑllɑrdɑ
mesɑfeDAn	mesɑfeten	mesɑfeden
okumADAn	okumɑtɑn	okumɑdɑn
olDHklArHHn	oltɯklɑrɯɯn	olduklɑrɯɯn
orgɑnizɑsjonHHn	orgɑnizɑsjonɯɯn	orgɑnizɑsjonuun
plɑnDAki	plɑntɑki	plɑndɑki
profesørlHk	profesørlik	profesørlyk
protokolHHn	protokolɯɯn	protokolyyn
rɑdjoDA	rɑdjotɑ	rɑdjodɑ
syryʤyH	syryʤyi	syryʤyy
sɑhɑDAki	sɑhɑtɑki	sɑhɑdɑki
sɑlonHHn	sɑlonɯɯn	sɑlonuun
sejɑhɑtH	sejɑhɑtɯ	sejɑhɑti
solH	solɯ	solu
sorHnʤA	sorɯnʤɑ	sorunʤɑ
suʧlHlArHn	suʧlɯlɑrɯn	suʧlulɑrɯn
teʃekkyllH	teʃekkylli	teʃekkylly
tebliɰDA	tebliɰte	tebliɰde
tulumH	tulumɯ	tulumu
jolluksHz	jolluksɯz	jolluksuz
ʧoklHk	ʧoklɯk	ʧokluk
ʧubuklH	ʧubuklɯ	ʧubuklu
ʃokH	ʃokɯ	ʃoku
ʃuurlH	ʃuurlɯ	ʃuurlu
ɑɰlArDA	ɑɰlɑrtɑ	ɑɰlɑrdɑ
bɑʃvurunHzH	bɑʃvurunɯzɯ	bɑʃvurunuzu
bɑnjoDA	bɑnjotɑ	bɑnjodɑ
birimDAn	birimten	birimden
ʤemɑɑtH	ʤemɑɑtɯ	ʤemɑɑti
ʤAr	ʤɑr	ʤer
ʤihɑnDA	ʤihɑntɑ	ʤihɑndɑ
dyɰynlArDA	dyɰynlerte	dyɰynlerde
dyʃHʃlAr	dyʃiʃler	dyʃyʃler
devletlArDAn	devletlerten	devletlerden
editørDAn	editørten	editørden
fɯkrɑDAki	fɯkrɑtɑki	fɯkrɑdɑki
gøzlArDAn	gøzlerten	gøzlerden
hɑreketlArDAn	hɑreketlerten	hɑreketlerden
hɑrfHn	hɑrfɯn	hɑrfin
hekimDAn	hekimten	hekimden
iʧerDHklArH	iʧertikleri	iʧerdikleri
imɑlH	imɑlɯ	imɑli
isimlArDAn	isimlerten	isimlerden
kyltyrDAn	kyltyrten	kyltyrden
kyrsyH	kyrsyi	kyrsyy
kɑdɑstroH	kɑdɑstroɯ	kɑdɑstrou
kɑrʃɯDAki	kɑrʃɯtɑki	kɑrʃɯdɑki
kɑjɯtlArDAn	kɑjɯtlɑrtɑn	kɑjɯtlɑrdɑn
kongrelArDA	kongrelerte	kongrelerde
kullAnHʤHDAn	kullɑnɯʤɯtɑn	kullɑnɯʤɯdɑn
mɑlzemelArDA	mɑlzemelerte	mɑlzemelerde
oluʃmADAn	oluʃmɑtɑn	oluʃmɑdɑn
ryzgɑrDAn	ryzgɑrtɑn	ryzgɑrdɑn
rɑflArDA	rɑflɑrtɑ	rɑflɑrdɑ
sɑtɯrDAki	sɑtɯrtɑki	sɑtɯrdɑki
sɑjfɑlArDAn	sɑjfɑlɑrtɑn	sɑjfɑlɑrdɑn
sektørlArDAki	sektørlerteki	sektørlerdeki
servislArDA	servislerte	servislerde
stɑndDA	stɑndtɑ	stɑnddɑ
tɑbɑnDAn	tɑbɑntɑn	tɑbɑndɑn
tɑmɑmlɑnmADAn	tɑmɑmlɑnmɑtɑn	tɑmɑmlɑnmɑdɑn
tɑsɑrɯmDAn	tɑsɑrɯmtɑn	tɑsɑrɯmdɑn
tɑtilDA	tɑtilte	tɑtilde
tekneDA	teknete	teknede
tekrɑrDAn	tekrɑrtɑn	tekrɑrdɑn
ujHp	ujɯp	ujup
virysHHn	virysiin	virysyyn
jɑrdɯmlArDAn	jɑrdɯmlɑrtɑn	jɑrdɯmlɑrdɑn
jolmHzA	jolmɯzɑ	jolmuzɑ
ʧøzynyrlyklH	ʧøzynyrlykli	ʧøzynyrlykly
ʧizimDA	ʧizimte	ʧizimde
øɰretmenlArDAn	øɰretmenlerten	øɰretmenlerden
øzelDA	øzelte	øzelde
ʃiirDA	ʃiirte	ʃiirde
ɑɰɑʧlArDA	ɑɰɑʧlɑrtɑ	ɑɰɑʧlɑrdɑ
ɑdɯmDAn	ɑdɯmtɑn	ɑdɯmdɑn
ɑnimɑsjonH	ɑnimɑsjonɯ	ɑnimɑsjonu
ɑrɑDHklArH	ɑrɑtɯklɑrɯ	ɑrɑdɯklɑrɯ
byroHn	byroɯn	byroun
bizlerDA	bizlerte	bizlerde
ʤevɑplAmAnHzDAn	ʤevɑplɑmɑnɯztɑn	ʤevɑplɑmɑnɯzdɑn
dyʃmADAn	dyʃmeten	dyʃmeden
dyzenlemADA	dyzenlemete	dyzenlemede
demirDAn	demirten	demirden
dokuH	dokuɯ	dokuu
ekrɑnlArDA	ekrɑnlɑrtɑ	ekrɑnlɑrdɑ
enerʒiDA	enerʒite	enerʒide
filoH	filoɯ	filou
finɑlDA	finɑltɑ	finɑlde
fotoɰrɑflArDA	fotoɰrɑflɑrtɑ	fotoɰrɑflɑrdɑ
hesɑplAmADA	hesɑplɑmɑtɑ	hesɑplɑmɑdɑ
iʃgɑlA	iʃgɑlɑ	iʃgɑle
ihmɑlH	ihmɑlɯ	ihmɑli
kɑrɑkterDAn	kɑrɑkterten	kɑrɑkterden
kɑtlArDA	kɑtlɑrtɑ	kɑtlɑrdɑ
kesimlArDAn	kesimlerten	kesimlerden
komutHHn	komutɯɯn	komutuun
kurumlArDAki	kurumlɑrtɑki	kurumlɑrdɑki
mɑmullAr	mɑmullɑr	mɑmuller
metreDA	metrete	metrede
mitingDA	mitingte	mitingde
okulmHzA	okulmɯzɑ	okulmuzɑ
okuHnʤA	okuɯnʤɑ	okuunʤɑ
operɑsjonlArDA	operɑsjonlɑrtɑ	operɑsjonlɑrdɑ
otobysHn	otobysin	otobysyn
sɯkɯntɯlArDAn	sɯkɯntɯlɑrtɑn	sɯkɯntɯlɑrdɑn
sɯnɯrDA	sɯnɯrtɑ	sɯnɯrdɑ
sinDA	sinte	sinde
sorumluHHn	sorumluɯɯn	sorumluuun
suʧlHlArH	suʧlɯlɑrɯ	suʧlulɑrɯ
sunuʤuDA	sunuʤutɑ	sunuʤudɑ
sunuʤuDAn	sunuʤutɑn	sunuʤudɑn
tɑbɑnDA	tɑbɑntɑ	tɑbɑndɑ
toplɑmDA	toplɑmtɑ	toplɑmdɑ
uɰrɑDHklArH	uɰrɑtɯklɑrɯ	uɰrɑdɯklɑrɯ
ulɑʃmADAn	ulɑʃmɑtɑn	ulɑʃmɑdɑn
unsurHHn	unsurɯɯn	unsuruun
jøntemDAn	jøntemten	jøntemden
jɑvruH	jɑvruɯ	jɑvruu
jɑzɯlArDAn	jɑzɯlɑrtɑn	jɑzɯlɑrdɑn
jetkilHlArDAn	jetkililerten	jetkililerden
ʧɯkɑrmɑDAn	ʧɯkɑrmɑtɑn	ʧɯkɑrmɑdɑn
yniteDAn	yniteten	yniteden
ɑɰɑʧlArDAn	ɑɰɑʧlɑrtɑn	ɑɰɑʧlɑrdɑn
ɑnlɑmDAki	ɑnlɑmtɑki	ɑnlɑmdɑki
bejinDAki	bejinteki	bejindeki
bojutlArDAki	bojutlɑrtɑki	bojutlɑrdɑki
ʤezɑDAn	ʤezɑtɑn	ʤezɑdɑn
døngyHn	døngyin	døngyyn
deDHkDAn	detikten	dedikten
defɑDAn	defɑtɑn	defɑdɑn
doktornHzHn	doktornɯzɯn	doktornuzun
dokulH	dokulɯ	dokulu
ejlylDA	ejlylte	ejlylde
fɑbrikɑmHzDA	fɑbrikɑmɯztɑ	fɑbrikɑmɯzdɑ
fɑktørHn	fɑktørin	fɑktøryn
filozofH	filozofɯ	filozofu
fosforlH	fosforlɯ	fosforlu
gørynyrDA	gørynyrte	gørynyrde
gøzmHn	gøzmin	gøzmyn
gebelArDA	gebelerte	gebelerde
gemilArDA	gemilerte	gemilerde
hɑrmɑnlArDA	hɑrmɑnlɑrtɑ	hɑrmɑnlɑrdɑ
ilkelArDAn	ilkelerten	ilkelerden
istɑsjonDA	istɑsjontɑ	istɑsjondɑ
istemDA	istemte	istemde
kyltyrmHz	kyltyrmiz	kyltyrmyz
kɑnɑllArDA	kɑnɑllɑrtɑ	kɑnɑllɑrdɑ
kɑnunsHz	kɑnunsɯz	kɑnunsuz
komisjonmHz	komisjonmɯz	komisjonmuz
komutHn	komutɯn	komutun
koridorDA	koridortɑ	koridordɑ
kutuDA	kututɑ	kutudɑ
mɑkɑmlArDAn	mɑkɑmlɑrtɑn	mɑkɑmlɑrdɑn
numɑrɑDAn	numɑrɑtɑn	numɑrɑdɑn
obstryksijonH	obstryksijonɯ	obstryksijonu
otelmHzDA	otelmizte	otelmizde
pyryzlH	pyryzli	pyryzly
pɑrʧɑlArDA	pɑrʧɑlɑrtɑ	pɑrʧɑlɑrdɑ
pɑzɑrDAn	pɑzɑrtɑn	pɑzɑrdɑn
sɑldɯrɯDAn	sɑldɯrɯtɑn	sɑldɯrɯdɑn
sɑldɯrɯlArDA	sɑldɯrɯlɑrtɑ	sɑldɯrɯlɑrdɑ
senɑtoHHn	senɑtoɯɯn	senɑtouun
sorumlHlAr	sorumlɯlɑr	sorumlulɑr
sunuʤuHHn	sunuʤuɯɯn	sunuʤuuun
tɑɑrruzH	tɑɑrruzɯ	tɑɑrruzu
tɑburH	tɑburɯ	tɑburu
tɑvukʧHlHk	tɑvukʧɯlɯk	tɑvukʧuluk
uʧHp	uʧɯp	uʧup
vɑtɑndɑʃlArDAn	vɑtɑndɑʃlɑrtɑn	vɑtɑndɑʃlɑrdɑn
jolsuzlHklAr	jolsuzlɯklɑr	jolsuzluklɑr
zorunlulHklAr	zorunlulɯklɑr	zorunluluklɑr
ʧɯkɑrDHklArH	ʧɯkɑrtɯklɑrɯ	ʧɯkɑrdɯklɑrɯ
ʧevremHzDAki	ʧevremizteki	ʧevremizdeki
ɯsɯDA	ɯsɯtɑ	ɯsɯdɑ
ɑdɑptɑsjonH	ɑdɑptɑsjonɯ	ɑdɑptɑsjonu
ɑvDAn	ɑvtɑn	ɑvdɑn
bɑromHz	bɑromɯz	bɑromuz
boɰHʤH	boɰuʤɯ	boɰuʤu
dyʃynʤelArDAn	dyʃynʤelerten	dyʃynʤelerden
dykkɑnDA	dykkɑntɑ	dykkɑndɑ
deɰiʃimDAn	deɰiʃimten	deɰiʃimden
deɰmADAn	deɰmeten	deɰmeden
denetimDAn	denetimten	denetimden
dergimHzDA	dergimizte	dergimizde
dinlenDHkDAn	dinlentikten	dinlendikten
ekimDAn	ekimten	ekimden
formylHn	formylin	formylyn
gøryʃmeDAn	gøryʃmeten	gøryʃmeden
gerʧeklArDAn	gerʧeklerten	gerʧeklerden
hɑʤimDA	hɑʤimte	hɑʤimde
hɑlmA	hɑlmɑ	hɑlme
hususlArDAn	hususlɑrtɑn	hususlɑrdɑn
iʧmHzDAki	iʧmizteki	iʧmizdeki
istemADAn	istemeten	istemeden
køpyklH	køpykli	køpykly
kytyphɑnelArDA	kytyphɑnelerte	kytyphɑnelerde
kɑplArDA	kɑplɑrtɑ	kɑplɑrdɑ
komplikɑsjonH	komplikɑsjonɯ	komplikɑsjonu
kortH	kortɯ	kortu
kristɑllArH	kristɑllɑrɯ	kristɑlleri
kulH	kulɯ	kulu
kumHn	kumɯn	kumun
mylkH	mylki	mylky
mɑmulHn	mɑmulɯn	mɑmulyn
mekɑnDAn	mekɑntɑn	mekɑndɑn
mevzuH	mevzuɯ	mevzuu
molekylH	molekyli	molekyly
mukozɑDA	mukozɑtɑ	mukozɑdɑ
odunH	odunɯ	odunu
ordumHzHn	ordumɯzɯn	ordumuzun
pɑsɑportH	pɑsɑportɯ	pɑsɑportu
rezervɑsjonH	rezervɑsjonɯ	rezervɑsjonu
søzmHz	søzmiz	søzmyz
sensørH	sensøri	sensøry
sejɑhɑtA	sejɑhɑtɑ	sejɑhɑte
sezonHn	sezonɯn	sezonun
sonHHn	sonɯɯn	sonuun
sporHHn	sporɯɯn	sporuun
stɑtyHHn	stɑtyiin	stɑtyyyn
tɑnsijonHn	tɑnsijonɯn	tɑnsijonun
tepeDA	tepete	tepede
tesʤilDAn	tesʤilten	tesʤilden
tijɑtroH	tijɑtroɯ	tijɑtrou
tonHn	tonɯn	tonun
turnuvɑDA	turnuvɑtɑ	turnuvɑdɑ
tutumHn	tutumɯn	tutumun
uʧHʃH	uʧɯʃɯ	uʧuʃu
jɑnmDAki	jɑnmtɑki	jɑnmdɑki
jɑjɯnDAn	jɑjɯntɑn	jɑjɯndɑn
jɑzɯDAn	jɑzɯtɑn	jɑzɯdɑn
jemeklArDAn	jemeklerten	jemeklerden
zɑmɑnlArDAki	zɑmɑnlɑrtɑki	zɑmɑnlɑrdɑki
øɰretmenDAn	øɰretmenten	øɰretmenden
ørtyHn	ørtyin	ørtyyn
ʃɑmpijonlHk	ʃɑmpijonlɯk	ʃɑmpijonluk
ɑnɑlizlArDA	ɑnɑlizlerte	ɑnɑlizlerde
ɑnlɑʃmɑDA	ɑnlɑʃmɑtɑ	ɑnlɑʃmɑdɑ
byjyklHklAr	byjyklikler	byjyklykler
bɑʃɑrɯDA	bɑʃɑrɯtɑ	bɑʃɑrɯdɑ
bilgisɑjɑrnHzDAki	bilgisɑjɑrnɯztɑki	bilgisɑjɑrnɯzdɑki
bilmADHklArH	bilmetikleri	bilmedikleri
bulHnʤA	bulɯnʤɑ	bulunʤɑ
dyʃHʃA	dyʃiʃe	dyʃyʃe
dyzenlemAlArDAn	dyzenlemelerten	dyzenlemelerden
dɑmɑrDAn	dɑmɑrtɑn	dɑmɑrdɑn
demirjoluHn	demirjoluɯn	demirjoluun
dujHp	dujɯp	dujup
evnHzDAn	evnizten	evnizden
hɑkikɑtA	hɑkikɑtɑ	hɑkikɑte
huzurnHzDA	huzurnɯztɑ	huzurnuzdɑ
iʃletmeDAn	iʃletmeten	iʃletmeden
køʃkH	køʃki	køʃky
køpryDAn	køpryten	køpryden
kɑmjonHn	kɑmjonɯn	kɑmjonun
kɑrʃɯmDA	kɑrʃɯmtɑ	kɑrʃɯmdɑ
koʃHp	koʃɯp	koʃup
kolDAn	koltɑn	koldɑn
kojDHklArH	kojtɯklɑrɯ	kojduklɑrɯ
kuʃHn	kuʃɯn	kuʃun
lokɑntɑDA	lokɑntɑtɑ	lokɑntɑdɑ
myʃteriDAn	myʃteriten	myʃteriden
mɑʤunH	mɑʤunɯ	mɑʤunu
modylDA	modylte	modylde
noterDA	noterte	noterde
oʤɑklArDAn	oʤɑklɑrtɑn	oʤɑklɑrdɑn
odɑDAki	odɑtɑki	odɑdɑki
olumsuzlHklArn	olumsuzlɯklɑrn	olumsuzluklɑrn
plɑtformHHn	plɑtformɯɯn	plɑtformuun
progrɑmmHzDA	progrɑmmɯztɑ	progrɑmmɯzdɑ
sɑɰdujulH	sɑɰdujulɯ	sɑɰdujulu
sektørmHz	sektørmiz	sektørmyz
suʧsHz	suʧsɯz	suʧsuz
tymDAn	tymten	tymden
tɑʃlArDAn	tɑʃlɑrtɑn	tɑʃlɑrdɑn
tijɑtroHHn	tijɑtroɯɯn	tijɑtrouun
toprɑklArDAn	toprɑklɑrtɑn	toprɑklɑrdɑn
usɑnmADAn	usɑnmɑtɑn	usɑnmɑdɑn
usulsHz	usulsɯz	usulsyz
ujɑrɯlArDA	ujɑrɯlɑrtɑ	ujɑrɯlɑrdɑ
vurHp	vurɯp	vurup
jyzjɯlDAki	jyzjɯltɑki	jyzjɯldɑki
jɑɰDAn	jɑɰtɑn	jɑɰdɑn
jijeʤeklArDAn	jijeʤeklerten	jijeʤeklerden
jolʤuHn	jolʤuɯn	jolʤuun
jumurtɑDAn	jumurtɑtɑn	jumurtɑdɑn
ʧølDA	ʧølte	ʧølde
ʧɑdɯrlArDA	ʧɑdɯrlɑrtɑ	ʧɑdɯrlɑrdɑ
ʧekmADAn	ʧekmeten	ʧekmeden
ønlemADA	ønlemete	ønlemede
øjkyH	øjkyi	øjkyy
ɑʧɯklɑmADAn	ɑʧɯklɑmɑtɑn	ɑʧɯklɑmɑdɑn
ɑksɑmADAn	ɑksɑmɑtɑn	ɑksɑmɑdɑn
ɑlkolsHz	ɑlkolsɯz	ɑlkolsyz
ɑrɑʃtɯrmAlArDAn	ɑrɑʃtɯrmɑlɑrtɑn	ɑrɑʃtɯrmɑlɑrdɑn
ɑskerDAn	ɑskerten	ɑskerden
ɑtøljeDA	ɑtøljete	ɑtøljede
bulunDHkDAn	buluntɯktɑn	bulunduktɑn
burunDAn	buruntɑn	burundɑn
ʤemɑɑtHn	ʤemɑɑtɯn	ʤemɑɑtin
ʤoʃkuH	ʤoʃkuɯ	ʤoʃkuu
dɑɰlArDAn	dɑɰlɑrtɑn	dɑɰlɑrdɑn
deɰiʃiklHklArDA	deɰiʃikliklerte	deɰiʃikliklerde
doɰrultuH	doɰrultuɯ	doɰrultuu
durumnHz	durumnɯz	durumnuz
enstitymHzDA	enstitymizte	enstitymyzde
eriʃimDA	eriʃimte	eriʃimde
eserDAn	eserten	eserden
evmHzDA	evmizte	evmizde
fɑturɑDA	fɑturɑtɑ	fɑturɑdɑ
felsefeDA	felsefete	felsefede
gøryʃmelArDAn	gøryʃmelerten	gøryʃmelerden
gøzmHz	gøzmiz	gøzmyz
getirmADA	getirmete	getirmede
hykymDAn	hykymten	hykymden
hɑberlArDA	hɑberlerte	hɑberlerde
hɑllArHn	hɑllɑrɯn	hɑllerin
hɑrʤɑmAlArDA	hɑrʤɑmɑlɑrtɑ	hɑrʤɑmɑlɑrdɑ
iʧeriDAki	iʧeriteki	iʧerideki
inʤeleDHkDAn	inʤeletikten	inʤeledikten
istɑsjonlArDA	istɑsjonlɑrtɑ	istɑsjonlɑrdɑ
kɯjɯDAn	kɯjɯtɑn	kɯjɯdɑn
kyrsyDAn	kyrsyten	kyrsyden
kɑhveDA	kɑhvete	kɑhvede
kɑnɑɑtH	kɑnɑɑtɯ	kɑnɑɑti
kɑnunDAki	kɑnuntɑki	kɑnundɑki
kɑsɑDA	kɑsɑtɑ	kɑsɑdɑ
kɑtkɯlArDAn	kɑtkɯlɑrtɑn	kɑtkɯlɑrdɑn
kelimelArDAn	kelimelerten	kelimelerden
kereDA	kerete	kerede
kilolH	kilolɯ	kilolu
konumHHn	konumɯɯn	konumuun
kristɑlHn	kristɑlɯn	kristɑlin
kurʃunlH	kurʃunlɯ	kurʃunlu
mɑkinelArDA	mɑkinelerte	mɑkinelerde
mɑrketlArDA	mɑrketlerte	mɑrketlerde
memeDA	memete	memede
menfɑɑtlAr	menfɑɑtlɑr	menfɑɑtler
metinlArDAn	metinlerten	metinlerden
mimɑriDA	mimɑrite	mimɑride
morɑlH	morɑlɯ	morɑli
olHʃHHn	olɯʃɯɯn	oluʃuun
ovɑDA	ovɑtɑ	ovɑdɑ
pɑrselDA	pɑrselte	pɑrselde
progrɑmlArDAki	progrɑmlɑrtɑki	progrɑmlɑrdɑki
rɑkɑmlArDAn	rɑkɑmlɑrtɑn	rɑkɑmlɑrdɑn
reformHHn	reformɯɯn	reformuun
renklArDAn	renklerten	renklerden
sɯnɯflArDAn	sɯnɯflɑrtɑn	sɯnɯflɑrdɑn
sɑntrɑllArDA	sɑntrɑllɑrtɑ	sɑntrɑllɑrdɑ
sɑntrɑllArHn	sɑntrɑllɑrɯn	sɑntrɑllerin
sɑjɯlArDA	sɑjɯlɑrtɑ	sɑjɯlɑrdɑ
semtlArDA	semtlerte	semtlerde
sermɑjeDAn	sermɑjeten	sermɑjeden
silɑhlArDAn	silɑhlɑrtɑn	silɑhlɑrdɑn
sitenHzDA	sitenizte	sitenizde
tɑhtɑDAn	tɑhtɑtɑn	tɑhtɑdɑn
tɑrɑfmDAn	tɑrɑfmtɑn	tɑrɑfmdɑn
tehlikelArDAn	tehlikelerten	tehlikelerden
tekerryrH	tekerryri	tekerryry
tesismHzDA	tesismizte	tesismizde
tuzHn	tuzɯn	tuzun
viryslH	virysli	virysly
jɑʃɑmDAki	jɑʃɑmtɑki	jɑʃɑmdɑki
jɑkɯnDAki	jɑkɯntɑki	jɑkɯndɑki
jɑngɯnDAn	jɑngɯntɑn	jɑngɯndɑn
jemeklArDA	jemeklerte	jemeklerde
zorH	zorɯ	zoru
yzymH	yzymi	yzymy
ɑntrenørlHk	ɑntrenørlik	ɑntrenørlyk
ɑrmutlH	ɑrmutlɯ	ɑrmutlu
ɑvɑntɑʒlArDAn	ɑvɑntɑʒlɑrtɑn	ɑvɑntɑʒlɑrdɑn
ɑvluHn	ɑvluɯn	ɑvluun
byroHHn	byroɯɯn	byrouun
bɑʤɑklArDA	bɑʤɑklɑrtɑ	bɑʤɑklɑrdɑ
beledijeDA	beledijete	beledijede
betonH	betonɯ	betonu
borsɑDAki	borsɑtɑki	borsɑdɑki
bulunmADAn	bulunmɑtɑn	bulunmɑdɑn
ʤihɑzlArDAn	ʤihɑzlɑrtɑn	ʤihɑzlɑrdɑn
devrelArDA	devrelerte	devrelerde
editørHn	editørin	editøryn
emisjonH	emisjonɯ	emisjonu
emsɑlH	emsɑlɯ	emsɑli
eriʃkinDA	eriʃkinte	eriʃkinde
etmADHkʧA	etmetikʧe	etmedikʧe
fɑbrikɑDAn	fɑbrikɑtɑn	fɑbrikɑdɑn
federɑsjonHn	federɑsjonɯn	federɑsjonun
filmlArDAn	filmlerten	filmlerden
fijɑtlArDAn	fijɑtlɑrtɑn	fijɑtlɑrdɑn
fuɑrlArDA	fuɑrlɑrtɑ	fuɑrlɑrdɑ
gøzmHzHn	gøzmizin	gøzmyzyn
geʤelArDA	geʤelerte	geʤelerde
geliʃmADAn	geliʃmeten	geliʃmeden
gemiDAn	gemiten	gemiden
hɑzɯrlAmADA	hɑzɯrlɑmɑtɑ	hɑzɯrlɑmɑdɑ
hekimlArDAn	hekimlerten	hekimlerden
hejeʤɑnDAn	hejeʤɑntɑn	hejeʤɑndɑn
iʧimDAki	iʧimteki	iʧimdeki
ihtimɑlHHn	ihtimɑlɯɯn	ihtimɑliin
ikiDA	ikite	ikide
iliʃkilArDAn	iliʃkilerten	iliʃkilerden
illArmHzDA	illermizte	illermizde
kɑrɑkterDA	kɑrɑkterte	kɑrɑkterde
kɑrɑrnɑmeDA	kɑrɑrnɑmete	kɑrɑrnɑmede
kelimeDAn	kelimeten	kelimeden
kelimelArDA	kelimelerte	kelimelerde
kendinHzDAn	kendinizten	kendinizden
kokuH	kokuɯ	kokuu
konfederɑsjonH	konfederɑsjonɯ	konfederɑsjonu
kontrolDA	kontroltɑ	kontrolde
konHp	konɯp	konup
koordinɑsjonHn	koordinɑsjonɯn	koordinɑsjonun
kujumʤulHk	kujumʤulɯk	kujumʤuluk
mɑterjɑllArHHn	mɑterjɑllɑrɯɯn	mɑterjɑlleriin
menyHn	menyin	menyyn
olH	olɯ	olu
onurHHn	onurɯɯn	onuruun
orɑnnDAn	orɑnntɑn	orɑnndɑn
ortɑklArDAn	ortɑklɑrtɑn	ortɑklɑrdɑn
petrolH	petrolɯ	petroly
politikɑDAn	politikɑtɑn	politikɑdɑn
portføjHHn	portføjiin	portføjyyn
protokolDA	protokoltɑ	protokolde
reklɑmlArDA	reklɑmlɑrtɑ	reklɑmlɑrdɑ
sytunlH	sytunlɯ	sytunlu
sɑhɑDAn	sɑhɑtɑn	sɑhɑdɑn
servislArDAn	servislerten	servislerden
sevDHklArnHzA	sevtiklernize	sevdiklernize
sorumlHlArHHn	sorumlɯlɑrɯɯn	sorumlulɑrɯɯn
sponsorlHk	sponsorlɯk	sponsorluk
tyketimDA	tyketimte	tyketimde
tɑkɯmDA	tɑkɯmtɑ	tɑkɯmdɑ
teʃebbysHn	teʃebbysin	teʃebbysyn
teoriDA	teorite	teoride
jɑpmADA	jɑpmɑtɑ	jɑpmɑdɑ
jɑrHn	jɑrɯn	jɑrin
ʧɑtɯʃmAlArDA	ʧɑtɯʃmɑlɑrtɑ	ʧɑtɯʃmɑlɑrdɑ
ølʧymlArDA	ølʧymlerte	ølʧymlerde
ølyHn	ølyin	ølyyn
ʃuHn	ʃuɯn	ʃuun
ɑkʤiɰerlArDA	ɑkʤiɰerlerte	ɑkʤiɰerlerde
ɑlkolA	ɑlkolɑ	ɑlkole
ɑnormɑllHk	ɑnormɑllɯk	ɑnormɑllik
ɑrkɑDAki	ɑrkɑtɑki	ɑrkɑdɑki
bølymmHzHn	bølymmizin	bølymmyzyn
bɑʃvurHp	bɑʃvurɯp	bɑʃvurup
bɑsɯmDA	bɑsɯmtɑ	bɑsɯmdɑ
belirleDHklArH	belirletikleri	belirledikleri
belirleDHkDAn	belirletikten	belirledikten
bilɑnʧoHn	bilɑnʧoɯn	bilɑnʧoun
ʤymleDAn	ʤymleten	ʤymleden
ʤivɑrDAki	ʤivɑrtɑki	ʤivɑrdɑki
dyɰynH	dyɰyni	dyɰyny
demokrɑsiDA	demokrɑsite	demokrɑside
depremlArDAn	depremlerten	depremlerden
duvɑrDAki	duvɑrtɑki	duvɑrdɑki
erDHkDAn	ertikten	erdikten
fɯrɯnDAn	fɯrɯntɑn	fɯrɯndɑn
gøklArDA	gøklerte	gøklerde
gøllArDA	gøllerte	gøllerde
genelgeDA	genelgete	genelgede
hɑrfnA	hɑrfnɑ	hɑrfne
hɑvuzDA	hɑvuztɑ	hɑvuzdɑ
ilgilHlArDAn	ilgililerten	ilgililerden
istemADHklArH	istemetikleri	istemedikleri
izleDHklArH	izletikleri	izledikleri
kɑnserDAn	kɑnserten	kɑnserden
kɑrɑkolH	kɑrɑkolɯ	kɑrɑkolu
kɑjbolHp	kɑjbolɯp	kɑjbolup
komiteDA	komitete	komitede
konferɑnslArDA	konferɑnslɑrtɑ	konferɑnslɑrdɑ
konumDAki	konumtɑki	konumdɑki
korkuH	korkuɯ	korkuu
kuʃʧH	kuʃʧɯ	kuʃʧu
kurummHzHn	kurummɯzɯn	kurummuzun
myʤɑdeleDAn	myʤɑdeleten	myʤɑdeleden
myhyrlH	myhyrli	myhyrly
mysɑbɑkɑlArDA	mysɑbɑkɑlɑrtɑ	mysɑbɑkɑlɑrdɑ
mekɑnlArDAn	mekɑnlɑrtɑn	mekɑnlɑrdɑn
merkezlArDAn	merkezlerten	merkezlerden
mesɑfelArDA	mesɑfelerte	mesɑfelerde
metodHHn	metodɯɯn	metoduun
okjɑnusH	okjɑnusɯ	okjɑnusu
olurH	olurɯ	oluru
opsijonDA	opsijontɑ	opsijondɑ
pilotHn	pilotɯn	pilotun
plɑnlAmADA	plɑnlɑmɑtɑ	plɑnlɑmɑdɑ
proʒeDAki	proʒeteki	proʒedeki
purolHk	purolɯk	puroluk
rɑportørlHk	rɑportørlik	rɑportørlyk
sɯʧɑnlArDA	sɯʧɑnlɑrtɑ	sɯʧɑnlɑrdɑ
sɯɰɯrlArDA	sɯɰɯrlɑrtɑ	sɯɰɯrlɑrdɑ
søzlArDAn	søzlerten	søzlerden
sɑnɑjiDAki	sɑnɑjiteki	sɑnɑjideki
sezonDA	sezontɑ	sezondɑ
sigortɑDAn	sigortɑtɑn	sigortɑdɑn
sonDAn	sontɑn	sondɑn
sorunnHz	sorunnɯz	sorunnuz
suʧlHH	suʧlɯɯ	suʧluu
tyjH	tyji	tyjy
tɑbɑkɑDA	tɑbɑkɑtɑ	tɑbɑkɑdɑ
tɑrɯmDAn	tɑrɯmtɑn	tɑrɯmdɑn
tɑvɑnDA	tɑvɑntɑ	tɑvɑndɑ
teʤɑvyzHn	teʤɑvyzin	teʤɑvyzyn
uzɑDHkʧA	uzɑtɯkʧɑ	uzɑdɯkʧɑ
jøntemlArDA	jøntemlerte	jøntemlerde
jynlH	jynli	jynly
jɑtmADAn	jɑtmɑtɑn	jɑtmɑdɑn
jorumDA	jorumtɑ	jorumdɑ
ʧøzymDA	ʧøzymte	ʧøzymde
ʧɑlɯʃɑnlArDAn	ʧɑlɯʃɑnlɑrtɑn	ʧɑlɯʃɑnlɑrdɑn
ʧimentoHn	ʧimentoɯn	ʧimentoun
yniversitelArmHzDA	yniversitelermizte	yniversitelermizde
yzernDAken	yzernteken	yzerndeken
ɑʧɯklɑmAlArDAn	ɑʧɯklɑmɑlɑrtɑn	ɑʧɯklɑmɑlɑrdɑn
ɑfetlArDA	ɑfetlerte	ɑfetlerde
ɑnormɑllHklAr	ɑnormɑllɯklɑr	ɑnormɑllikler
ɑjɑklArDA	ɑjɑklɑrtɑ	ɑjɑklɑrdɑ
bekleDHklArH	bekletikleri	bekledikleri
birɑzDA	birɑztɑ	birɑzdɑ
bulunHʃH	bulunɯʃɯ	bulunuʃu
ʤɑmiDA	ʤɑmite	ʤɑmide
dyʃmH	dyʃmi	dyʃmy
denizDAki	denizteki	denizdeki
denizlArmHzDA	denizlermizte	denizlermizde
depresjonHn	depresjonɯn	depresjonun
diʃlArDA	diʃlerte	diʃlerde
doɰmADAn	doɰmɑtɑn	doɰmɑdɑn
doɰrultulH	doɰrultulɯ	doɰrultulu
doɰumHHn	doɰumɯɯn	doɰumuun
dolguH	dolguɯ	dolguu
fonlArDAn	fonlɑrtɑn	fonlɑrdɑn
fonHHn	fonɯɯn	fonuun
gerekAnDAn	gerekenten	gerekenden
gerilArDA	gerilerte	gerilerde
hɑmurHn	hɑmurɯn	hɑmurun
hɑtlArDAn	hɑtlɑrtɑn	hɑtlɑrdɑn
iʃʧiDAn	iʃʧiten	iʃʧiden
iʃlArnHzDA	iʃlernizte	iʃlernizde
ihtilɑlH	ihtilɑlɯ	ihtilɑli
isteDHklArnHzH	istetiklernizi	istediklernizi
kyltyrmHzH	kyltyrmizi	kyltyrmyzy
kɑdrolArDA	kɑdrolɑrtɑ	kɑdrolɑrdɑ
kɑpsylH	kɑpsyli	kɑpsyly
kimlArDAn	kimlerten	kimlerden
kolDA	koltɑ	koldɑ
konsolosH	konsolosɯ	konsolosu
kontrollArA	kontrollɑrɑ	kontrollere
kurulDAn	kurultɑn	kuruldɑn
kurultɑjDA	kurultɑjtɑ	kurultɑjdɑ
kujruklH	kujruklɯ	kujruklu
kujuDAn	kujutɑn	kujudɑn
kujuHn	kujuɯn	kujuun
mɑkbulA	mɑkbulɑ	mɑkbule
mɑkinɑDA	mɑkinɑtɑ	mɑkinɑdɑ
mɑmullArHHn	mɑmullɑrɯɯn	mɑmulleriin
mertebeDAn	mertebeten	mertebeden
mesɑfeDAki	mesɑfeteki	mesɑfedeki
modylHHn	modyliin	modylyyn
pɑrklArDA	pɑrklɑrtɑ	pɑrklɑrdɑ
refɑkɑtʧH	refɑkɑtʧɯ	refɑkɑtʧi
sɑɰnDAki	sɑɰntɑki	sɑɰndɑki
sinjɑllArHn	sinjɑllɑrɯn	sinjɑllerin
sirkylɑsjonH	sirkylɑsjonɯ	sirkylɑsjonu
soɰuklHk	soɰuklɯk	soɰukluk
tɑvɑnDAn	tɑvɑntɑn	tɑvɑndɑn
tɑvsijeDA	tɑvsijete	tɑvsijede
tempoDA	tempotɑ	tempodɑ
jɑʃɑmADAn	jɑʃɑmɑtɑn	jɑʃɑmɑdɑn
jɑʃlArDAn	jɑʃlɑrtɑn	jɑʃlɑrdɑn
jerjyzynDAn	jerjyzynten	jerjyzynden
jolmHz	jolmɯz	jolmuz
jolmHzH	jolmɯzɯ	jolmuzu
ʧɑlɯʃɑnlArDA	ʧɑlɯʃɑnlɑrtɑ	ʧɑlɯʃɑnlɑrdɑ
ʧimentoH	ʧimentoɯ	ʧimentou
øzDA	øzte	øzde
ʃubelArDA	ʃubelerte	ʃubelerde
ʃurɑDA	ʃurɑtɑ	ʃurɑdɑ
ynitelArDA	ynitelerte	ynitelerde
yniversitenHzDA	yniversitenizte	yniversitenizde
yretiʤilArDAn	yretiʤilerten	yretiʤilerden
ɑdɑlArDA	ɑdɑlɑrtɑ	ɑdɑlɑrdɑ
ɑlɯnmADHkʧA	ɑlɯnmɑtɯkʧɑ	ɑlɯnmɑdɯkʧɑ
ɑlbymDAn	ɑlbymten	ɑlbymden
ɑjDAki	ɑjtɑki	ɑjdɑki
ɑzɑlDHkʧA	ɑzɑltɯkʧɑ	ɑzɑldɯkʧɑ
bɯkmADAn	bɯkmɑtɑn	bɯkmɑdɑn
bɑɰlɑntɯlArDA	bɑɰlɑntɯlɑrtɑ	bɑɰlɑntɯlɑrdɑ
belirtmADAn	belirtmeten	belirtmeden
bolmH	bolmɯ	bolmu
bulutH	bulutɯ	bulutu
burɑlArDAki	burɑlɑrtɑki	burɑlɑrdɑki
bursHn	bursɯn	bursun
dyʃH	dyʃi	dyʃy
dyʃHʃHn	dyʃiʃin	dyʃyʃyn
dykkɑnDAn	dykkɑntɑn	dykkɑndɑn
dokuDAn	dokutɑn	dokudɑn
dolɑʃɯmDA	dolɑʃɯmtɑ	dolɑʃɯmdɑ
dosjɑlArDAn	dosjɑlɑrtɑn	dosjɑlɑrdɑn
dujHʃsAl	dujɯʃsɑl	dujuʃsɑl
eksenDA	eksente	eksende
enflɑsjonDAn	enflɑsjontɑn	enflɑsjondɑn
engellArDAn	engellerten	engellerden
fɯkrɑlArDA	fɯkrɑlɑrtɑ	fɯkrɑlɑrdɑ
fermɑntɑsjonDA	fermɑntɑsjontɑ	fermɑntɑsjondɑ
fermɑntɑsjonH	fermɑntɑsjonɯ	fermɑntɑsjonu
gɯdɑlArDA	gɯdɑlɑrtɑ	gɯdɑlɑrdɑ
gøndermADAn	gøndermeten	gøndermeden
gøryʃlArDAn	gøryʃlerten	gøryʃlerden
gɑjrimenkulA	gɑjrimenkulɑ	gɑjrimenkule
golDAn	goltɑn	golden
hykymsHzlHk	hykymsizlik	hykymsyzlyk
hɑritɑDAn	hɑritɑtɑn	hɑritɑdɑn
iʧAnlArDA	iʧenlerte	iʧenlerde
indirimDAn	indirimten	indirimden
kɑleDAn	kɑleten	kɑleden
kɑlplArH	kɑlplɑrɯ	kɑlpleri
kɑmjonH	kɑmjonɯ	kɑmjonu
kɑpɯDAki	kɑpɯtɑki	kɑpɯdɑki
kɑrʃɯmHzDAki	kɑrʃɯmɯztɑki	kɑrʃɯmɯzdɑki
kɑtmɑnDA	kɑtmɑntɑ	kɑtmɑndɑ
kemɑlH	kemɑlɯ	kemɑli
kolesterolHn	kolesterolɯn	kolesterolyn
konsorsijumH	konsorsijumɯ	konsorsijumu
kontrollArDA	kontrollɑrtɑ	kontrollerde
korkmADAn	korkmɑtɑn	korkmɑdɑn
kristɑllAr	kristɑllɑr	kristɑller
kuruDHkDAn	kurutɯktɑn	kuruduktɑn
kutuDAn	kututɑn	kutudɑn
kutulArDA	kutulɑrtɑ	kutulɑrdɑ
mɑhɑlleDAn	mɑhɑlleten	mɑhɑlleden
mɑmullArHn	mɑmullɑrɯn	mɑmullerin
merdivenlArDAn	merdivenlerten	merdivenlerden
mesɑʒDA	mesɑʒtɑ	mesɑʒdɑ
mideDA	midete	midede
molekylHn	molekylin	molekylyn
nelArDAn	nelerten	nelerden
okulmHzH	okulmɯzɯ	okulmuzu
ormɑnlArDA	ormɑnlɑrtɑ	ormɑnlɑrdɑ
pɑrtilArDA	pɑrtilerte	pɑrtilerde
sɯkɯntɯDAn	sɯkɯntɯtɑn	sɯkɯntɯdɑn
syrgylH	syrgyli	syrgyly
sɑbunlH	sɑbunlɯ	sɑbunlu
sɑvunmADAn	sɑvunmɑtɑn	sɑvunmɑdɑn
serɑlArDA	serɑlɑrtɑ	serɑlɑrdɑ
sitelArDAn	sitelerten	sitelerden
stɑdjumH	stɑdjumɯ	stɑdjumu
teʃekkyrH	teʃekkyri	teʃekkyry
turmHz	turmɯz	turmuz
tutɑrDA	tutɑrtɑ	tutɑrdɑ
ulusmHzHn	ulusmɯzɯn	ulusmuzun
ujumHHn	ujumɯɯn	ujumuun
viryslArDAn	viryslerten	viryslerden
jyryHp	jyryip	jyryyp
jyzjɯllArDAn	jyzjɯllɑrtɑn	jyzjɯllɑrdɑn
jɑɰlArDAn	jɑɰlɑrtɑn	jɑɰlɑrdɑn
jɑsɑlArDAn	jɑsɑlɑrtɑn	jɑsɑlɑrdɑn
jediDAn	jediten	jediden
jerjyzynH	jerjyzyni	jerjyzyny
jolsuzlHklArH	jolsuzlɯklɑrɯ	jolsuzluklɑrɯ
jolsuzlHklArA	jolsuzlɯklɑrɑ	jolsuzluklɑrɑ
ʧileDAn	ʧileten	ʧileden
øɰrenmADA	øɰrenmete	øɰrenmede
øɰretimDAki	øɰretimteki	øɰretimdeki
ønemDA	ønemte	ønemde
ʃɑntijeDA	ʃɑntijete	ʃɑntijede
ylkyH	ylkyi	ylkyy
yretiʤiDAn	yretiʤiten	yretiʤiden
yzermHzDA	yzermizte	yzermizde
ɑksɑtmADAn	ɑksɑtmɑtɑn	ɑksɑtmɑdɑn
ɑlɯmlArDA	ɑlɯmlɑrtɑ	ɑlɯmlɑrdɑ
ɑrterDAn	ɑrterten	ɑrterden
ɑzɑDAn	ɑzɑtɑn	ɑzɑdɑn
bølymmHzA	bølymmize	bølymmyze
bølgemHzDAki	bølgemizteki	bølgemizdeki
bɑʃɑrɯDAn	bɑʃɑrɯtɑn	bɑʃɑrɯdɑn
bɑnkɑDAki	bɑnkɑtɑki	bɑnkɑdɑki
bilgisɑjɑrnHzDAn	bilgisɑjɑrnɯztɑn	bilgisɑjɑrnɯzdɑn
bulHʃlArH	bulɯʃlɑrɯ	buluʃlɑrɯ
bulHʃlArHn	bulɯʃlɑrɯn	buluʃlɑrɯn
denetimDA	denetimte	denetimde
dikkɑtHn	dikkɑtɯn	dikkɑtin
dikkɑtsHzlHk	dikkɑtsɯzlɯk	dikkɑtsizlik
dilekʧeDA	dilekʧete	dilekʧede
doɰulH	doɰulɯ	doɰulu
doɰumHn	doɰumɯn	doɰumun
dujguHn	dujguɯn	dujguun
eʃgydymH	eʃgydymi	eʃgydymy
eʃjɑlArDAn	eʃjɑlɑrtɑn	eʃjɑlɑrdɑn
eʤzɑneDA	eʤzɑnete	eʤzɑnede
eklemDA	eklemte	eklemde
figyrH	figyri	figyry
fiilDAn	fiilten	fiilden
filmDAn	filmten	filmden
firmɑmHzDA	firmɑmɯztɑ	firmɑmɯzdɑ
formlH	formlɯ	formlu
gøsterilArDA	gøsterilerte	gøsterilerde
gyllHk	gyllik	gyllyk
gɑzɑlH	gɑzɑlɯ	gɑzɑli
getirDHkDAn	getirtikten	getirdikten
gezilArDA	gezilerte	gezilerde
golH	golɯ	goly
hɑstɑnelArDAn	hɑstɑnelerten	hɑstɑnelerden
iʃʧilArDAn	iʃʧilerten	iʃʧilerden
idɑreDAn	idɑreten	idɑreden
iliʃkilArmHzDA	iliʃkilermizte	iliʃkilermizde
ishɑlA	ishɑlɑ	ishɑle
kørH	køri	køry
kyltyrmHzA	kyltyrmize	kyltyrmyze
kytyphɑnelArDAn	kytyphɑnelerten	kytyphɑnelerden
kɑlDHkʧA	kɑltɯkʧɑ	kɑldɯkʧɑ
kɑmpɑnjɑDAn	kɑmpɑnjɑtɑn	kɑmpɑnjɑdɑn
kɑrbonlH	kɑrbonlɯ	kɑrbonlu
kɑzɑlArDAn	kɑzɑlɑrtɑn	kɑzɑlɑrdɑn
kesilDHkDAn	kesiltikten	kesildikten
kesimDAki	kesimteki	kesimdeki
klɑvjeDAki	klɑvjeteki	klɑvjedeki
koʃulHHn	koʃulɯɯn	koʃuluun
kolonH	kolonɯ	kolonu
kontrollArHn	kontrollɑrɯn	kontrollerin
konumlH	konumlɯ	konumlu
kullɑnɯmlArDA	kullɑnɯmlɑrtɑ	kullɑnɯmlɑrdɑ
kuruluʃnHzHn	kuruluʃnɯzɯn	kuruluʃnuzun
lyksH	lyksi	lyksy
mɑkroH	mɑkroɯ	mɑkrou
mesleklArDA	mesleklerte	mesleklerde
mutsuzlHk	mutsuzlɯk	mutsuzluk
nesilDAn	nesilten	nesilden
normH	normɯ	normu
ordumHz	ordumɯz	ordumuz
orgɑnlArDAn	orgɑnlɑrtɑn	orgɑnlɑrdɑn
ojnɑDHklArH	ojnɑtɯklɑrɯ	ojnɑdɯklɑrɯ
penʤerelArDA	penʤerelerte	penʤerelerde
resimlArDAn	resimlerten	resimlerden
restorɑnlArDA	restorɑnlɑrtɑ	restorɑnlɑrdɑ
søjleʃiDA	søjleʃite	søjleʃide
sɑlonlArDA	sɑlonlɑrtɑ	sɑlonlɑrdɑ
sɑntrɑllArDA	sɑntrɑllɑrtɑ	sɑntrɑllerde
sektørmHzDA	sektørmizte	sektørmyzde
sembollArHn	sembollɑrɯn	sembollerin
solunumHn	solunumɯn	solunumun
sojDAn	sojtɑn	sojdɑn
tohumHn	tohumɯn	tohumun
toklHk	toklɯk	tokluk
uʧHʃA	uʧɯʃɑ	uʧuʃɑ
unutmADAn	unutmɑtɑn	unutmɑdɑn
urHn	urɯn	urun
vɑdeDAn	vɑdeten	vɑdeden
jyzmH	jyzmi	jyzmy
jɑʃɑDHkʧA	jɑʃɑtɯkʧɑ	jɑʃɑdɯkʧɑ
jɑngɯnDA	jɑngɯntɑ	jɑngɯndɑ
jɑzɯlɯmDA	jɑzɯlɯmtɑ	jɑzɯlɯmdɑ
jɑzɑrlArDAn	jɑzɑrlɑrtɑn	jɑzɑrlɑrdɑn
jerɑltɯnDA	jerɑltɯntɑ	jerɑltɯndɑ
zijɑretlArDA	zijɑretlerte	zijɑretlerde
ʧɑdɯrDA	ʧɑdɯrtɑ	ʧɑdɯrdɑ
ølʧeklArDA	ølʧeklerte	ølʧeklerde
ølymlH	ølymli	ølymly
ystlHk	ystlik	ystlyk
yjelArDA	yjelerte	yjelerde
yzernHzDA	yzernizte	yzernizde
ɑktivɑsjonH	ɑktivɑsjonɯ	ɑktivɑsjonu
ɑpɑrtmɑnDA	ɑpɑrtmɑntɑ	ɑpɑrtmɑndɑ
ɑrɑziDAn	ɑrɑziten	ɑrɑziden
ɑrkɑdɑʃlArmHzDAn	ɑrkɑdɑʃlɑrmɯztɑn	ɑrkɑdɑʃlɑrmɯzdɑn
ɑtmADAn	ɑtmɑtɑn	ɑtmɑdɑn
bɑkɯmlArDAn	bɑkɯmlɑrtɑn	bɑkɯmlɑrdɑn
beledijelArDAn	beledijelerten	beledijelerden
bilimDAn	bilimten	bilimden
ʤerrɑhiDA	ʤerrɑhite	ʤerrɑhide
dɯʃmHzDA	dɯʃmɯztɑ	dɯʃmɯzdɑ
dyʃynHnʤA	dyʃyninʤe	dyʃynynʤe
dykkɑnlArDA	dykkɑnlɑrtɑ	dykkɑnlɑrdɑ
dɑɰDAn	dɑɰtɑn	dɑɰdɑn
defterDA	defterte	defterde
depoDA	depotɑ	depodɑ
diDA	dite	dide
disknHzDA	disknizte	disknizde
doɰruHn	doɰruɯn	doɰruun
dolgulH	dolgulɯ	dolgulu
durummHz	durummɯz	durummuz
dujuruDA	dujurutɑ	dujurudɑ
elemɑnlArDAn	elemɑnlɑrtɑn	elemɑnlɑrdɑn
ellArDAn	ellerten	ellerden
eskilArDAn	eskilerten	eskilerden
evrenDAki	evrenteki	evrendeki
fɯrɯnlArDA	fɯrɯnlɑrtɑ	fɯrɯnlɑrdɑ
forumDA	forumtɑ	forumdɑ
gønyllHlArHn	gønyllilerin	gønyllylerin
gøryntyDA	gøryntyte	gøryntyde
geliʃmAlArDA	geliʃmelerte	geliʃmelerde
gerADA	gerete	gerede
getirmADAn	getirmeten	getirmeden
hykymlHlArA	hykymlilere	hykymlylere
hɑlmHz	hɑlmɯz	hɑlmiz
hɑtɑDAn	hɑtɑtɑn	hɑtɑdɑn
hɑvuzDAn	hɑvuztɑn	hɑvuzdɑn
hɑvuzlArDA	hɑvuzlɑrtɑ	hɑvuzlɑrdɑ
hipertɑnsijonHn	hipertɑnsijonɯn	hipertɑnsijonun
iʧnHzDAn	iʧnizten	iʧnizden
iʃverenDAn	iʃverenten	iʃverenden
ifɑdeDA	ifɑdete	ifɑdede
køpryH	køpryi	køpryy
køjlylArDAn	køjlylerten	køjlylerden
køjlArDAki	køjlerteki	køjlerdeki
kɑleDA	kɑlete	kɑlede
kɑzɑnDHkDAn	kɑzɑntɯktɑn	kɑzɑndɯktɑn
kimseDA	kimsete	kimsede
kurHʤHnHn	kuruʤɯnɯn	kuruʤunun
kurumnHzHn	kurumnɯzɯn	kurumnuzun
liberɑllAʃmA	liberɑllɑʃmɑ	liberɑlleʃme
linklArDAn	linklerten	linklerden
mɑɰɑrɑDA	mɑɰɑrɑtɑ	mɑɰɑrɑdɑ
mɑkɑmDAn	mɑkɑmtɑn	mɑkɑmdɑn
mɑsɑDAn	mɑsɑtɑn	mɑsɑdɑn
menyH	menyi	menyy
monitørH	monitøri	monitøry
mutlulHkDAn	mutlulɯktɑn	mutluluktɑn
nesnelArDAn	nesnelerten	nesnelerden
normlH	normlɯ	normlu
okurH	okurɯ	okuru
ortɑmlArDAn	ortɑmlɑrtɑn	ortɑmlɑrdɑn
pɑzɑrlAmADA	pɑzɑrlɑmɑtɑ	pɑzɑrlɑmɑdɑ
petrolA	petrolɑ	petrole
plɑnlArDA	plɑnlɑrtɑ	plɑnlɑrdɑ
rɑporDAki	rɑportɑki	rɑpordɑki
reɑksijonHn	reɑksijonɯn	reɑksijonun
syrgynDA	syrgynte	syrgynde
semptomH	semptomɯ	semptomu
serumDA	serumtɑ	serumdɑ
siʤilDAn	siʤilten	siʤilden
spektrumlH	spektrumlɯ	spektrumlu
suʧHHn	suʧɯɯn	suʧuun
tytynDAn	tytynten	tytynden
tɑbɑkɑDAn	tɑbɑkɑtɑn	tɑbɑkɑdɑn
tɑnɯmADAn	tɑnɯmɑtɑn	tɑnɯmɑdɑn
tɑsɑrɯmlArDA	tɑsɑrɯmlɑrtɑ	tɑsɑrɯmlɑrdɑ
temelnDAki	temelnteki	temelndeki
tezDA	tezte	tezde
uʧurumH	uʧurumɯ	uʧurumu
uzmɑnDAn	uzmɑntɑn	uzmɑndɑn
jɑrdɯmlArDA	jɑrdɯmlɑrtɑ	jɑrdɯmlɑrdɑ
jemADAn	jemeten	jemeden
ʧøzmADA	ʧøzmete	ʧøzmede
ʧevremDA	ʧevremte	ʧevremde
ʧevremDAki	ʧevremteki	ʧevremdeki
ølʧysHz	ølʧysiz	ølʧysyz
ʃɑrtnɑmelArDA	ʃɑrtnɑmelerte	ʃɑrtnɑmelerde
ʃekilDAn	ʃekilten	ʃekilden
ʃubeDAn	ʃubeten	ʃubeden
ynHn	ynin	ynyn
ystmHzA	ystmize	ystmyze
ɑmɑtørlHk	ɑmɑtørlik	ɑmɑtørlyk
ɑmbɑlɑʒlArDA	ɑmbɑlɑʒlɑrtɑ	ɑmbɑlɑʒlɑrdɑ
ɑnneDA	ɑnnete	ɑnnede
bynjemHzDA	bynjemizte	bynjemizde
bɑlɯklArDA	bɑlɯklɑrtɑ	bɑlɯklɑrdɑ
bɑrDA	bɑrtɑ	bɑrdɑ
bɑroHHn	bɑroɯɯn	bɑrouun
bordroDA	bordrotɑ	bordrodɑ
borsɑlArDA	borsɑlɑrtɑ	borsɑlɑrdɑ
ʤivɑrDA	ʤivɑrtɑ	ʤivɑrdɑ
dɑlDAn	dɑltɑn	dɑldɑn
dɑmɑrlArDAn	dɑmɑrlɑrtɑn	dɑmɑrlɑrdɑn
dɑnɯʃmADAn	dɑnɯʃmɑtɑn	dɑnɯʃmɑdɑn
deklɑrɑsjonH	deklɑrɑsjonɯ	deklɑrɑsjonu
denemeDA	denemete	denemede
depoHHn	depoɯɯn	depouun
dergilArDAn	dergilerten	dergilerden
direktiflArDA	direktiflerte	direktiflerde
doɰDHkDAn	doɰtɯktɑn	doɰduktɑn
dozHHn	dozɯɯn	dozuun
durumDAken	durumtɑken	durumdɑken
durumnHzH	durumnɯzɯ	durumnuzu
ertesinDA	ertesinte	ertesinde
etkilAnmADAn	etkilenmeten	etkilenmeden
evvelDAn	evvelten	evvelden
federɑsjonHHn	federɑsjonɯɯn	federɑsjonuun
festivɑlA	festivɑlɑ	festivɑle
fikirDA	fikirte	fikirde
gɯdɑlArDAn	gɯdɑlɑrtɑn	gɯdɑlɑrdɑn
gørynymHn	gørynymin	gørynymyn
gøryntylArDA	gøryntylerte	gøryntylerde
gøryntyHHn	gøryntyiin	gøryntyyyn
gynejdoɰuDA	gynejdoɰutɑ	gynejdoɰudɑ
gɑzeteDAki	gɑzeteteki	gɑzetedeki
hyʤreDAn	hyʤreten	hyʤreden
hɑritɑlArDA	hɑritɑlɑrtɑ	hɑritɑlɑrdɑ
hɑvuzHHn	hɑvuzɯɯn	hɑvuzuun
hɑvzɑDA	hɑvzɑtɑ	hɑvzɑdɑ
hɑzineDAn	hɑzineten	hɑzineden
huzurlArnHzDA	huzurlɑrnɯztɑ	huzurlɑrnɯzdɑ
iʧmHzDAn	iʧmizten	iʧmizden
idɑreDA	idɑrete	idɑrede
istɑsjonHn	istɑsjonɯn	istɑsjonun
kyreDA	kyrete	kyrede
kɑbullAnmA	kɑbullɑnmɑ	kɑbullenme
kɑlibrɑsjonH	kɑlibrɑsjonɯ	kɑlibrɑsjonu
kɑlplH	kɑlplɯ	kɑlpli
kɑlpDAn	kɑlptɑn	kɑlpten
kɑtegoriDAki	kɑtegoriteki	kɑtegorideki
kentmHzDA	kentmizte	kentmizde
kolonHn	kolonɯn	kolonun
komisjonDAn	komisjontɑn	komisjondɑn
kongreDAn	kongreten	kongreden
kontrollArHHn	kontrollɑrɯɯn	kontrolleriin
kriterlArDAn	kriterlerten	kriterlerden
mydɑhɑleDAn	mydɑhɑleten	mydɑhɑleden
myesseselArDA	myesseselerte	myesseselerde
myzɑkerelArDA	myzɑkerelerte	myzɑkerelerde
mɑʧlArDA	mɑʧlɑrtɑ	mɑʧlɑrdɑ
mɑɰɑzɑDAn	mɑɰɑzɑtɑn	mɑɰɑzɑdɑn
mɑɰɑzɑlArDAn	mɑɰɑzɑlɑrtɑn	mɑɰɑzɑlɑrdɑn
mevsimlArDA	mevsimlerte	mevsimlerde
modellArDAn	modellerten	modellerden
numɑrɑDA	numɑrɑtɑ	numɑrɑdɑ
onlH	onlɯ	onlu
pɑrɑmetrelArDAn	pɑrɑmetrelerten	pɑrɑmetrelerden
revizjonH	revizjonɯ	revizjonu
søzmH	søzmi	søzmy
sɑnijeDAn	sɑnijeten	sɑnijeden
senɑrjoHn	senɑrjoɯn	senɑrjoun
senɑrjoH	senɑrjoɯ	senɑrjou
sendromHHn	sendromɯɯn	sendromuun
serɑDA	serɑtɑ	serɑdɑ
soruDAn	sorutɑn	sorudɑn
sorumlHlArHn	sorumlɯlɑrɯn	sorumlulɑrɯn
tɯklADHkDAn	tɯklɑtɯktɑn	tɯklɑdɯktɑn
tɑʃrɑDA	tɑʃrɑtɑ	tɑʃrɑdɑ
tɑblolArDAn	tɑblolɑrtɑn	tɑblolɑrdɑn
tekliflArDA	tekliflerte	tekliflerde
uʧHʃlAr	uʧɯʃlɑr	uʧuʃlɑr
ujkuHn	ujkuɯn	ujkuun
jokuʃH	jokuʃɯ	jokuʃu
jolʤuluklArDA	jolʤuluklɑrtɑ	jolʤuluklɑrdɑ
zeminDAn	zeminten	zeminden
