uf	pred	sf
gelAn	geldn	gelen
gynH	gyni	gyny
gerekAn	gerekɑn	gereken
geʧAn	geʧɑn	geʧen
bilgilArH	bilgilɑri	bilgileri
jolH	jolɯ	jolu
bilgilAr	bilgilɑr	bilgiler
øɰrenʤilAr	øɰrenʤilɑr	øɰrenʤiler
øzellHklArH	øzelliklɑri	øzellikleri
dønemDA	dønemdɑ	dønemde
biʧimDA	biʧimdd	biʧimde
hɑlDA	hɑldɑ	hɑlde
bilimsAl	bilimsdl	bilimsel
jerDA	jerdɑ	jerde
øɰrenʤilArHn	øɰrenʤilɑrin	øɰrenʤilerin
yjelArH	yjelɑri	yjeleri
sistemlArH	sistemlɑri	sistemleri
vermA	vermi	verme
gørmA	gørmɑ	gørme
deɰerlendirmA	deɰerlendirmd	deɰerlendirme
dikkɑtA	dikkɑtɑ	dikkɑte
iʧerAn	iʧerdn	iʧeren
dyzenlAnAn	dyzenlɑndn	dyzenlenen
iʃlemlArH	iʃlemlɑri	iʃlemleri
ølʧyDA	ølʧydɑ	ølʧyde
jyzDAn	jyzddn	jyzden
kiʃilAr	kiʃilɑr	kiʃiler
kodH	kodɯ	kodu
gynmHzDA	gynmizdɑ	gynmyzde
bølgeDA	bølgedɑ	bølgede
syreDA	syredɑ	syrede
kiʃisAl	kiʃisdl	kiʃisel
geliʃmA	geliʃmɑ	geliʃme
kɑnunHn	kɑnunɯn	kɑnunun
ylkeDA	ylkedi	ylkede
yrynlAr	yrynlɑr	yrynler
iʃH	iʃɯ	iʃi
fiziksAl	fiziksdl	fiziksel
kiʃilArHn	kiʃilɑrin	kiʃilerin
dilA	dilɑ	dile
bɑʃDA	bɑʃdɑ	bɑʃtɑ
sonH	sonɯ	sonu
toplumHn	toplumɯn	toplumun
ermAnH	ermɑni	ermeni
jøntemlArH	jøntemlɑri	jøntemleri
dyzejDA	dyzejdɑ	dyzejde
ylkelAr	ylkelɑr	ylkeler
formH	formɯ	formu
nelAr	nelɑr	neler
birejsAl	birejsɑl	birejsel
iʃA	iʃɑ	iʃe
enstityH	enstityi	enstityy
demA	demɑ	deme
hizmetlAr	hizmetlɑr	hizmetler
gørAn	gørɑn	gøren
ylkelArDA	ylkelɑrdɑ	ylkelerde
gynDA	gyndd	gynde
okulH	okulɯ	okulu
derslAr	derslɑr	dersler
ʃejlAr	ʃejlɑr	ʃejler
øɰrenʤilArA	øɰrenʤilɑrd	øɰrenʤilere
iʃHn	iʃɯn	iʃin
iʃlArH	iʃlɑrɯ	iʃleri
hykymlArH	hykymlɑri	hykymleri
bølymDA	bølymdd	bølymde
dereʤeDA	dereʤedi	dereʤede
tyrH	tyri	tyry
gynlArDA	gynlɑrdɑ	gynlerde
dyzenlemA	dyzenlemi	dyzenleme
iʃlemlAr	iʃlemlɑr	iʃlemler
komisjonH	komisjonɯ	komisjonu
geliʃmAlAr	geliʃmɑlɑr	geliʃmeler
gørevlArH	gørevlɑri	gørevleri
ønmHzDAki	ønmizdɑki	ønmyzdeki
vermA	vermi	verme
deɰiʃiklHklAr	deɰiʃikliklɑr	deɰiʃiklikler
mɑddelAr	mɑddelɑr	mɑddeler
jønDA	jøndɑ	jønde
bilgilArHn	bilgilɑrin	bilgilerin
etmAH	etmɑi	etmei
kurulHHn	kurulɯɯn	kuruluun
syrAn	syrdn	syren
etmAA	etmɑɑ	etmee
gøzDAn	gøzdɑn	gøzden
iʃlAr	iʃlɑr	iʃler
proʒelAr	proʒelɑr	proʒeler
tɑrihDAn	tɑrihdɑn	tɑrihten
sektørH	sektøri	sektøry
ønA	ønɑ	øne
inʤelemA	inʤelemd	inʤeleme
fɑɑlijetlArH	fɑɑlijetlɑri	fɑɑlijetleri
belirtAn	belirtdn	belirten
bilimlArH	bilimlɑri	bilimleri
yjelArHHn	yjelɑriin	yjeleriin
jɑpDHklArH	jɑpdɯklɑrɯ	jɑptɯklɑrɯ
bojH	bojɯ	boju
tekniklArH	tekniklɑri	teknikleri
hizmetA	hizmetd	hizmete
belgelAr	belgelɑr	belgeler
yjelAr	yjelɑr	yjeler
søzH	søzi	søzy
øɰrenʤilArH	øɰrenʤilɑri	øɰrenʤileri
øɰrenmA	øɰrenmd	øɰrenme
deɰerlAr	deɰerlɑr	deɰerler
getirAn	getirdn	getiren
bilimlAr	bilimlɑr	bilimler
uzɑkDAn	uzɑkdɑn	uzɑktɑn
mɑddelArH	mɑddelɑri	mɑddeleri
iʃlemA	iʃlemi	iʃleme
gynHn	gynin	gynyn
øzellHklAr	øzelliklɑr	øzellikler
bilgiA	bilgii	bilgie
yrynH	yryni	yryny
belgelArH	belgelɑri	belgeleri
ʧøzymlAr	ʧøzymlɑr	ʧøzymler
teknoloʒilArH	teknoloʒilɑri	teknoloʒileri
deɰiʃAn	deɰiʃɑn	deɰiʃen
ʧøzymH	ʧøzymi	ʧøzymy
dyʃAn	dyʃɑn	dyʃen
jerlArH	jerlɑri	jerleri
sistemA	sistemd	sisteme
inʤelAnmAH	inʤelɑnmɑi	inʤelenmei
sɯnɑvH	sɯnɑvi	sɯnɑvɯ
bølgesAl	bølgesdl	bølgesel
ønDA	øndɑ	ønde
koruHʤH	koruɯʤɯ	koruuʤu
tɑrihDA	tɑrihdɑ	tɑrihte
getirmA	getirmi	getirme
jerDAn	jerdɑn	jerden
ylkelArH	ylkelɑri	ylkeleri
derslArH	derslɑri	dersleri
gynlArH	gynlɑri	gynleri
iliʃkilArH	iliʃkilɑri	iliʃkileri
vermAA	vermɑi	vermee
verArAk	verɑrɑk	vererek
sektørHn	sektørin	sektøryn
ørgytH	ørgyti	ørgyty
sizlerA	sizlerd	sizlere
rolH	rolɯ	roly
kurumHn	kurumɯn	kurumun
yrynHn	yrynin	yrynyn
gynDAn	gynddn	gynden
geriA	gerii	gerie
evDA	evdi	evde
jerlAr	jerlɑr	jerler
iliʃkilAr	iliʃkilɑr	iliʃkiler
izleAn	izlein	izleen
olmADAn	olmɑdɑn	olmɑtɑn
ɑjɑkDA	ɑjɑkdɑ	ɑjɑktɑ
konuHn	konuɯn	konuun
verilAr	verilɑr	veriler
mɑddeDA	mɑddedɑ	mɑddede
gørmA	gørmɑ	gørme
sektørHHn	sektøriin	sektøryyn
gynA	gynd	gyne
sɑjeDA	sɑjedɑ	sɑjede
yjelArHn	yjelɑrin	yjelerin
devreA	devrei	devree
ʤinsAl	ʤinsdl	ʤinsel
mɑddelArHn	mɑddelɑrin	mɑddelerin
gørevA	gørevi	gøreve
konulH	konulɯ	konulu
sistemlAr	sistemlɑr	sistemler
hɑberleʃmA	hɑberleʃmɑ	hɑberleʃme
soruHn	soruɯn	soruun
herkesA	herkesd	herkese
toplumH	toplumɯ	toplumu
kyresAl	kyresdl	kyresel
bilgilArA	bilgilɑrɑ	bilgilere
kendilArH	kendilɑri	kendileri
hizmetlArHHn	hizmetlɑriin	hizmetleriin
geleʤekDA	geleʤekdi	geleʤekte
kiʃilArA	kiʃilɑrd	kiʃilere
køjH	køji	køjy
sɑɑtH	sɑɑtɯ	sɑɑti
durumHn	durumɯn	durumun
ønlemlAr	ønlemlɑr	ønlemler
bølgelArDA	bølgelɑrdɑ	bølgelerde
jøntemlAr	jøntemlɑr	jøntemler
iʃitmA	iʃitmd	iʃitme
gøryʃH	gøryʃi	gøryʃy
hykymlAr	hykymlɑr	hykymler
merkezlArH	merkezlɑri	merkezleri
tyrlArH	tyrlɑri	tyrleri
bølgeA	bølgei	bølgee
søjlemA	søjlemd	søjleme
mɑlzemelArH	mɑlzemelɑri	mɑlzemeleri
sɑhiplArH	sɑhiplɑri	sɑhipleri
sɑlonH	sɑlonɯ	sɑlonu
telefonH	telefonɯ	telefonu
milletlAr	milletlɑr	milletler
dønemlArDA	dønemlɑrdɑ	dønemlerde
ʧøzymlArH	ʧøzymlɑri	ʧøzymleri
problemlArH	problemlɑri	problemleri
genʧlAr	genʧlɑr	genʧler
ʧekAn	ʧekɑn	ʧeken
døkymH	døkymi	døkymy
dønHʃ	døniʃ	dønyʃ
etkinlHklAr	etkinliklɑr	etkinlikler
girmA	girmd	girme
sempozjumH	sempozjumi	sempozjumu
gelHnʤA	gelinʤd	gelinʤe
ønlemA	ønlemi	ønleme
tymH	tymi	tymy
ʧerʧeveDA	ʧerʧevedi	ʧerʧevede
ʃirketlArHn	ʃirketlɑrin	ʃirketlerin
øɰrenmA	øɰrenmd	øɰrenme
ʧevresAl	ʧevresdl	ʧevresel
gynlAr	gynlɑr	gynler
seʧmA	seʧmɑ	seʧme
dyzenlAnmAH	dyzenlɑnmdi	dyzenlenmei
jønetiʤilArH	jønetiʤilɑri	jønetiʤileri
øɰrenʤiA	øɰrenʤii	øɰrenʤie
sistemlArHHn	sistemlɑriin	sistemleriin
etmADA	etmddɑ	etmete
mɑlzemelAr	mɑlzemelɑr	mɑlzemeler
jønDAn	jøndɑn	jønden
sistemDA	sistemdɑ	sistemde
dyzenlemAlAr	dyzenlemɑlɑr	dyzenlemeler
dikkɑtlH	dikkɑtlɯ	dikkɑtli
geliʃmAH	geliʃmɑi	geliʃmei
ørneklArH	ørneklɑri	ørnekleri
fɑɑlijetlAr	fɑɑlijetlɑr	fɑɑlijetler
ojunH	ojunɯ	ojunu
beklAnAn	beklɑndn	beklenen
gøstermA	gøstermd	gøsterme
mutlulHk	mutlulɯk	mutluluk
sɑɑtlArH	sɑɑtlɑrɯ	sɑɑtleri
evA	evi	eve
ylkelArA	ylkelɑrd	ylkelere
isteDHklArH	istediklɑri	istedikleri
belirtArAk	belirtɑrɑk	belirterek
eɰitimA	eɰitimd	eɰitime
bølgeDAki	bølgeddki	bølgedeki
usulH	usulɯ	usuly
geliʃmAlArH	geliʃmɑlɑri	geliʃmeleri
ødylH	ødyli	ødyly
hizmetlArHn	hizmetlɑrin	hizmetlerin
bojutlH	bojutli	bojutlu
evrensAl	evrensdl	evrensel
nedenlArH	nedenlɑri	nedenleri
temsilʤilArH	temsilʤilɑri	temsilʤileri
deɰiʃiklHklArH	deɰiʃikliklɑri	deɰiʃiklikleri
hukukH	hukuki	hukuku
tɑrihsAl	tɑrihsdl	tɑrihsel
fɑktørlAr	fɑktørlɑr	fɑktørler
kɑblosHz	kɑblosɯz	kɑblosuz
kurtulHʃ	kurtulɯʃ	kurtuluʃ
bilgilArHHn	bilgilɑriin	bilgileriin
belgelArHn	belgelɑrin	belgelerin
notH	notɯ	notu
birimlArH	birimlɑri	birimleri
gøzA	gøzɑ	gøze
eserlArH	eserlɑri	eserleri
tedbirlAr	tedbirlɑr	tedbirler
bizDA	bizdɑ	bizde
eserlAr	eserlɑr	eserler
nereA	nerei	neree
nereDAn	nereddn	nereden
genA	gend	gene
bulunDHklArH	bulundɯklɑrɯ	bulunduklɑrɯ
ylkeA	ylkei	ylkee
jønetmelikDA	jønetmelikdi	jønetmelikte
syrelArH	syrelɑri	syreleri
ʧevreA	ʧevrei	ʧevree
fɑɑlijetA	fɑɑlijetɑ	fɑɑlijete
ilkelArH	ilkelɑri	ilkeleri
kesmA	kesmd	kesme
bizDAn	bizdɑn	bizden
gelArAk	gelɑrɑk	gelerek
kuvvetlArH	kuvvetlɑri	kuvvetleri
nitelikDA	nitelikdɑ	nitelikte
bɑʃlɑngɯʧDA	bɑʃlɑngɯʧdɑ	bɑʃlɑngɯʧtɑ
gynmHz	gynmiz	gynmyz
ʃirketlArH	ʃirketlɑri	ʃirketleri
øɰretmenlAr	øɰretmenlɑr	øɰretmenler
yrynlArHHn	yrynlɑriin	yrynleriin
ileriDA	ileridi	ileride
ʧeʃitlArH	ʧeʃitlɑri	ʧeʃitleri
bojutH	bojutɯ	bojutu
sɑɑtDA	sɑɑtdɑ	sɑɑtte
ʃimdiA	ʃimdii	ʃimdie
okulHn	okulɯn	okulun
mezunH	mezuni	mezunu
tesislAr	tesislɑr	tesisler
verilArHn	verilɑrin	verilerin
ønerilAr	ønerilɑr	øneriler
gørevlHlArH	gørevlilɑri	gørevlileri
denizA	denizd	denize
kiʃiDAn	kiʃiddn	kiʃiden
tɑrihA	tɑrihɑ	tɑrihe
giderlArH	giderlɑri	giderleri
nyfusH	nyfusi	nyfusu
etmAH	etmɑi	etmei
tɑrɑfDA	tɑrɑfdɑ	tɑrɑftɑ
jetkilHlArH	jetkililɑri	jetkilileri
jønlH	jønlɯ	jønly
øzgyrlHk	øzgyrlik	øzgyrlyk
iʃlArHn	iʃlɑrɯn	iʃlerin
modellArH	modellɑri	modelleri
iʃlemlArHn	iʃlemlɑrin	iʃlemlerin
tedbirlArH	tedbirlɑri	tedbirleri
belirlemA	belirlemi	belirleme
jyklemA	jyklemd	jykleme
yʤretlArH	yʤretlɑri	yʤretleri
gøryʃmelAr	gøryʃmelɑr	gøryʃmeler
grupDA	grupdɑ	gruptɑ
bølgelAr	bølgelɑr	bølgeler
belirleAn	belirledn	belirleen
sevijeDA	sevijedi	sevijede
ønlAnmAH	ønlɑnmɑɯ	ønlenmei
geʧmiʃDA	geʧmiʃdɑ	geʧmiʃte
geliʃmADA	geliʃmɑdɑ	geliʃmete
memurH	memuri	memuru
jyzH	jyzi	jyzy
seʧeneklArH	seʧeneklɑri	seʧenekleri
girmAH	girmdi	girmei
ujgunlHk	ujgunlɯk	ujgunluk
jønH	jøni	jøny
komutH	komutɯ	komutu
fonksijonH	fonksijonɯ	fonksijonu
hɑjɑtDA	hɑjɑtdɑ	hɑjɑttɑ
ørgytlArH	ørgytlɑri	ørgytleri
bɑʃvuruH	bɑʃvurui	bɑʃvuruu
olHnʤA	olɯnʤɑ	olunʤɑ
ønerilArH	ønerilɑri	ønerileri
gøryʃlArH	gøryʃlɑri	gøryʃleri
genʧlArHn	genʧlɑrin	genʧlerin
kuruluʃHn	kuruluʃɯn	kuruluʃun
proʒelArHn	proʒelɑrin	proʒelerin
bølymlArH	bølymlɑri	bølymleri
geʧArAk	geʧɑrɑk	geʧerek
jetkilArH	jetkilɑri	jetkileri
tɑleplArH	tɑleplɑri	tɑlepleri
yʧDA	yʧdɑ	yʧte
gørevlAr	gørevlɑr	gørevler
bizlerA	bizlerd	bizlere
ikiA	ikii	ikie
tiplArH	tiplɑri	tipleri
dyzeltmA	dyzeltmd	dyzeltme
etmAlArH	etmɑlɑri	etmeleri
sɑɑtlHk	sɑɑtlɯk	sɑɑtlik
belirtmA	belirtmd	belirtme
hekimlAr	hekimlɑr	hekimler
iʃDAn	iʃdɑn	iʃten
kolH	kolɯ	kolu
yniversitelAr	yniversitelɑr	yniversiteler
gørynAn	gøryndn	gørynen
girArAk	girɑrɑk	girerek
verDHklArH	verdiklɑri	verdikleri
søjleAn	søjleɑn	søjleen
doɰruH	doɰruɯ	doɰruu
ølymH	ølymi	ølymy
ʃejlArH	ʃejlɑri	ʃejleri
birimlAr	birimlɑr	birimler
gøryntylAr	gøryntylɑr	gøryntyler
kuʃkusHz	kuʃkusɯz	kuʃkusuz
oluʃumH	oluʃumɯ	oluʃumu
ʧekmA	ʧekmi	ʧekme
geriDA	geridi	geride
diɰerlArH	diɰerlɑri	diɰerleri
orduH	orduɯ	orduu
engellAr	engellɑr	engeller
øɰrenʤilArHHn	øɰrenʤilɑriin	øɰrenʤileriin
servislArH	servislɑri	servisleri
dyzenlAnAʤAk	dyzenlɑnɑʤdk	dyzenleneʤek
devletlArHn	devletlɑrin	devletlerin
tedɑviA	tedɑvii	tedɑvie
ølʧmA	ølʧmɑ	ølʧme
gelirlArH	gelirlɑri	gelirleri
hɑstɑneA	hɑstɑneɑ	hɑstɑnee
jyksekokulH	jyksekokuli	jyksekokulu
gørHnʤA	gørinʤd	gørynʤe
myhendislArH	myhendislɑri	myhendisleri
jyzmA	jyzmd	jyzme
desteklAAn	desteklddn	destekleen
testlArH	testlɑri	testleri
bølgelArH	bølgelɑri	bølgeleri
gøzlArH	gøzlɑri	gøzleri
geʧmA	geʧmi	geʧme
hyʤrelArH	hyʤrelɑri	hyʤreleri
tuʃH	tuʃɯ	tuʃu
ʃejA	ʃejɑ	ʃeje
sonsHz	sonsɯz	sonsuz
jɑpmADA	jɑpmɑdɑ	jɑpmɑtɑ
sizDAn	sizdɑn	sizden
niteliklArH	niteliklɑri	nitelikleri
problemlAr	problemlɑr	problemler
kelimelAr	kelimelɑr	kelimeler
deɰerlendirmA	deɰerlendirmd	deɰerlendirme
bekleAn	bekleɑn	bekleen
dikkɑtH	dikkɑtɯ	dikkɑti
elDAn	elddn	elden
sistemlArHn	sistemlɑrin	sistemlerin
øzellHklArA	øzelliklɑri	øzelliklere
bɑʃDAn	bɑʃdɑn	bɑʃtɑn
evlArH	evlɑri	evleri
geʧmAH	geʧmdi	geʧmei
isimlArH	isimlɑri	isimleri
konumH	konumɯ	konumu
pɑrtilAr	pɑrtilɑr	pɑrtiler
proʒeA	proʒeɑ	proʒee
ystA	ystd	yste
doɰumlH	doɰumlɯ	doɰumlu
bølymlAr	bølymlɑr	bølymler
devletlArH	devletlɑri	devletleri
kimlAr	kimlɑr	kimler
ʧoʤuklHk	ʧoʤuklɯk	ʧoʤukluk
hedeflArH	hedeflɑri	hedefleri
uʧHʃ	uʧiʃ	uʧuʃ
dilDA	dildɑ	dilde
erkeklAr	erkeklɑr	erkekler
iʃlArDA	iʃlɑrdɑ	iʃlerde
isteklArH	isteklɑri	istekleri
jolHn	jolɯn	jolun
dyzenleAn	dyzenledn	dyzenleen
øzellHklArHHn	øzelliklɑriin	øzellikleriin
ʃejDAn	ʃejdɑn	ʃejden
birejlAr	birejlɑr	birejler
kimseA	kimsed	kimsee
myʃteriA	myʃterii	myʃterie
mɑlzemelArHn	mɑlzemelɑrin	mɑlzemelerin
gelirlAr	gelirlɑr	gelirler
iʃletmelAr	iʃletmelɑr	iʃletmeler
jønetiʤilAr	jønetiʤilɑr	jønetiʤiler
mɑlijetlArH	mɑlijetlɑri	mɑlijetleri
birejlArHn	birejlɑrin	birejlerin
bølymHn	bølymin	bølymyn
jykH	jyki	jyky
sorumluH	sorumluɯ	sorumluu
ylkemHzDAki	ylkemizddki	ylkemizdeki
syrelAr	syrelɑr	syreler
tɑbloH	tɑbloɯ	tɑblou
syreʧDA	syreʧdi	syreʧte
seslArH	seslɑri	sesleri
hyʤrelAr	hyʤrelɑr	hyʤreler
iʧmA	iʧmd	iʧme
fɑɑlijetlArHHn	fɑɑlijetlɑriin	fɑɑlijetleriin
iʧA	iʧɑ	iʧe
orgɑnizɑsjonH	orgɑnizɑsjonɯ	orgɑnizɑsjonu
ɑnɑlizlArH	ɑnɑlizlɑri	ɑnɑlizleri
evlAr	evlɑr	evler
søzlArH	søzlɑri	søzleri
bølymHHn	bølymiin	bølymyyn
dønemA	dønemd	døneme
rɑporHn	rɑporɯn	rɑporun
iʃletmelArHn	iʃletmelɑrin	iʃletmelerin
hekimlArHn	hekimlɑrin	hekimlerin
polislAr	polislɑr	polisler
merkezDA	merkezdd	merkezde
sektørA	sektørɑ	sektøre
ylkelArDAn	ylkelɑrddn	ylkelerden
vermADAn	vermdddn	vermeden
jyklH	jykli	jykly
sɑhiplArHHn	sɑhiplɑriin	sɑhipleriin
gøzlAr	gøzlɑr	gøzler
personelA	personeld	personele
yremA	yremd	yreme
kyresAllAʃmA	kyresɑlldʃmɑ	kyreselleʃme
ønlemlArH	ønlemlɑri	ønlemleri
kɑliteDA	kɑlitedɑ	kɑlitede
pɑrɑmetrelAr	pɑrɑmetrelɑr	pɑrɑmetreler
bulunmADA	bulunmɑdɑ	bulunmɑtɑ
hukukHn	hukukin	hukukun
nyfusHn	nyfusin	nyfusun
ønʤelArH	ønʤelɑri	ønʤeleri
dyzejlArH	dyzejlɑri	dyzejleri
iʃʧilArHn	iʃʧilɑrin	iʃʧilerin
nolH	nolɯ	nolu
ʧoklH	ʧoklɯ	ʧoklu
soruH	soruɯ	soruu
derneklAr	derneklɑr	dernekler
geʤikmA	geʤikmi	geʤikme
yjeDAn	yjeddn	yjeden
istɑtistiksAl	istɑtistiksdl	istɑtistiksel
koʃulH	koʃulɯ	koʃulu
dinlenmA	dinlenmd	dinlenme
øɰretmenlArHn	øɰretmenlɑrin	øɰretmenlerin
dyzenlemA	dyzenlemi	dyzenleme
dyzejA	dyzejɑ	dyzeje
gøndermA	gøndermd	gønderme
inʤelemA	inʤelemd	inʤeleme
sytH	syti	syty
bølymA	bølymd	bølyme
hɑberlArH	hɑberlɑri	hɑberleri
hɑstɑneDA	hɑstɑnedɑ	hɑstɑnede
listeDA	listedɑ	listede
tytynlAr	tytynlɑr	tytynler
beledijelAr	beledijelɑr	beledijeler
hedeflAr	hedeflɑr	hedefler
ødemelAr	ødemelɑr	ødemeler
proʒeDA	proʒedɑ	proʒede
kitɑpDA	kitɑpdɑ	kitɑptɑ
byjyAn	byjyɑn	byjyen
søzlAr	søzlɑr	søzler
deɰerlendirmAH	deɰerlendirmdi	deɰerlendirmei
kiʃilArDA	kiʃilɑrdɑ	kiʃilerde
iʃlemlArHHn	iʃlemlɑriin	iʃlemleriin
kiʃilArH	kiʃilɑri	kiʃileri
jyryHʃ	jyryiʃ	jyryyʃ
gøzH	gøzi	gøzy
køjHn	køjin	køjyn
mɑddeA	mɑddeɑ	mɑddee
memurlArH	memurlɑri	memurlɑrɯ
pɑrɑmetrelArH	pɑrɑmetrelɑri	pɑrɑmetreleri
belirtilArH	belirtilɑri	belirtileri
etmADAn	etmddɑn	etmeden
ølAn	øldn	ølen
byroH	byroɯ	byrou
desteklAr	desteklɑr	destekler
izlAr	izlɑr	izler
silmA	silmd	silme
gøsterArAk	gøsterɑrdk	gøstererek
birliklArH	birliklɑri	birlikleri
kɑbulH	kɑbulɯ	kɑbuly
vɑdeDA	vɑdedɑ	vɑdede
ʧekilAn	ʧekildn	ʧekilen
testlAr	testlɑr	testler
getirArAk	getirɑrɑk	getirerek
merkezA	merkezd	merkeze
dyʃynmA	dyʃynmd	dyʃynme
dersDA	dersdɑ	derste
gerʧeklAʃmAH	gerʧekldʃmɑɯ	gerʧekleʃmei
internetA	interneti	internete
resimlAr	resimlɑr	resimler
ʃekillArH	ʃekillɑri	ʃekilleri
yʤretlAr	yʤretlɑr	yʤretler
yniversiteDA	yniversitedi	yniversitede
gɑzeteDA	gɑzetedɑ	gɑzetede
bølymDAn	bølymddn	bølymden
gølH	gøli	gøly
gørynymH	gørynymi	gørynymy
dereʤeA	dereʤei	dereʤee
ileriA	ilerii	ilerie
resimlArH	resimlɑri	resimleri
siteDA	sitedɑ	sitede
tɑsɑrrufH	tɑsɑrrufɯ	tɑsɑrrufu
ʃehirDA	ʃehirdɑ	ʃehirde
bitkilArH	bitkilɑri	bitkileri
dønAn	dønɑn	dønen
derslArA	derslɑrɑ	derslere
tɑrihlArDA	tɑrihlɑrdɑ	tɑrihlerde
gørevDAn	gørevdɑn	gørevden
kendimA	kendimd	kendime
pɑrtilArHn	pɑrtilɑrin	pɑrtilerin
bølgelArA	bølgelɑrɑ	bølgelere
kendinHzA	kendinizd	kendinize
jetkilHlAr	jetkililɑr	jetkililer
ʧekmA	ʧekmi	ʧekme
deɰerlArHn	deɰerlɑrin	deɰerlerin
dostlHk	dostlɯk	dostluk
kursH	kursɯ	kursu
metinlAr	metinlɑr	metinler
geliʃmAlArHn	geliʃmɑlɑrin	geliʃmelerin
sɯnɯfDA	sɯnɯfdɑ	sɯnɯftɑ
erkeklArDA	erkeklɑrdɑ	erkeklerde
hɑreketlAr	hɑreketlɑr	hɑreketler
kɑdroH	kɑdroɯ	kɑdrou
kurumHHn	kurumɯɯn	kurumuun
myʃterilAr	myʃterilɑr	myʃteriler
topDAn	topdɑn	toptɑn
geliʃmAlArA	geliʃmɑlɑrɑ	geliʃmelere
giderlAr	giderlɑr	giderler
gelmA	gelmi	gelme
seklHnDA	seklindɑ	seklinde
kontrollH	kontrollɯ	kontrolly
tehlikeA	tehlikei	tehlikee
tesislArHn	tesislɑrin	tesislerin
ylkelArHHn	ylkelɑriin	ylkeleriin
gøryntylArH	gøryntylɑri	gøryntyleri
hykymlArA	hykymlɑrd	hykymlere
olAbilmA	olɑbilmd	olɑbilme
ɑltDA	ɑltdɑ	ɑlttɑ
menyH	menyi	menyy
derslArDAn	derslɑrdɑn	derslerden
motorlH	motorlɯ	motorlu
jɑʃDA	jɑʃdɑ	jɑʃtɑ
øɰrenʤilArmHz	øɰrenʤilɑrmiz	øɰrenʤilermiz
dujguH	dujgui	dujguu
myʃterilArHn	myʃterilɑrin	myʃterilerin
renklArH	renklɑri	renkleri
yniversitelArHn	yniversitelɑrin	yniversitelerin
geʧirAn	geʧirɑn	geʧiren
komisjonHn	komisjonɯn	komisjonun
sɯnɑvlArH	sɯnɑvlɑri	sɯnɑvlɑrɯ
ʧøzymA	ʧøzymd	ʧøzyme
modylH	modyli	modyly
ʃirketlArHHn	ʃirketlɑriin	ʃirketleriin
belirlemA	belirlemi	belirleme
listeA	listei	listee
seminerlAr	seminerlɑr	seminerler
dillAr	dillɑr	diller
eklemA	eklemd	ekleme
sendromH	sendromɯ	sendromu
unsurH	unsurɯ	unsuru
ylkeDAn	ylkeddn	ylkeden
ylkelArDAki	ylkelɑrddki	ylkelerdeki
dyzenlemAlArH	dyzenlemɑlɑri	dyzenlemeleri
durumHHn	durumɯɯn	durumuun
jykselAn	jykseldn	jykselen
renkDA	renkdɑ	renkte
ɑlmADA	ɑlmɑdɑ	ɑlmɑtɑ
køjDA	køjdɑ	køjde
penʤereDA	penʤeredi	penʤerede
plɑtformH	plɑtformɯ	plɑtformu
tyrDAn	tyrdɑn	tyrden
yniversiteA	yniversitei	yniversitee
gørmAH	gørmɑi	gørmei
ilkelAr	ilkelɑr	ilkeler
kendilArHHn	kendilɑriin	kendileriin
sorumlHlHklArH	sorumlɯlɯklɑrɯ	sorumluluklɑrɯ
beʃnʤH	beʃnʤɯ	beʃnʤi
denejsAl	denejsɑl	denejsel
prensiplArH	prensiplɑri	prensipleri
øɰrenʤilArmHzHn	øɰrenʤilɑrmizin	øɰrenʤilermizin
yjelArA	yjelɑrd	yjelere
olDHkDAn	oldɯkdɑn	olduktɑn
iʃsHzlHk	iʃsɯzlik	iʃsizlik
deɰiʃiklHklArHn	deɰiʃikliklɑrin	deɰiʃikliklerin
fɑɑlijetDA	fɑɑlijetdɑ	fɑɑlijette
teknoloʒilAr	teknoloʒilɑr	teknoloʒiler
gyʧlArH	gyʧlɑri	gyʧleri
seʧArAk	seʧɑrɑk	seʧerek
bojutDA	bojutdɑ	bojuttɑ
gerʧeklArH	gerʧeklɑri	gerʧekleri
girmA	girmd	girme
iʃʧilAr	iʃʧilɑr	iʃʧiler
kimselAr	kimselɑr	kimseler
zihinsAl	zihinsdl	zihinsel
yretiʤilArH	yretiʤilɑri	yretiʤileri
deɰiʃmAH	deɰiʃmɑi	deɰiʃmei
sevijeA	sevijei	sevijee
mensuplArH	mensuplɑri	mensuplɑrɯ
ʧøzmA	ʧøzmɑ	ʧøzme
hedefA	hedefd	hedefe
servislAr	servislɑr	servisler
ɑilelAr	ɑilelɑr	ɑileler
gøndermA	gøndermd	gønderme
gøstermAH	gøstermdi	gøstermei
jyrytAn	jyrytdn	jyryten
kentsAl	kentsdl	kentsel
suʧH	suʧɯ	suʧu
yretimDA	yretimdi	yretimde
kriterlArH	kriterlɑri	kriterleri
mydyrlyklArH	mydyrlyklɑri	mydyrlykleri
kutuH	kutuɯ	kutuu
listelArH	listelɑri	listeleri
mɑkɑlelAr	mɑkɑlelɑr	mɑkɑleler
jyrytmA	jyrytmd	jyrytme
deɰerlendirmAA	deɰerlendirmɑi	deɰerlendirmee
gøryʃlAr	gøryʃlɑr	gøryʃler
ijilAʃmA	ijildʃmɑ	ijileʃme
ojunHn	ojunɯn	ojunun
sorunHHn	sorunɯɯn	sorunuun
topH	topɯ	topu
ylkeDAki	ylkeddki	ylkedeki
ɑdreslArH	ɑdreslɑri	ɑdresleri
mɑtemɑtiksAl	mɑtemɑtiksdl	mɑtemɑtiksel
teknoloʒiA	teknoloʒii	teknoloʒie
tesislArHHn	tesislɑriin	tesisleriin
belirtilAr	belirtilɑr	belirtiler
engellAmA	engellɑmɑ	engelleme
ilDA	ildd	ilde
nedenlAr	nedenlɑr	nedenler
penʤereDAn	penʤereddn	penʤereden
federɑsjonH	federɑsjonɯ	federɑsjonu
kimA	kimɑ	kime
dokuH	dokuɯ	dokuu
genʧlArA	genʧlɑrɑ	genʧlere
protokolH	protokolɯ	protokoly
sɑnijeDA	sɑnijedɑ	sɑnijede
suretDA	suretdɑ	surette
jerlArHn	jerlɑrin	jerlerin
gørHp	gørip	gøryp
hɑvuzH	hɑvuzi	hɑvuzu
olHʃH	olɯʃɯ	oluʃu
ødemAlArH	ødemɑlɑri	ødemeleri
geleʤekDAki	geleʤekddki	geleʤekteki
olAbilmAH	olɑbilmɑi	olɑbilmei
opsijonH	opsijonɯ	opsijonu
ihtimɑlH	ihtimɑlɯ	ihtimɑli
dønHp	dønip	dønyp
dønmA	dønmɑ	dønme
dilmHzDA	dilmizdi	dilmizde
renklAr	renklɑr	renkler
jønetiʤilArHHn	jønetiʤilɑriin	jønetiʤileriin
ʧøzmA	ʧøzmɑ	ʧøzme
iliʃkilArHn	iliʃkilɑrin	iliʃkilerin
ørgytlArHHn	ørgytlɑriin	ørgytleriin
nyfusHHn	nyfusiin	nyfusuun
sɑnɑtDA	sɑnɑtdɑ	sɑnɑttɑ
jɑpAbilmA	jɑpɑbilmɑ	jɑpɑbilme
seneDA	senedi	senede
vermADA	vermddɑ	vermete
geʧmADAn	geʧmdddn	geʧmeden
køjA	køjɑ	køje
øɰleDAn	øɰleddn	øɰleden
hedeflArA	hedeflɑrd	hedeflere
jykymlH	jykymli	jykymly
ɑlDHkDAn	ɑldɯkdɑn	ɑldɯktɑn
zorlHk	zorlɯk	zorluk
dyʃynmA	dyʃynmd	dyʃynme
internetDA	internetdd	internette
seʧeneklAr	seʧeneklɑr	seʧenekler
seʧimlAr	seʧimlɑr	seʧimler
uzɑkDA	uzɑkdɑ	uzɑktɑ
ønlemA	ønlemi	ønleme
ɑsliA	ɑsliɑ	ɑslie
dyʃmAH	dyʃmɑi	dyʃmei
kɑlemA	kɑlemd	kɑleme
normɑlDA	normɑldɑ	normɑlde
jyksAl	jyksdl	jyksel
fɑɑlijetlArHn	fɑɑlijetlɑrin	fɑɑlijetlerin
gɑzeteʤilAr	gɑzeteʤilɑr	gɑzeteʤiler
geʧmA	geʧmi	geʧme
geʤelArH	geʤelɑri	geʤeleri
soruH	soruɯ	soruu
mɑkinelArH	mɑkinelɑri	mɑkineleri
seʧmA	seʧmɑ	seʧme
sistemlArDA	sistemlɑrdɑ	sistemlerde
joksullHk	joksullɯk	joksulluk
dyʃynAn	dyʃyndn	dyʃynen
ekiplArH	ekiplɑri	ekipleri
eserlArHn	eserlɑrin	eserlerin
evlArHn	evlɑrin	evlerin
hedeflAAn	hedeflddn	hedefleen
koordinɑsjonH	koordinɑsjonɯ	koordinɑsjonu
verilArA	verilɑri	verilere
beklemA	beklemd	bekleme
birʃejlAr	birʃejlɑr	birʃejler
derslArDA	derslɑrdɑ	derslerde
dostH	dostɯ	dostu
fɑktørH	fɑktøri	fɑktøry
dyʃHʃ	dyʃiʃ	dyʃyʃ
ʧokDAn	ʧokdɑn	ʧoktɑn
deɰerlArHHn	deɰerlɑriin	deɰerleriin
desteklAmA	desteklɑmɑ	destekleme
iʃletmeA	iʃletmei	iʃletmee
dersDAn	dersddn	dersten
getirmAA	getirmɑi	getirmee
izlAnmAH	izlɑnmɑi	izlenmei
mezunlArH	mezunlɑri	mezunlɑrɯ
ruhH	ruhi	ruhu
birimlArHn	birimlɑrin	birimlerin
dyʃynʤelAr	dyʃynʤelɑr	dyʃynʤeler
inʤeleArAk	inʤeleɑrdk	inʤeleerek
operɑsjonH	operɑsjonɯ	operɑsjonu
ʧekArAk	ʧekɑrɑk	ʧekerek
ʃirketlArA	ʃirketlɑrɑ	ʃirketlere
ɑilelArHn	ɑilelɑrin	ɑilelerin
elektriksAl	elektriksdl	elektriksel
proʒelArA	proʒelɑrɑ	proʒelere
uzɑklɯkDA	uzɑklɯkdɑ	uzɑklɯktɑ
jykselmA	jykselmd	jykselme
ʧekilmAH	ʧekilmii	ʧekilmei
ølymA	ølymd	ølyme
bitkisAl	bitkisdl	bitkisel
ekonomiA	ekonomid	ekonomie
temsilʤilAr	temsilʤilɑr	temsilʤiler
øjkyH	øjkyi	øjkyy
etkilArHHn	etkilɑriin	etkileriin
iʃlevlArH	iʃlevlɑri	iʃlevleri
istɑsjonH	istɑsjonɯ	istɑsjonu
sɑvɑʃDA	sɑvɑʃdɑ	sɑvɑʃtɑ
seʧimA	seʧimd	seʧime
dyʃynʤelArH	dyʃynʤelɑri	dyʃynʤeleri
illArDA	illɑrdɑ	illerde
myʃterilArH	myʃterilɑri	myʃterileri
tedɑviDA	tedɑvidɑ	tedɑvide
jenilHklAr	jeniliklɑr	jenilikler
øzlHk	øzlik	øzlyk
ʃekillArDA	ʃekillɑrdɑ	ʃekillerde
eɰitimlArH	eɰitimlɑri	eɰitimleri
filmlAr	filmlɑr	filmler
gereksinimlArH	gereksinimlɑri	gereksinimleri
iʃleAn	iʃleɑn	iʃleen
inʤelemAH	inʤelemdi	inʤelemei
kuvvetlAr	kuvvetlɑr	kuvvetler
ønʤylHk	ønʤylik	ønʤylyk
bildirilAr	bildirilɑr	bildiriler
etkilAnAn	etkilɑndn	etkilenen
etmAnHz	etmɑniz	etmeniz
kyltyrHHn	kyltyriin	kyltyryyn
yniversitelArDA	yniversitelɑrdi	yniversitelerde
ekonomiDA	ekonomidɑ	ekonomide
hykymlH	hykymli	hykymly
isimlAr	isimlɑr	isimler
mɑddelArHHn	mɑddelɑriin	mɑddeleriin
menyDA	menydɑ	menyde
sektørDAki	sektørddki	sektørdeki
gørmAA	gørmɑɑ	gørmee
geʧDHkʧA	geʧdikʧɑ	geʧtikʧe
tekniklAr	tekniklɑr	teknikler
jɑpDHkDAn	jɑpdɯkdɑn	jɑptɯktɑn
evDAn	evdɑn	evden
myʤɑdeleDA	myʤɑdeledɑ	myʤɑdelede
beklemA	beklemd	bekleme
bolH	bolɯ	bolu
etmAAn	etmɑɑn	etmeen
sɑɑtlAr	sɑɑtlɑr	sɑɑtler
sokɑkDA	sokɑkdɑ	sokɑktɑ
jønetimlAr	jønetimlɑr	jønetimler
ʧɑlɯʃmADA	ʧɑlɯʃmɑdɑ	ʧɑlɯʃmɑtɑ
bitkilAr	bitkilɑr	bitkiler
kelimelArH	kelimelɑri	kelimeleri
kendimHzA	kendimizd	kendimize
sɑɑtlArDA	sɑɑtlɑrdɑ	sɑɑtlerde
ɑdresA	ɑdresd	ɑdrese
ɑlAbilmA	ɑlɑbilmd	ɑlɑbilme
ilgilHlArA	ilgililɑri	ilgililere
listelAr	listelɑr	listeler
gørDHklArH	gørdiklɑri	gørdykleri
okuHʤH	okuɯʤi	okuuʤu
søzDA	søzdɑ	søzde
hykymetlAr	hykymetlɑr	hykymetler
kurulumH	kurulumɯ	kurulumu
problemlArHn	problemlɑrin	problemlerin
sɑvunAn	sɑvundn	sɑvunɑn
sorunsHz	sorunsɯz	sorunsuz
biʧimlArH	biʧimlɑri	biʧimleri
getirmA	getirmi	getirme
menyDAn	menyddn	menyden
sitelAr	sitelɑr	siteler
bulHp	bulɯp	bulup
geliʃmAA	geliʃmɑɑ	geliʃmee
ynitelArH	ynitelɑri	yniteleri
serbestʧA	serbestʧɑ	serbestʧe
yjelArmHzHn	yjelɑrmizin	yjelermizin
ɑlɯnDHkDAn	ɑlɯndɯkdɑn	ɑlɯndɯktɑn
desteklAnmAH	desteklɑnmɑi	desteklenmei
fɑktørlArH	fɑktørlɑri	fɑktørleri
kesilAn	kesildn	kesilen
kriterlAr	kriterlɑr	kriterler
proʒelArDA	proʒelɑrdɑ	proʒelerde
sunuʤuH	sunuʤuɯ	sunuʤuu
tuzlH	tuzlɯ	tuzlu
ɑrtDHkʧA	ɑrtdɯkʧɑ	ɑrttɯkʧɑ
dønemlAr	dønemlɑr	dønemler
deɰerlArA	deɰerlɑrd	deɰerlere
depremA	depremd	depreme
geliʃmAHn	geliʃmɑin	geliʃmein
ilerleAn	ilerledn	ilerleen
linklAr	linklɑr	linkler
olmADA	olmɑdɑ	olmɑtɑ
temelDA	temeldd	temelde
ɑletlArH	ɑletlɑri	ɑletleri
dillArH	dillɑri	dilleri
gøryntyH	gøryntyi	gøryntyy
jyzA	jyzd	jyze
ʧɑpDA	ʧɑpdɑ	ʧɑptɑ
øzellHklArHn	øzelliklɑrin	øzelliklerin
yniversitelArɑrɑsɯ	yniversitelɑrɑrɑsɯ	yniversitelerɑrɑsɯ
dyʃynArAk	dyʃynɑrɑk	dyʃynerek
depremDAn	depremddn	depremden
erkeklArHn	erkeklɑrin	erkeklerin
konuHHn	konuɯɯn	konuuun
vermAAn	vermɑdn	vermeen
jemeklArH	jemeklɑri	jemekleri
bedellArH	bedellɑri	bedelleri
gønderAn	gønderdn	gønderen
listeDAn	listeddn	listeden
motorH	motorɯ	motoru
jøntemlArHHn	jøntemlɑriin	jøntemleriin
bɑʃvurulArH	bɑʃvurulɑri	bɑʃvurulɑrɯ
eɰitimlAr	eɰitimlɑr	eɰitimler
gøzlAnAn	gøzlɑnɑn	gøzlenen
ilgilenAn	ilgilendn	ilgilenen
kuruluʃHHn	kuruluʃɯɯn	kuruluʃuun
oturHp	oturɯp	oturup
proʒelArHHn	proʒelɑriin	proʒeleriin
ʧevreDA	ʧevredi	ʧevrede
ʃirketA	ʃirketd	ʃirkete
ɑskerlAr	ɑskerlɑr	ɑskerler
byjymAH	byjymdi	byjymei
hususDA	hususdɑ	husustɑ
kelimelArHn	kelimelɑrin	kelimelerin
jønlArH	jønlɑrɯ	jønleri
yjelArmHz	yjelɑrmiz	yjelermiz
deɰiʃimA	deɰiʃimi	deɰiʃime
geʧDHkDAn	geʧdikdɑn	geʧtikten
myʃterilArHHn	myʃterilɑriin	myʃterileriin
syreʧlArH	syreʧlɑri	syreʧleri
bilgilArnHzH	bilgilɑrnizi	bilgilernizi
dønemDAki	dønemddki	dønemdeki
eklemA	eklemd	ekleme
kyltyrHn	kyltyrin	kyltyryn
jyzejA	jyzejɑ	jyzeje
bugynHn	bugynin	bugynyn
geʧmiʃA	geʧmiʃɑ	geʧmiʃe
hykymetA	hykymetd	hykymete
iʃsHz	iʃsɯz	iʃsiz
køjlArDA	køjlɑrdɑ	køjlerde
jønetmeliklAr	jønetmeliklɑr	jønetmelikler
zorunlulHk	zorunlulɯk	zorunluluk
bildirAn	bildirdn	bildiren
iʃlAnmAH	iʃlɑnmɑɯ	iʃlenmei
køtyA	køtyi	køtye
sevAn	sevdn	seven
tɑbiplArH	tɑbiplɑri	tɑbipleri
tipDA	tipdɑ	tipte
deɰerlendirmAlAr	deɰerlendirmɑlɑr	deɰerlendirmeler
deɰiʃmA	deɰiʃmɑ	deɰiʃme
neA	ned	nee
tɑleplAr	tɑleplɑr	tɑlepler
jerDAki	jerddki	jerdeki
eklAnAn	eklɑndn	eklenen
etmAHn	etmɑin	etmein
gøstermAA	gøstermdi	gøstermee
gɑzetelArDA	gɑzetelɑrdɑ	gɑzetelerde
øɰrenʤilArDAn	øɰrenʤilɑrddn	øɰrenʤilerden
elmHzDA	elmizdi	elmizde
gøryʃmelArH	gøryʃmelɑri	gøryʃmeleri
hekimA	hekimi	hekime
iptɑlH	iptɑlɯ	iptɑli
olguH	olguɯ	olguu
gynmHzHn	gynmizin	gynmyzyn
ojH	ojɯ	oju
suʧlH	suʧlɯ	suʧlu
jøreDA	jøredɑ	jørede
øɰretmenlArH	øɰretmenlɑri	øɰretmenleri
ʃejlArHn	ʃejlɑrin	ʃejlerin
dyʃmA	dyʃmɑ	dyʃme
inʤelemAlAr	inʤelemɑlɑr	inʤelemeler
merkezDAn	merkezddn	merkezden
seslAr	seslɑr	sesler
øzH	øzi	øzy
binDA	bindd	binde
bitAn	bitɑn	biten
dønmAH	dønmɑi	dønmei
etkilAHʤH	etkildiʤi	etkileiʤi
fikirlAr	fikirlɑr	fikirler
isteAnlArHn	isteɑnlɑrin	isteenlerin
kentDA	kentdd	kentte
mɑlijetlAr	mɑlijetlɑr	mɑlijetler
beslemA	beslemd	besleme
bulunHp	bulunɯp	bulunup
ɑilelArH	ɑilelɑri	ɑileleri
dyzenlemAlArHn	dyzenlemɑlɑrin	dyzenlemelerin
gidermA	gidermd	giderme
huzurlH	huzurlɯ	huzurlu
ihɑleA	ihɑleɑ	ihɑlee
søzleʃmeDA	søzleʃmedɑ	søzleʃmede
suʧHn	suʧɯn	suʧun
tekliflAr	tekliflɑr	teklifler
toplumHHn	toplumɯɯn	toplumuun
tutumH	tutumɯ	tutumu
ønemA	ønemd	øneme
bilArAk	bilɑrɑk	bilerek
dujgulArH	dujgulɑri	dujgulɑrɯ
etmADAn	etmddɑn	etmeten
kokuH	kokuɯ	kokuu
krizDAn	krizddn	krizden
stɑtyH	stɑtyi	stɑtyy
temsilʤilArHHn	temsilʤilɑriin	temsilʤileriin
turH	turɯ	turu
usullArH	usullɑrɯ	usulleri
yrynlArA	yrynlɑrd	yrynlere
ystynDAki	ystynddki	ystyndeki
fɑktørlArHn	fɑktørlɑrin	fɑktørlerin
kojHp	kojɯp	kojup
strɑteʒilArH	strɑteʒilɑri	strɑteʒileri
ønlAHʤH	ønlɑiʤi	ønleiʤi
dyzenlemAH	dyzenlemdi	dyzenlemei
teknoloʒilArHHn	teknoloʒilɑriin	teknoloʒileriin
jyryrlykDA	jyryrlykdi	jyryrlykte
eklAnmAH	eklɑnmɑi	eklenmei
enflɑsjonHn	enflɑsjonɯn	enflɑsjonun
myhendislAr	myhendislɑr	myhendisler
rɑporHHn	rɑporɯɯn	rɑporuun
sebeplArH	sebeplɑri	sebepleri
silmA	silmd	silme
jønetimA	jønetimd	jønetime
dyzAnlAHʤH	dyzɑnlɑiʤi	dyzenleiʤi
gørArAk	gørɑrɑk	gørerek
gøsterilArH	gøsterilɑri	gøsterileri
genʧlArH	genʧlɑri	genʧleri
hɑstɑnelAr	hɑstɑnelɑr	hɑstɑneler
kredilAr	kredilɑr	krediler
jyryrlykDAn	jyryrlykddn	jyryrlykten
ønlemlArHn	ønlemlɑrin	ønlemlerin
yretiʤilAr	yretiʤilɑr	yretiʤiler
gønderArAk	gønderɑrɑk	gøndererek
tepkilAr	tepkilɑr	tepkiler
ujumH	ujumɯ	ujumu
ørgytlAr	ørgytlɑr	ørgytler
dujDHklArH	dujdɯklɑri	dujduklɑrɯ
gørevDA	gørevdi	gørevde
hyʤrelArHHn	hyʤrelɑriin	hyʤreleriin
kokulH	kokulɯ	kokulu
okulmHz	okulmɯz	okulmuz
søzleʃmelArH	søzleʃmelɑri	søzleʃmeleri
teʃekkyrlAr	teʃekkyrlɑr	teʃekkyrler
tijɑtroH	tijɑtroɯ	tijɑtrou
ʧɑlɯʃDHklArH	ʧɑlɯʃdɯklɑrɯ	ʧɑlɯʃtɯklɑrɯ
øɰrenmAA	øɰrenmdi	øɰrenmee
ølʧymH	ølʧymi	ølʧymy
bitkilArHn	bitkilɑrin	bitkilerin
deɰiʃimlAr	deɰiʃimlɑr	deɰiʃimler
engellAAn	engellddn	engelleen
iliʃkilArHHn	iliʃkilɑriin	iliʃkileriin
senetlArH	senetlɑri	senetleri
bɑʃvurAnHn	bɑʃvurɑnin	bɑʃvurɑnɯn
bedensAl	bedensdl	bedensel
girmAA	girmɑi	girmee
kesilmAH	kesilmdi	kesilmei
ujruklH	ujruklɯ	ujruklu
ɑrɑziDA	ɑrɑzidɑ	ɑrɑzide
borʧlH	borʧlɯ	borʧlu
gelmAA	gelmɑi	gelmee
hemDA	hemdɑ	hemde
iʃlAnAn	iʃlɑnɑn	iʃlenen
kɯlɑvuzH	kɯlɑvuzi	kɯlɑvuzu
kɑtDA	kɑtdɑ	kɑttɑ
kontrollArH	kontrollɑrɯ	kontrolleri
nedenlArDAn	nedenlɑrdɑn	nedenlerden
jetiʃAn	jetiʃɑn	jetiʃen
birA	birɑ	bire
desteklAnAn	desteklɑndn	desteklenen
sebeplAr	sebeplɑr	sebepler
sistemDAn	sistemddn	sistemden
vyʤutDA	vyʤutdɑ	vyʤuttɑ
jerleʃmA	jerleʃmɑ	jerleʃme
beklentilArH	beklentilɑri	beklentileri
divA	divɑ	dive
fɑɑlijetlArA	fɑɑlijetlɑrɑ	fɑɑlijetlere
hɑreketlArHHn	hɑreketlɑriin	hɑreketleriin
teknoloʒilArHn	teknoloʒilɑrin	teknoloʒilerin
jøntemlArHn	jøntemlɑrin	jøntemlerin
jykymlHlHklArH	jykymliliklɑri	jykymlylykleri
jemeklAr	jemeklɑr	jemekler
bebeklAr	bebeklɑr	bebekler
dinsAl	dinsdl	dinsel
fiʃH	fiʃɯ	fiʃi
koordinɑtørH	koordinɑtøri	koordinɑtøry
orduHn	orduɯn	orduun
sunumH	sunumɯ	sunumu
jyrymA	jyrymd	jyryme
ʧiʧeklAr	ʧiʧeklɑr	ʧiʧekler
dyzelmA	dyzelmd	dyzelme
gyndemDA	gyndemdd	gyndemde
iʃlArHHn	iʃlɑrɯin	iʃleriin
jønA	jønɑ	jøne
bitDHkDAn	bitdikdɑn	bittikten
etDHkDAn	etdikdɑn	ettikten
iʧeriA	iʧerii	iʧerie
kɑpɑsitelArH	kɑpɑsitelɑri	kɑpɑsiteleri
myʃterilArmHzHn	myʃterilɑrmizin	myʃterilermizin
mydyrlArH	mydyrlɑri	mydyrleri
rekɑbetA	rekɑbetɑ	rekɑbete
temizlAnmAH	temizlɑnmɑi	temizlenmei
jolHHn	jolɯɯn	joluun
ølʧymlArH	ølʧymlɑri	ølʧymleri
ɑnnelAr	ɑnnelɑr	ɑnneler
benzeAn	benzeɑn	benzeen
binA	bind	bine
gøryʃmelArDA	gøryʃmelɑrdi	gøryʃmelerde
geʧHʃH	geʧiʃɯ	geʧiʃi
girmADAn	girmdddn	girmeden
iʃlemlArDA	iʃlemlɑrdɑ	iʃlemlerde
virysH	virysi	virysy
ødyllArH	ødyllɑri	ødylleri
ødemAH	ødemdi	ødemei
ʃiʃlH	ʃiʃlɯ	ʃiʃli
yʧlH	yʧli	yʧly
byjyklHkDA	byjyklikdi	byjyklykte
bɑʃvuruHn	bɑʃvuruin	bɑʃvuruun
dønHʃH	døniʃɯ	dønyʃy
enfeksijonH	enfeksijonɯ	enfeksijonu
hepnHzA	hepnizi	hepnize
iʃlArA	iʃlɑrɑ	iʃlere
kusursHz	kusursɯz	kusursuz
metinlArH	metinlɑri	metinleri
servisA	servisd	servise
ørtyH	ørtyi	ørtyy
filmlArH	filmlɑri	filmleri
herʃejDAn	herʃejdɑn	herʃejden
milletlArHn	milletlɑrin	milletlerin
verAbilmA	veribilmi	verebilme
yjelArDAn	yjelɑrddn	yjelerden
dønmA	dønmɑ	dønme
bølgelArHn	bølgelɑrin	bølgelerin
dergilArDA	dergilɑrdɑ	dergilerde
gøryʃmA	gøryʃmɑ	gøryʃme
gyʧlAr	gyʧlɑr	gyʧler
gerʧeklAr	gerʧeklɑr	gerʧekler
sɑɑtA	sɑɑtɑ	sɑɑte
jønetiʤilArHn	jønetiʤilɑrin	jønetiʤilerin
deɰiʃiklHklArA	deɰiʃikliklɑri	deɰiʃikliklere
evlenmA	evlenmd	evlenme
evlArDA	evlɑrdɑ	evlerde
kuvvetlArHHn	kuvvetlɑriin	kuvvetleriin
sizDA	sizdɑ	sizde
jerlArHHn	jerlɑriin	jerleriin
enstityA	enstityi	enstitye
izlArH	izlɑri	izleri
dønemlArH	dønemlɑri	dønemleri
geliʃmAH	geliʃmɑi	geliʃmei
kentA	kentd	kente
tedbirlArHn	tedbirlɑrin	tedbirlerin
dyzenlemAA	dyzenlemɑi	dyzenlemee
derlemA	derlemd	derleme
eɰitimDAn	eɰitimddn	eɰitimden
gelmADAn	gelmdddn	gelmeden
mɑsonlHk	mɑsonlɯk	mɑsonluk
ɑlkollH	ɑlkollɯ	ɑlkolly
dinlemA	dinlemd	dinleme
giriʃimlArH	giriʃimlɑri	giriʃimleri
rektørH	rektøri	rektøry
jenilAnmAH	jenilɑnmɑi	jenilenmei
ɑnɑlizlAr	ɑnɑlizlɑr	ɑnɑlizler
defterA	defterd	deftere
denizDAn	denizddn	denizden
fikirlArH	fikirlɑri	fikirleri
gøryʃmelArHn	gøryʃmelɑrin	gøryʃmelerin
kiʃiDA	kiʃidi	kiʃide
myʃterilArmHzA	myʃterilɑrmizd	myʃterilermize
tyrlArHHn	tyrlɑriin	tyrleriin
tɑrihlAr	tɑrihlɑr	tɑrihler
jɑpmADAn	jɑpmɑdɑn	jɑpmɑtɑn
joɰunlHk	joɰunlɯk	joɰunluk
ʃubelArH	ʃubelɑri	ʃubeleri
yrynA	yrynd	yryne
bytynH	bytyni	bytyny
doɰHʃ	doɰɯʃ	doɰuʃ
fonHn	fonɯn	fonun
merkezlArHHn	merkezlɑriin	merkezleriin
prɑtikDA	prɑtikdɑ	prɑtikte
syrymH	syrymi	syrymy
tesislArDA	tesislɑrdɑ	tesislerde
jønetmA	jønetmd	jønetme
bɑroH	bɑroɯ	bɑrou
denklemlAr	denklemlɑr	denklemler
gøzHn	gøzin	gøzyn
kredilArH	kredilɑri	kredileri
tekliflArH	tekliflɑri	teklifleri
tesisDA	tesisdɑ	tesiste
jyklAnHʤH	jykldniʤi	jykleniʤi
øɰretimA	øɰretimd	øɰretime
bølymlArDA	bølymlɑrdɑ	bølymlerde
ejlemlArH	ejlemlɑri	ejlemleri
gitmAH	gitmdi	gitmei
mesɑfeDA	mesɑfedɑ	mesɑfede
rektørlHk	rektørlik	rektørlyk
vergilAr	vergilɑr	vergiler
jyzejsAl	jyzejsɑl	jyzejsel
ɑlbymH	ɑlbymi	ɑlbymy
bølgeDAn	bølgedɑn	bølgeden
beledijelArHn	beledijelɑrin	beledijelerin
doktorH	doktorɯ	doktoru
gøsterDHklArH	gøsterdiklɑri	gøsterdikleri
hɑstɑlɯkDAn	hɑstɑlɯkdɑn	hɑstɑlɯktɑn
søzleʃmeA	søzleʃmei	søzleʃmee
jyzejlAr	jyzejlɑr	jyzejler
ørgytHHn	ørgytiin	ørgytyyn
dergiDA	dergidɑ	dergide
gyzellHklArH	gyzelliklɑri	gyzellikleri
hɑreketlArHn	hɑreketlɑrin	hɑreketlerin
hɑjɑlH	hɑjɑlɯ	hɑjɑli
islArH	islɑri	isleri
izleArAk	izleɑrɑk	izleerek
søzHn	søzin	søzyn
hɑfifʧA	hɑfifʧɑ	hɑfifʧe
mɑddelArDAn	mɑddelɑrdɑn	mɑddelerden
ønH	øni	øny
ɑktivitelAr	ɑktivitelɑr	ɑktiviteler
bytynlHk	bytynlik	bytynlyk
bozuklHk	bozuklɯk	bozukluk
dinlAr	dinlɑr	dinler
etkinlHklArHn	etkinliklɑrin	etkinliklerin
fɑɑlijetlArDA	fɑɑlijetlɑrdɑ	fɑɑlijetlerde
gørevlHlAr	gørevlilɑr	gørevliler
hykymlArHHn	hykymlɑriin	hykymleriin
hizmetlArDAn	hizmetlɑrddn	hizmetlerden
syreDAn	syreddn	syreden
tɯpDA	tɯpdɑ	tɯptɑ
tedɑvilArH	tedɑvilɑri	tedɑvileri
øɰelArH	øɰelɑri	øɰeleri
øɰrenʤilArmHzA	øɰrenʤilɑrmizd	øɰrenʤilermize
bursH	bursɯ	bursu
dønemDAn	dønemddn	dønemden
dyzenleArAk	dyzenleɑrdk	dyzenleerek
gøryntyH	gøryntyi	gøryntyy
iʧmA	iʧmd	iʧme
iʃlemlArA	iʃlemlɑrd	iʃlemlere
izlAnAn	izlɑnɑn	izlenen
krizA	krizɑ	krize
nitelikDAki	nitelikddki	nitelikteki
dergilAr	dergilɑr	dergiler
gøstermA	gøstermd	gøsterme
hizmetDAn	hizmetddn	hizmetten
iʃlevsAl	iʃlevsɑl	iʃlevsel
ilʧeDA	ilʧedi	ilʧede
mɑkbuzH	mɑkbuzɯ	mɑkbuzu
polislArHn	polislɑrin	polislerin
sitelArH	sitelɑri	siteleri
etkinlHklArA	etkinliklɑri	etkinliklere
hizmetlArA	hizmetlɑrd	hizmetlere
idɑreA	idɑreɑ	idɑree
mesleklAr	mesleklɑr	meslekler
tɑbloHn	tɑbloɯn	tɑbloun
jykselmAH	jykselmdi	jykselmei
elnHzDA	elnizdɑ	elnizde
hedeflAnAn	hedeflɑndn	hedeflenen
iʧAʤAk	iʧɑʤdk	iʧeʤek
menyA	menyi	menye
sektørlAr	sektørlɑr	sektørler
senDAn	senddn	senden
jyryAn	jyryɑn	jyryen
jolsuzlHk	jolsuzlɯk	jolsuzluk
yrynlArDA	yrynlɑrdd	yrynlerde
bølymlArHn	bølymlɑrin	bølymlerin
belgelArHHn	belgelɑriin	belgeleriin
depoH	depoi	depou
depremDA	depremdd	depremde
gɑzeteʤilArHn	gɑzeteʤilɑrin	gɑzeteʤilerin
getirmAH	getirmdi	getirmei
hɑstɑnelArDA	hɑstɑnelɑrdɑ	hɑstɑnelerde
istemA	istemd	isteme
mɑlzemeDAn	mɑlzemeddn	mɑlzemeden
syreʧlAr	syreʧlɑr	syreʧler
sektørlArDA	sektørlɑrdɑ	sektørlerde
tonH	tonɯ	tonu
vekillArH	vekillɑri	vekilleri
jetkilHlArHn	jetkililɑrin	jetkililerin
ɑileA	ɑilei	ɑilee
giriʃimlAr	giriʃimlɑr	giriʃimler
køpryH	køpryi	køpryy
sɑɑtDAn	sɑɑtdɑn	sɑɑtten
sevijelArH	sevijelɑri	sevijeleri
versijonH	versijonɯ	versijonu
ødyllAr	ødyllɑr	ødyller
bildirilArH	bildirilɑri	bildirileri
birimlArA	birimlɑrɑ	birimlere
myʤɑdeleA	myʤɑdeleɑ	myʤɑdelee
ørneklemA	ørneklemi	ørnekleme
ʃiirlArH	ʃiirlɑri	ʃiirleri
ʃikɑjetlAr	ʃikɑjetlɑr	ʃikɑjetler
ystDA	ystdd	ystte
ɑbonelAr	ɑbonelɑr	ɑboneler
denetlAr	denetlɑr	denetler
giriʃimlArDA	giriʃimlɑrdi	giriʃimlerde
korkuH	korkuɯ	korkuu
myʃterilArA	myʃterilɑrd	myʃterilere
onurlH	onurlɯ	onurlu
ɑskerlArH	ɑskerlɑri	ɑskerleri
entegrɑsjonH	entegrɑsjonɯ	entegrɑsjonu
etkenlAr	etkenlɑr	etkenler
risklArH	risklɑri	riskleri
seminerlArH	seminerlɑri	seminerleri
tørenDA	tørendd	tørende
tyketiʤiA	tyketiʤii	tyketiʤie
tɑmɑmlADHkDAn	tɑmɑmlɑdɯkdɑn	tɑmɑmlɑdɯktɑn
tɑrɑfDAki	tɑrɑfdɑki	tɑrɑftɑki
jyryrlykDAki	jyryrlykddki	jyryrlykteki
ʧekmAA	ʧekmɑi	ʧekmee
dinA	dind	dine
ellArH	ellɑri	elleri
ikiAr	ikiɑr	ikier
ilʧelArDA	ilʧelɑrdɑ	ilʧelerde
rezervlArH	rezervlɑri	rezervleri
syreA	syrei	syree
ørnekDA	ørnekdɑ	ørnekte
dyzenlAnArAk	dyzenlɑnɑrɑk	dyzenlenerek
devletDAn	devletddn	devletten
mydyrHn	mydyrin	mydyryn
sɑhneA	sɑhneɑ	sɑhnee
siteA	siteɑ	sitee
sonsHzA	sonsɯzɑ	sonsuzɑ
vergilArH	vergilɑri	vergileri
viryslAr	viryslɑr	virysler
ømyrlH	ømyrli	ømyrly
ʃehirlArDA	ʃehirlɑrdɑ	ʃehirlerde
ʃiʃlHk	ʃiʃlɯk	ʃiʃlik
dønArAk	dønɑrɑk	dønerek
evsAl	evsɑl	evsel
iʃɑretlArH	iʃɑretlɑri	iʃɑretleri
kriterlArA	kriterlɑrɑ	kriterlere
ʧiʧeklArH	ʧiʧeklɑri	ʧiʧekleri
yʧH	yʧi	yʧy
beledijeA	beledijei	beledijee
deɰerlendirAn	deɰerlendirdn	deɰerlendiren
festivɑlH	festivɑlɯ	festivɑli
komisjonHHn	komisjonɯɯn	komisjonuun
nyfusA	nyfusd	nyfusɑ
ølʧymlAr	ølʧymlɑr	ølʧymler
ønerilArDA	ønerilɑrdɑ	ønerilerde
ɑteʃA	ɑteʃɑ	ɑteʃe
dyʃynmAA	dyʃynmɑi	dyʃynmee
ellAr	ellɑr	eller
hɑlkDAn	hɑlkdɑn	hɑlktɑn
iʃletmelArH	iʃletmelɑri	iʃletmeleri
mydyrHHn	mydyriin	mydyryyn
søzleʃmelAr	søzleʃmelɑr	søzleʃmeler
ødemAH	ødemdi	ødemei
dønyʃymH	dønyʃymi	dønyʃymy
derinDAn	derinddn	derinden
inʤelemAA	inʤelemɑi	inʤelemee
inAn	indn	inen
internetDAn	internetddn	internetten
pɑnellAr	pɑnellɑr	pɑneller
syrɑtlH	syrɑtlɯ	syrɑtli
sembolH	sembolɯ	semboly
sitemHzDA	sitemizdɑ	sitemizde
jønetimlArHn	jønetimlɑrin	jønetimlerin
ørgytlH	ørgytli	ørgytly
deɰerlendirmADA	deɰerlendirmddɑ	deɰerlendirmede
dinlemA	dinlemd	dinleme
gørevlHlArHHn	gørevlilɑriin	gørevlileriin
sɑvɑʃDAn	sɑvɑʃdɑn	sɑvɑʃtɑn
tutHp	tutɯp	tutup
jorgunlHk	jorgunlɯk	jorgunluk
zijɑretA	zijɑretɑ	zijɑrete
yjelHkDAn	yjelikdɑn	yjelikten
bozuklHklAr	bozuklɯklɑr	bozukluklɑr
formylH	formyli	formyly
kylH	kyli	kyly
kentlArDA	kentlɑrdɑ	kentlerde
jemA	jemd	jeme
ørgytsAl	ørgytsdl	ørgytsel
deɰiʃimlArH	deɰiʃimlɑri	deɰiʃimleri
devrelAr	devrelɑr	devreler
gyʧlArHHn	gyʧlɑriin	gyʧleriin
gitmAA	gitmɑi	gitmee
kesAn	kesdn	kesen
sonlH	sonlɯ	sonlu
ʃiirlAr	ʃiirlɑr	ʃiirler
bølymlArA	bølymlɑrd	bølymlere
bebeklArHn	bebeklɑrin	bebeklerin
belgesAl	belgesdl	belgesel
denizDA	denizdd	denizde
devrelArH	devrelɑri	devreleri
nesnelAr	nesnelɑr	nesneler
netiʤeDA	netiʤedi	netiʤede
okulmHzDA	okulmɯzdɑ	okulmuzdɑ
reformH	reformɯ	reformu
zorlHklAr	zorlɯklɑr	zorluklɑr
ʧizgilAr	ʧizgilɑr	ʧizgiler
birikAn	birikɑn	biriken
desteklAHʤH	destekldiʤi	destekleiʤi
ermAH	ermɑi	ermei
geʧirArAk	geʧirɑrɑk	geʧirerek
gelirlArHHn	gelirlɑriin	gelirleriin
iʃletmelArA	iʃletmelɑrd	iʃletmelere
isteAnlArA	isteɑnlɑrɑ	isteenlere
ulusHn	ulusɯn	ulusun
ølʧekDA	ølʧekdɑ	ølʧekte
yniversitelArA	yniversitelɑrd	yniversitelere
birliklAr	birliklɑr	birlikler
dyʃynHp	dyʃynip	dyʃynyp
fɑkyltelArH	fɑkyltelɑri	fɑkylteleri
gɑzetelAr	gɑzetelɑr	gɑzeteler
girmAnHz	girmdniz	girmeniz
hykymetlArHn	hykymetlɑrin	hykymetlerin
mɑkɑleDA	mɑkɑledɑ	mɑkɑlede
søzA	søzɑ	søze
tyketiʤilArHn	tyketiʤilɑrin	tyketiʤilerin
tymHHn	tymiin	tymyyn
tɑrihinDAki	tɑrihinddki	tɑrihindeki
jenilAnAn	jenilɑndn	jenilenen
formHn	formɯn	formun
vermAlArH	vermɑlɑri	vermeleri
bɑsDA	bɑsdɑ	bɑstɑ
gynmHzDAki	gynmizddki	gynmyzdeki
gynlArA	gynlɑrd	gynlere
sɑvʤɯH	sɑvʤɯi	sɑvʤɯɯ
tyketiʤilAr	tyketiʤilɑr	tyketiʤiler
zeminDA	zemindd	zeminde
kɯjmetlAr	kɯjmetlɑr	kɯjmetler
tytynlArDA	tytynlɑrdɑ	tytynlerde
dyzenlemAHn	dyzenlemdin	dyzenlemein
deɰerlendirmAlArH	deɰerlendirmɑlɑri	deɰerlendirmeleri
deɰiʃmAlAr	deɰiʃmɑlɑr	deɰiʃmeler
elmHzDAn	elmizddn	elmizden
ifɑdelAr	ifɑdelɑr	ifɑdeler
kimselArHn	kimselɑrin	kimselerin
metinlArHn	metinlɑrin	metinlerin
muɑjeneDA	muɑjenedɑ	muɑjenede
rezervlAr	rezervlɑr	rezervler
sɑnɑjiDA	sɑnɑjidɑ	sɑnɑjide
tyrDA	tyrdɑ	tyrde
ʃehirlAr	ʃehirlɑr	ʃehirler
ɑrɑjyzH	ɑrɑjyzi	ɑrɑjyzy
byjymAA	byjymɑɑ	byjymee
bojlH	bojlɯ	bojlu
bugynlArDA	bugynlɑrdɑ	bugynlerde
dyzenA	dyzend	dyzene
deɰiʃkenlAr	deɰiʃkenlɑr	deɰiʃkenler
devirDA	devirdi	devirde
formHHn	formɯɯn	formuun
gynejDA	gynejdɑ	gynejde
hizmetDA	hizmetdd	hizmette
ilArDA	ilɑrdɑ	ilerde
iliʃkilArDA	iliʃkilɑrdi	iliʃkilerde
kɑblolH	kɑblolɯ	kɑblolu
konferɑnsDA	konferɑnsdɑ	konferɑnstɑ
pɑrtiA	pɑrtiɑ	pɑrtie
øɰrenAn	øɰrendn	øɰrenen
øngørAn	øngørdn	øngøren
yʧnʤHH	yʧnʤii	yʧnʤyy
dyzejDAki	dyzejddki	dyzejdeki
geʧmiʃDAn	geʧmiʃdɑn	geʧmiʃten
geʤeDA	geʤedi	geʤede
kulɑkDA	kulɑkdɑ	kulɑktɑ
sistemlArA	sistemlɑrɑ	sistemlere
sporH	sporɯ	sporu
tekniklArHHn	tekniklɑriin	teknikleriin
jyzejlArH	jyzejlɑri	jyzejleri
ʧoʤukDA	ʧoʤukdɑ	ʧoʤuktɑ
ørtylH	ørtyli	ørtyly
ɑdresnHzA	ɑdresnizɑ	ɑdresnize
ɑskerlArHn	ɑskerlɑrin	ɑskerlerin
deɰerlendirArAk	deɰerlendirɑrɑk	deɰerlendirerek
gøtyrmA	gøtyrmd	gøtyrme
kɑjdetmA	kɑjdetmɑ	kɑjdetme
memurlArHn	memurlɑrin	memurlɑrɯn
meslekDA	meslekdɑ	meslekte
sɑnɑjilAʃmA	sɑnɑjilɑʃmɑ	sɑnɑjileʃme
tɑmɑmlɑnDHkDAn	tɑmɑmlɑndɯkdɑn	tɑmɑmlɑndɯktɑn
jøresAl	jøresdl	jøresel
jyklAmA	jyklɑmɑ	jykleme
bilmAH	bilmdi	bilmei
gynlArHn	gynlɑrin	gynlerin
kongreDA	kongredɑ	kongrede
meʤlisA	meʤlisd	meʤlise
tuzH	tuzɯ	tuzu
jyzlH	jyzli	jyzly
birDA	birdɑ	birde
dereʤelArH	dereʤelɑri	dereʤeleri
gelHnʤAA	gelinʤdɑ	gelinʤee
izlAHʤH	izlɑiʤi	izleiʤi
merkeznDAki	merkeznddki	merkezndeki
jurtiʧinDA	jurtiʧindd	jurtiʧinde
ølʧylArH	ølʧylɑri	ølʧyleri
ʃubelAr	ʃubelɑr	ʃubeler
yʧAr	yʧɑr	yʧer
ɑltDAki	ɑltdɑki	ɑlttɑki
dozH	dozɯ	dozu
eklArH	eklɑri	ekleri
etmAmHz	etmɑmiz	etmemiz
gøzlemlAr	gøzlemlɑr	gøzlemler
geʧmAmA	geʧmɑmi	geʧmeme
gezilAr	gezilɑr	geziler
iʃʧilArA	iʃʧilɑrɑ	iʃʧilere
inʤelemAlArDA	inʤelemɑlɑrdi	inʤelemelerde
inʤeleAn	inʤeledn	inʤeleen
istemA	istemd	isteme
kɑjnɑkDAn	kɑjnɑkdɑn	kɑjnɑktɑn
mɑddelArA	mɑddelɑrɑ	mɑddelere
milletlArɑrɑsɯ	milletlɑrɑrɑsɯ	milletlerɑrɑsɯ
misjonH	misjonɯ	misjonu
pɑketlArH	pɑketlɑri	pɑketleri
tyrlAr	tyrlɑr	tyrler
ørgytlArHn	ørgytlɑrin	ørgytlerin
ʃiddetA	ʃiddetd	ʃiddete
ɑletlAr	ɑletlɑr	ɑletler
ɑskerA	ɑskerɑ	ɑskere
bølgemHzDA	bølgemizdi	bølgemizde
bordroH	bordroɯ	bordrou
ejlemlAr	ejlemlɑr	ejlemler
gereʧlArH	gereʧlɑri	gereʧleri
islAr	islɑr	isler
memleketDA	memleketdd	memlekette
polisA	polisd	polise
sɯnɑvHn	sɯnɑvin	sɯnɑvɯn
jerjyzynDA	jerjyzyndd	jerjyzynde
yniversiteDAn	yniversiteddn	yniversiteden
beʤerilAr	beʤerilɑr	beʤeriler
dørtDA	dørtdɑ	dørtte
dɑhilHA	dɑhiliɑ	dɑhilie
ekiplAr	ekiplɑr	ekipler
geliʃmAlArDAn	geliʃmɑlɑrdɑn	geliʃmelerden
kɑmpysH	kɑmpysi	kɑmpysy
kentlAʃmA	kentldʃmɑ	kentleʃme
liderlArH	liderlɑri	liderleri
merkezlArDA	merkezlɑrdɑ	merkezlerde
sevmA	sevmd	sevme
tɑbiplAr	tɑbiplɑr	tɑbipler
tɑlepDA	tɑlepdɑ	tɑlepte
tiʤɑretDA	tiʤɑretdɑ	tiʤɑrette
jorumH	jorumɯ	jorumu
ʧøzmAA	ʧøzmɑɑ	ʧøzmee
yrynlArmHz	yrynlɑrmiz	yrynlermiz
byjymAH	byjymdi	byjymei
gyʧlArHn	gyʧlɑrin	gyʧlerin
iʃlArDAn	iʃlɑrdɑn	iʃlerden
køsA	køsd	køse
køjlylAr	køjlylɑr	køjlyler
kyltyrlArH	kyltyrlɑri	kyltyrleri
otelA	otelɑ	otele
sunHʃ	sunɯʃ	sunuʃ
usullAr	usullɑr	usuller
øɰrenmAHn	øɰrenmdin	øɰrenmein
doɰHʃDAn	doɰɯʃdɑn	doɰuʃtɑn
ekleArAk	ekleɑrdk	ekleerek
fɯrsɑtDA	fɯrsɑtdɑ	fɯrsɑttɑ
girDHkDAn	girdikdɑn	girdikten
gijsilAr	gijsilɑr	gijsiler
kusurlH	kusurlɯ	kusurlu
terimlArH	terimlɑri	terimleri
jyrekDAn	jyrekddn	jyrekten
ʧizgilArH	ʧizgilɑri	ʧizgileri
bɑhʧelArH	bɑhʧelɑri	bɑhʧeleri
denejlArH	denejlɑri	denejleri
enflɑsjonH	enflɑsjonɯ	enflɑsjonu
iʃʧilArH	iʃʧilɑri	iʃʧileri
kɑtegoriDA	kɑtegoridɑ	kɑtegoride
kimilArH	kimilɑri	kimileri
kongreA	kongreɑ	kongree
kuvvetlArHn	kuvvetlɑrin	kuvvetlerin
mɑlijetlArHHn	mɑlijetlɑriin	mɑlijetleriin
sebepDAn	sebepdɑn	sebepten
strɑteʒilAr	strɑteʒilɑr	strɑteʒiler
jyrymAA	jyrymdd	jyrymee
ʃimdilArDA	ʃimdilɑrdɑ	ʃimdilerde
yzHʤH	yziʤi	yzyʤy
bølgelArHHn	bølgelɑriin	bølgeleriin
beklentilAr	beklentilɑr	beklentiler
dyzeltmA	dyzeltmd	dyzeltme
denklemlArH	denklemlɑri	denklemleri
inʤelemAlArH	inʤelemɑlɑri	inʤelemeleri
kyltyrA	kyltyrd	kyltyre
kɑrʃɯlɑʃDHklArH	kɑrʃɯlɑʃdɯklɑrɯ	kɑrʃɯlɑʃtɯklɑrɯ
kɑrɑnlɯkDA	kɑrɑnlɯkdɑ	kɑrɑnlɯktɑ
mektuplArH	mektuplɑri	mektuplɑrɯ
normɑlA	normɑlɑ	normɑle
sɯʤɑklɯkDA	sɯʤɑklɯkdɑ	sɯʤɑklɯktɑ
tekliflArHn	tekliflɑrin	tekliflerin
jørelArDA	jørelɑrdɑ	jørelerde
øɰretimDA	øɰretimdi	øɰretimde
ɑteʃDA	ɑteʃdɑ	ɑteʃte
belgelArA	belgelɑrd	belgelere
depremlAr	depremlɑr	depremler
etmAmA	etmɑmɑ	etmeme
gelDHkDAn	geldikdɑn	geldikten
iʃɑretlAr	iʃɑretlɑr	iʃɑretler
iʃgɑlH	iʃgɑlɯ	iʃgɑli
ifɑdelArH	ifɑdelɑri	ifɑdeleri
kitlelArA	kitlelɑrɑ	kitlelere
myʃterilArmHz	myʃterilɑrmiz	myʃterilermiz
syryʤylAr	syryʤylɑr	syryʤyler
jyklAr	jyklɑr	jykler
zeminA	zemind	zemine
ʧevirAn	ʧevirɑn	ʧeviren
ʧevreDAki	ʧevreddki	ʧevredeki
ɑileDA	ɑiledɑ	ɑilede
ʤiddiA	ʤiddii	ʤiddie
derslArHHn	derslɑriin	dersleriin
eriʃmA	eriʃmɑ	eriʃme
gøryntyHn	gøryntyin	gøryntyyn
gelDHklArH	geldiklɑri	geldikleri
iʃʧiA	iʃʧii	iʃʧie
iʃletmelArDA	iʃletmelɑrdi	iʃletmelerde
illAr	illɑr	iller
køjlArH	køjlɑrɯ	køjleri
konsɑntrɑsjonH	konsɑntrɑsjonɯ	konsɑntrɑsjonu
mylteʤilAr	mylteʤilɑr	mylteʤiler
milliA	millid	millie
mobilA	mobild	mobile
nesnelArH	nesnelɑri	nesneleri
operɑtørH	operɑtøri	operɑtøry
søzHHn	søziin	søzyyn
tyrHHn	tyriin	tyryyn
ulɑʃAbilmA	ulɑʃɑbilmɑ	ulɑʃɑbilme
yjelArmHzA	yjelɑrmizd	yjelermize
birliklArHHn	birliklɑriin	birlikleriin
bulHʃ	bulɯʃ	buluʃ
butonH	butonɯ	butonu
doɰrulHk	doɰrulɯk	doɰruluk
ejlemA	ejlemi	ejleme
fɑkylteDA	fɑkyltedɑ	fɑkyltede
gøryʃA	gøryʃɑ	gøryʃe
iletiʃimDA	iletiʃimdi	iletiʃimde
iletmA	iletmd	iletme
okuHp	okuɯp	okuup
pɑnelDA	pɑneldɑ	pɑnelde
pozisjonH	pozisjonɯ	pozisjonu
syrHp	syrip	syryp
syrmAH	syrmɑi	syrmei
tezlAr	tezlɑr	tezler
jønDAki	jøndɑki	jøndeki
doktorHn	doktorɯn	doktorun
eminA	emind	emine
gøtyrAn	gøtyrdn	gøtyren
getirDHklArH	getirdiklɑri	getirdikleri
køʃeDA	køʃedɑ	køʃede
kurHp	kurɯp	kurup
mɑhkemelAr	mɑhkemelɑr	mɑhkemeler
nelArH	nelɑri	neleri
notHHn	notɯɯn	notuun
penʤerelAr	penʤerelɑr	penʤereler
risklAr	risklɑr	riskler
susHz	susɯz	susuz
tedɑvilAr	tedɑvilɑr	tedɑviler
jyryHʃH	jyryiʃi	jyryyʃy
ʧøzymlArHn	ʧøzymlɑrin	ʧøzymlerin
ʧizmA	ʧizmd	ʧizme
øɰretmenlArA	øɰretmenlɑrd	øɰretmenlere
bølgelArDAki	bølgelɑrddki	bølgelerdeki
formɑtDA	formɑtdɑ	formɑttɑ
getirmAH	getirmdi	getirmei
gitmADAn	gitmddɑn	gitmeden
hedijelAr	hedijelɑr	hedijeler
kuzejDA	kuzejdɑ	kuzejde
mensuplArHHn	mensuplɑriin	mensuplɑrɯɯn
niteliklAr	niteliklɑr	nitelikler
søjlemAA	søjlemɑɑ	søjlemee
jurtDA	jurtdɑ	jurttɑ
ølʧylArDA	ølʧylɑrdɑ	ølʧylerde
bileʃenlArH	bileʃenlɑri	bileʃenleri
etkiA	etkii	etkie
gelmADA	gelmddɑ	gelmete
iʃlemDAn	iʃlemddn	iʃlemden
iʃletmeDA	iʃletmedi	iʃletmede
kullɑnmADA	kullɑnmɑdɑ	kullɑnmɑtɑ
otelDA	oteldɑ	otelde
ølʧyH	ølʧyi	ølʧyy
bɑʃlɑDHkDAn	bɑʃlɑdɯkdɑn	bɑʃlɑdɯktɑn
bugynDAn	bugynddn	bugynden
dyʃynʤeA	dyʃynʤei	dyʃynʤee
dɑirelAr	dɑirelɑr	dɑireler
elmDA	elmdd	elmde
etkilArA	etkilɑrd	etkilere
gøryntylH	gøryntyli	gøryntyly
hyʤrelArA	hyʤrelɑrɑ	hyʤrelere
ilmHzDA	ilmizdi	ilmizde
kesimDA	kesimdɑ	kesimde
mɑlzemelArHHn	mɑlzemelɑriin	mɑlzemeleriin
nesnelArHn	nesnelɑrin	nesnelerin
orgɑnizɑsjonHn	orgɑnizɑsjonɯn	orgɑnizɑsjonun
sɯnɑvlArHn	sɯnɑvlɑrin	sɯnɑvlɑrɯn
syrArAk	syrɑrɑk	syrerek
sɑhneDA	sɑhnedɑ	sɑhnede
sektørlArA	sektørlɑrɑ	sektørlere
sijɑsetA	sijɑsetɑ	sijɑsete
eklAnArAk	eklɑnɑrɑk	eklenerek
kɑrɑkterlArH	kɑrɑkterlɑri	kɑrɑkterleri
nelArA	nelɑrɑ	nelere
proʒeksijonH	proʒeksijonɯ	proʒeksijonu
vizjonH	vizjonɯ	vizjonu
øɰrenmAH	øɰrenmdi	øɰrenmei
byjymAHn	byjymdin	byjymein
belirleArAk	belirleɑrɑk	belirleerek
bitHnʤA	bitinʤd	bitinʤe
gøryʃmelArA	gøryʃmelɑrd	gøryʃmelere
grɑfiklAr	grɑfiklɑr	grɑfikler
istemAAn	istemɑdn	istemeen
kytyphɑneA	kytyphɑneɑ	kytyphɑnee
kɑpɑsiteA	kɑpɑsiteɑ	kɑpɑsitee
kollHk	kollɯk	kolluk
mydyrlykʧA	mydyrlykʧi	mydyrlykʧe
merkezlAr	merkezlɑr	merkezler
okulmHzHn	okulmɯzɯn	okulmuzun
timA	timɑ	time
zijɑretʧHlAr	zijɑretʧilɑr	zijɑretʧiler
ødemAA	ødemɑi	ødemee
ynitelAr	ynitelɑr	yniteler
yretiʤilArHn	yretiʤilɑrin	yretiʤilerin
birejlArH	birejlɑri	birejleri
dɑirelArH	dɑirelɑri	dɑireleri
etmAlH	etmɑli	etmeli
evlArHHn	evlɑriin	evleriin
giriʃimDA	giriʃimdi	giriʃimde
iʃlemlArDAn	iʃlemlɑrdɑn	iʃlemlerden
kɑrɑkterlAr	kɑrɑkterlɑr	kɑrɑkterler
kesmA	kesmd	kesme
seʧimlArHn	seʧimlɑrin	seʧimlerin
øɰretmA	øɰretmd	øɰretme
ønerilArnHzH	ønerilɑrnizi	ønerilernizi
øzellikDA	øzellikdi	øzellikte
øzgyrlHklAr	øzgyrliklɑr	øzgyrlykler
ʃekillAr	ʃekillɑr	ʃekiller
ystlenAn	ystlendn	ystlenen
enerʒiA	enerʒii	enerʒie
engellArH	engellɑri	engelleri
gynejA	gyneji	gyneje
girAbilmA	girdbilmi	girebilme
hɑrflArH	hɑrflɑrɯ	hɑrfleri
izinlArH	izinlɑri	izinleri
kɑmuHn	kɑmuɯn	kɑmuun
kurDHklArH	kurdɯklɑrɯ	kurduklɑrɯ
mɑkinelAr	mɑkinelɑr	mɑkineler
renklArHn	renklɑrin	renklerin
syslH	sysli	sysly
sebeplArDAn	sebeplɑrdɑn	sebeplerden
ʃirketDA	ʃirketdd	ʃirkette
bɑkterilAr	bɑkterilɑr	bɑkteriler
deɰerA	deɰeri	deɰere
demokrɑtiklAʃmA	demokrɑtikldʃmɑ	demokrɑtikleʃme
dilmHzA	dilmizd	dilmize
gøstermADA	gøstermddɑ	gøstermete
herkesDAn	herkesddn	herkesten
mevsimsAl	mevsimsdl	mevsimsel
seminerA	seminerd	seminere
jijeʤeklAr	jijeʤeklɑr	jijeʤekler
øteA	øtei	øtee
burslH	burslɯ	burslu
doktornHz	doktornɯz	doktornuz
emmA	emmd	emme
iʧAn	iʧɑn	iʧen
izlemAA	izlemdi	izlemee
liflAr	liflɑr	lifler
mɑhkemelArH	mɑhkemelɑri	mɑhkemeleri
miljonH	miljonɯ	miljonu
olAbilAn	olɑbilɑn	olɑbilen
resimlArHn	resimlɑrin	resimlerin
syrHʃ	syriʃ	syryʃ
sytHn	sytin	sytyn
ʧøzymlAnmAH	ʧøzymlɑnmdi	ʧøzymlenmei
ʧøzynyrlykDA	ʧøzynyrlykdi	ʧøzynyrlykte
ølʧylAr	ølʧylɑr	ølʧyler
belgeA	belgei	belgee
bugynH	bugyni	bugyny
dyzenlemAlArA	dyzenlemɑlɑrd	dyzenlemelere
direktørH	direktøri	direktøry
evlArA	evlɑri	evlere
gøryʃHn	gøryʃin	gøryʃyn
iʃHHn	iʃɯin	iʃiin
konforlH	konforlɯ	konforlu
konserlAr	konserlɑr	konserler
mɑddeDAki	mɑddeddki	mɑddedeki
otomɑsjonH	otomɑsjonɯ	otomɑsjonu
pɑrɑmetrelArHn	pɑrɑmetrelɑrin	pɑrɑmetrelerin
søzlArHn	søzlɑrin	søzlerin
tɑbloH	tɑbloɯ	tɑblou
telefonHn	telefonɯn	telefonun
toprɑkDA	toprɑkdɑ	toprɑktɑ
ʤymlelAr	ʤymlelɑr	ʤymleler
deDHklArH	dediklɑri	dedikleri
diʃlAr	diʃlɑr	diʃler
edilAmAAn	edilɑmɑɑn	edilemeen
elDAki	elddki	eldeki
elemA	elemd	eleme
gɑzetelArHn	gɑzetelɑrin	gɑzetelerin
gelAnlArHn	gelɑnlɑrin	gelenlerin
girHʃDA	giriʃdɑ	giriʃte
ilerleDHkʧA	ilerledikʧɑ	ilerledikʧe
kytyphɑnelAr	kytyphɑnelɑr	kytyphɑneler
motorHn	motorɯn	motorun
otellAr	otellɑr	oteller
ruhHn	ruhin	ruhun
topHn	topɯn	topun
jɑpAbilAn	jɑpɑbilɑn	jɑpɑbilen
ʃikɑjetlArH	ʃikɑjetlɑri	ʃikɑjetleri
yʤretlArHHn	yʤretlɑriin	yʤretleriin
yniversitelArH	yniversitelɑri	yniversiteleri
byjyklHk	byjyklik	byjyklyk
bilmADAn	bilmddɑn	bilmeden
edinAn	edindn	edinen
etkinlHklArnA	etkinliklɑrnd	etkinliklerne
gelmA	gelmi	gelme
iʧeriklArH	iʧeriklɑri	iʧerikleri
mɑterjɑllAr	mɑterjɑllɑr	mɑterjɑller
problemlArA	problemlɑrɑ	problemlere
resimDA	resimdɑ	resimde
tørenA	tørend	tørene
tonlHk	tonlɯk	tonluk
jyzejDA	jyzejdɑ	jyzejde
ʧizimlAr	ʧizimlɑr	ʧizimler
øzgyrlHklArH	øzgyrliklɑri	øzgyrlykleri
ɑrtmADA	ɑrtmɑdɑ	ɑrtmɑtɑ
bɑhsetmA	bɑhsetmɑ	bɑhsetme
bebeklArDA	bebeklɑrdɑ	bebeklerde
boruH	boruɯ	boruu
dilDAn	dilddn	dilden
durHp	durɯp	durup
grupDAki	grupdɑki	gruptɑki
iʧeriDA	iʧeridi	iʧeride
kytyphɑneDA	kytyphɑnedɑ	kytyphɑnede
mɑterjɑlH	mɑterjɑlɯ	mɑterjɑli
seʧimDA	seʧimdd	seʧimde
temellAr	temellɑr	temeller
terminɑlH	terminɑlɯ	terminɑli
topʧH	topʧɯ	topʧu
ʧeʃitlArHHn	ʧeʃitlɑriin	ʧeʃitleriin
ølymHn	ølymin	ølymyn
ørneklArHn	ørneklɑrin	ørneklerin
øzyrlylAr	øzyrlylɑr	øzyrlyler
øzetlArH	øzetlɑri	øzetleri
yniversitemHzDA	yniversitemizdi	yniversitemizde
denetlAnmAH	denetlɑnmdi	denetlenmei
emirlArH	emirlɑri	emirleri
eserDA	eserdd	eserde
gøryʃmeDA	gøryʃmedi	gøryʃmede
gyryltylH	gyryltyli	gyryltyly
giderlArHHn	giderlɑriin	giderleriin
hɑrflAr	hɑrflɑr	hɑrfler
istemAH	istemdi	istemei
lyzumlH	lyzumli	lyzumlu
metA	metd	mete
modellArHn	modellɑrin	modellerin
operɑsjonHn	operɑsjonɯn	operɑsjonun
pɑrtilArA	pɑrtilɑrɑ	pɑrtilere
sorunlH	sorunlɯ	sorunlu
ønmHzA	ønmizɑ	ønmyze
dyzenleDHklArH	dyzenlediklɑri	dyzenledikleri
filmDA	filmdɑ	filmde
gøsterilAr	gøsterilɑr	gøsteriler
hɑstɑnelArH	hɑstɑnelɑri	hɑstɑneleri
iliʃkiA	iliʃkii	iliʃkie
køjlArA	køjlɑrɑ	køjlere
kentlAr	kentlɑr	kentler
kuzejA	kuzejɑ	kuzeje
mɑddeDAn	mɑddedɑn	mɑddeden
modH	modɯ	modu
problemlArHHn	problemlɑriin	problemleriin
sɑɰlɑmADA	sɑɰlɑmɑdɑ	sɑɰlɑmɑtɑ
tyjlH	tyjli	tyjly
teorilArH	teorilɑri	teorileri
terimlAr	terimlɑr	terimler
tutulumH	tutulumɯ	tutulumu
zorlHklArH	zorlɯklɑrɯ	zorluklɑrɯ
bølymlArHHn	bølymlɑriin	bølymleriin
ʤepheDA	ʤephedɑ	ʤephede
delegelAr	delegelɑr	delegeler
dergilArHn	dergilɑrin	dergilerin
etkinliklArDA	etkinliklɑrdɑ	etkinliklerde
gølHn	gølin	gølyn
hɑberDA	hɑberdɑ	hɑberde
meselelArH	meselelɑri	meseleleri
misɑlH	misɑlɯ	misɑli
operɑtørlAr	operɑtørlɑr	operɑtørler
pɑrlɑmentoH	pɑrlɑmentoi	pɑrlɑmentou
verDHkDAn	verdikdɑn	verdikten
vermADAn	vermdddn	vermeten
vermAmA	vermɑmɑ	vermeme
vermAHn	vermdin	vermein
jøntemDA	jøntemdd	jøntemde
beledijelArA	beledijelɑrd	beledijelere
bezlArH	bezlɑri	bezleri
demokrɑsiA	demokrɑsiɑ	demokrɑsie
denejimlArH	denejimlɑri	denejimleri
fɑktørlArDAn	fɑktørlɑrdɑn	fɑktørlerden
gøryntylArHn	gøryntylɑrin	gøryntylerin
gørmAH	gørmɑi	gørmei
gøzlArHHn	gøzlɑriin	gøzleriin
gezAn	gezdn	gezen
hekimlArA	hekimlɑrɑ	hekimlere
køprylH	køpryli	køpryly
pɑrtilArH	pɑrtilɑri	pɑrtileri
søjleDHklArH	søjlediklɑri	søjledikleri
zirveA	zirvei	zirvee
ønleAʤAk	ønleɑʤdk	ønleeʤek
yʤretlArHn	yʤretlɑrin	yʤretlerin
yjeA	yjei	yjee
biʧimlArDA	biʧimlɑrdɑ	biʧimlerde
bilimA	bilimd	bilime
dɑiresAl	dɑiresdl	dɑiresel
engellAnmAH	engellɑnmɑi	engellenmei
gørynymlH	gørynymli	gørynymly
gørAbilmA	gøribilmi	gørebilme
gørevlHlArHn	gørevlilɑrin	gørevlilerin
gemilAr	gemilɑr	gemiler
køjDAn	køjdɑn	køjden
kyrlAʃmA	kyrldʃmɑ	kyrleʃme
søzʤyklArH	søzʤyklɑri	søzʤykleri
sporHn	sporɯn	sporun
tytynlArH	tytynlɑri	tytynleri
tɑrihDAki	tɑrihddki	tɑrihteki
tiʤɑretA	tiʤɑretɑ	tiʤɑrete
jykymlHlHk	jykymlilik	jykymlylyk
jyklAnmAH	jyklɑnmɑi	jyklenmei
jetkilHlArHHn	jetkililɑriin	jetkilileriin
ɑmirlArH	ɑmirlɑri	ɑmirleri
bytynlAʃmA	bytynldʃmɑ	bytynleʃme
byjyklAr	byjyklɑr	byjykler
distribytørH	distribytøri	distribytøry
ekonomiDAki	ekonomiddki	ekonomideki
eleʃtirilAr	eleʃtirilɑr	eleʃtiriler
elnHzDAki	elnizddki	elnizdeki
enstityHn	enstityin	enstityyn
etkilArHn	etkilɑrin	etkilerin
gøstergelAr	gøstergelɑr	gøstergeler
ilgilHlArHn	ilgililɑrin	ilgililerin
køklArH	køklɑri	køkleri
kɑliteA	kɑliteɑ	kɑlitee
kesimA	kesimd	kesime
kuruluʃDA	kuruluʃdɑ	kuruluʃtɑ
mɑdenlAr	mɑdenlɑr	mɑdenler
muɑjenelArH	muɑjenelɑri	muɑjeneleri
pɑketlAr	pɑketlɑr	pɑketler
petrolHn	petrolɯn	petrolyn
servislArHn	servislɑrin	servislerin
unH	unɯ	unu
ʧøzymHn	ʧøzymin	ʧøzymyn
ystynlHk	ystynlik	ystynlyk
ɑnnelArHn	ɑnnelɑrin	ɑnnelerin
birimA	birimd	birime
dujuruH	dujuruɯ	dujuruu
gønylDAn	gønylddn	gønylden
gønyllHlArH	gønyllilɑri	gønyllyleri
geʧmAAn	geʧmɑdn	geʧmeen
hɑberlArA	hɑberlɑrɑ	hɑberlere
isteArAk	isteɑrdk	isteerek
kɑpɑsiteDA	kɑpɑsitedɑ	kɑpɑsitede
liflArH	liflɑri	lifleri
meʤlisDA	meʤlisdɑ	meʤliste
prensiplAr	prensiplɑr	prensipler
uzɑkDAki	uzɑkdɑki	uzɑktɑki
jønetimDA	jønetimdi	jønetimde
jerleʃAn	jerleʃɑn	jerleʃen
yretimDAn	yretimddn	yretimden
bytʧeDAn	bytʧeddn	bytʧeden
bɑhʧelAr	bɑhʧelɑr	bɑhʧeler
dokuHn	dokuɯn	dokuun
gørynHʃ	gøryniʃ	gørynyʃ
hyʤresAl	hyʤresdl	hyʤresel
ilkelArA	ilkelɑrd	ilkelere
køjlAr	køjlɑr	køjler
kɑjbetmADAn	kɑjbetmɑdɑn	kɑjbetmeden
kumH	kumɯ	kumu
mɑddelArDA	mɑddelɑrdɑ	mɑddelerde
renklArDA	renklɑrdɑ	renklerde
syryʤyH	syryʤyi	syryʤyy
syreʧlArHn	syreʧlɑrin	syreʧlerin
senɑtoH	senɑtoɯ	senɑtou
sorumlHlArH	sorumlɯlɑrɯ	sorumlulɑrɯ
tepeDAn	tepeddn	tepeden
ystDAki	ystddki	ystteki
ɑʧɯkDA	ɑʧɯkdɑ	ɑʧɯktɑ
bølmA	bølmɑ	bølme
bilgilArnHzA	bilgilɑrnizd	bilgilernize
deɰiʃmAAn	deɰiʃmɑɑn	deɰiʃmeen
devreDA	devredi	devrede
dinlAHʤH	dinldiʤi	dinleiʤi
gørmAAn	gørmɑɑn	gørmeen
hedeflArHn	hedeflɑrin	hedeflerin
herʃejA	herʃejɑ	herʃeje
kitlesAl	kitlesdl	kitlesel
kusurH	kusurɯ	kusuru
modyllArH	modyllɑri	modylleri
syregelAn	syregeldn	syregelen
ʧekilArAk	ʧekilɑrɑk	ʧekilerek
ødemADAn	ødemdddn	ødemeden
ʃejlArA	ʃejlɑrɑ	ʃejlere
ʃirketlArDA	ʃirketlɑrdɑ	ʃirketlerde
ɑʃɑɰɯDAkilArDAn	ɑʃɑɰɯdɑkilɑrdɑn	ɑʃɑɰɯdɑkilerden
beklemADAn	beklemddɑn	beklemeden
eksiklHklAr	eksikliklɑr	eksiklikler
gøzlArm	gøzlɑrm	gøzlerm
hykymlHlArHn	hykymlilɑrin	hykymlylerin
hukukHHn	hukukiin	hukukuun
illArA	illɑrɑ	illere
inʤelemADA	inʤelemddi	inʤelemede
istɑtistiklAr	istɑtistiklɑr	istɑtistikler
mylteʤilArHn	mylteʤilɑrin	mylteʤilerin
jɑrH	jɑrɯ	jɑri
ølymlAr	ølymlɑr	ølymler
beklemAA	beklemɑi	beklemee
devletlArHHn	devletlɑriin	devletleriin
køʃeA	køʃei	køʃee
kesimlArH	kesimlɑri	kesimleri
mejvelAr	mejvelɑr	mejveler
nyfuslH	nyfusli	nyfuslu
syrelArHHn	syrelɑriin	syreleriin
seneA	senei	senee
typH	typi	typy
tyzykDA	tyzykdɑ	tyzykte
tesislArA	tesislɑrɑ	tesislere
jɑʃDAki	jɑʃdɑki	jɑʃtɑki
jerlArDAki	jerlɑrddki	jerlerdeki
ødylA	ødyli	ødyle
yretiʤilArHHn	yretiʤilɑriin	yretiʤileriin
ɑilelArHHn	ɑilelɑriin	ɑileleriin
ɑrɑziA	ɑrɑziɑ	ɑrɑzie
bølgelArDAn	bølgelɑrdɑn	bølgelerden
bytʧeA	bytʧei	bytʧee
bɑʃvuruH	bɑʃvurui	bɑʃvuruu
dɑhilDA	dɑhildɑ	dɑhilde
devreDAn	devreddn	devreden
fɑkyltelAr	fɑkyltelɑr	fɑkylteler
gezilArH	gezilɑri	gezileri
girHʃlArH	giriʃlɑri	giriʃleri
hizmetlArmHz	hizmetlɑrmiz	hizmetlermiz
ihlɑlH	ihlɑlɯ	ihlɑli
kentlArHn	kentlɑrin	kentlerin
niteliklArA	niteliklɑrɑ	niteliklere
seminerDA	seminerdd	seminerde
jetkilAr	jetkilɑr	jetkiler
ʧevrelAr	ʧevrelɑr	ʧevreler
ødemAlArnHzH	ødemɑlɑrnizi	ødemelernizi
ɑlternɑtiflAr	ɑlternɑtiflɑr	ɑlternɑtifler
bɑʃvurmAH	bɑʃvurmɑi	bɑʃvurmɑɯ
bildirimDA	bildirimdi	bildirimde
demirʤilAr	demirʤilɑr	demirʤiler
engellAHʤH	engelldiʤi	engelleiʤi
etydH	etydi	etydy
gyʧlyklAr	gyʧlyklɑr	gyʧlykler
ilerlemAH	ilerlemdi	ilerlemei
iletilArH	iletilɑri	iletileri
izlAnAʤAk	izlɑnɑʤɑk	izleneʤek
køtylHk	køtylik	køtylyk
kɑbloH	kɑbloɯ	kɑblou
kredilArHn	kredilɑrin	kredilerin
krizlAr	krizlɑr	krizler
kumlH	kumlɯ	kumlu
listeDAki	listeddki	listedeki
sɯnɯfDAn	sɯnɯfdɑn	sɯnɯftɑn
seferlArH	seferlɑri	seferleri
siʤilA	siʤild	siʤile
toprɑkDAn	toprɑkdɑn	toprɑktɑn
jorHʤH	jorɯʤɯ	joruʤu
ʧekilmA	ʧekilmi	ʧekilme
dyzejlArHHn	dyzejlɑriin	dyzejleriin
deɰinmA	deɰinmd	deɰinme
denetʧilAr	denetʧilɑr	denetʧiler
denetimA	denetimd	denetime
doɰHʃH	doɰɯʃɯ	doɰuʃu
dokuHHn	dokuɯɯn	dokuuun
ertelemA	ertelemd	erteleme
evDAki	evddki	evdeki
geʧmAA	geʧmɑi	geʧmee
hykymlArHn	hykymlɑrin	hykymlerin
idɑrelAr	idɑrelɑr	idɑreler
ilʧeA	ilʧei	ilʧee
limitlArH	limitlɑri	limitleri
metreA	metrei	metree
modyllAr	modyllɑr	modyller
sinjɑlH	sinjɑlɯ	sinjɑli
sistemDAki	sistemddki	sistemdeki
sitemHzA	sitemizd	sitemize
tenA	tend	tene
usulA	usulɑ	usule
vɑzijetDA	vɑzijetdɑ	vɑzijette
vermAnHz	vermɑniz	vermeniz
jøntemA	jøntemd	jønteme
zijɑretʧHlArHn	zijɑretʧilɑrin	zijɑretʧilerin
ʧizimlArH	ʧizimlɑri	ʧizimleri
ønDAn	øndɑn	ønden
øzellHklArDAn	øzelliklɑrdɑn	øzelliklerden
ʤoʃkulH	ʤoʃkulɯ	ʤoʃkulu
denetimlAr	denetimlɑr	denetimler
eksiklHklArHn	eksikliklɑrin	eksikliklerin
engellHlAr	engellilɑr	engelliler
erkeklArA	erkeklɑrd	erkeklere
geʧmiʃDAki	geʧmiʃddki	geʧmiʃteki
getirmAAn	getirmɑdn	getirmeen
hɑzineA	hɑzineɑ	hɑzinee
huzurH	huzurɯ	huzuru
kesilArAk	kesilɑrɑk	kesilerek
krediDAn	krediddn	krediden
memurHn	memurin	memurun
rollAr	rollɑr	roller
søzʤyH	søzʤyi	søzʤyy
syryʤyHn	syryʤyin	syryʤyyn
tyrHn	tyrin	tyryn
tɑtilA	tɑtild	tɑtile
vermAAʤAk	vermɑɑʤɑk	vermeeʤek
jykseklHkDA	jykseklikdi	jykseklikte
ølymlArHn	ølymlɑrin	ølymlerin
ɑilelArA	ɑilelɑrɑ	ɑilelere
dyʃynʤelArHn	dyʃynʤelɑrin	dyʃynʤelerin
dyrystlHk	dyrystlik	dyrystlyk
denetlAmA	denetlɑmɑ	denetleme
etkinlHklArHHn	etkinliklɑriin	etkinlikleriin
gyneʃDAn	gyneʃdɑn	gyneʃten
iʃverenA	iʃverend	iʃverene
modelDA	modeldɑ	modelde
okuHʤHA	okuɯʤiɑ	okuuʤuɑ
tɑʃDAn	tɑʃdɑn	tɑʃtɑn
tezA	tezd	teze
vergilArHn	vergilɑrin	vergilerin
jønetmA	jønetmd	jønetme
ʧorlH	ʧorlɯ	ʧorlu
øɰrenmAH	øɰrenmdi	øɰrenmei
yniversitelArDAn	yniversitelɑrddn	yniversitelerden
besleAn	besledn	besleen
deɰerlendirmAH	deɰerlendirmdi	deɰerlendirmei
etmAnHzH	etmɑnizi	etmenizi
gøryʃmeA	gøryʃmei	gøryʃmee
girmAAn	girmɑdn	girmeen
iʃkenʤeA	iʃkenʤei	iʃkenʤee
kɑrɑkteristiklArH	kɑrɑkteristiklɑri	kɑrɑkteristikleri
kulyplArH	kulyplɑri	kulypleri
noterDAn	noterdɑn	noterden
tytynH	tytyni	tytyny
jykHHn	jykiin	jykyyn
jyzlArH	jyzlɑri	jyzleri
ʧɯkDHkDAn	ʧɯkdɯkdɑn	ʧɯktɯktɑn
ødevlAr	ødevlɑr	ødevler
ønmHzDA	ønmizdɑ	ønmyzde
ʃubeA	ʃubeɑ	ʃubee
yʤretA	yʤretd	yʤrete
ɑrzuH	ɑrzuɯ	ɑrzuu
birejlArA	birejlɑrɑ	birejlere
dyɰmeA	dyɰmei	dyɰmee
denemelAr	denemelɑr	denemeler
devletDA	devletdd	devlette
ekDA	ekdɑ	ekte
ellArHn	ellɑrin	ellerin
fotoɰrɑfDA	fotoɰrɑfdɑ	fotoɰrɑftɑ
gørevlArHn	gørevlɑrin	gørevlerin
gørmADAn	gørmɑdɑn	gørmeden
gøzlArHn	gøzlɑrin	gøzlerin
gynlArDAn	gynlɑrddn	gynlerden
gyzellHklAr	gyzelliklɑr	gyzellikler
gereklArH	gereklɑri	gerekleri
girHnʤA	girinʤd	girinʤe
idɑrelArH	idɑrelɑri	idɑreleri
isteklAr	isteklɑr	istekler
kyresAllAʃmAHn	kyresɑlldʃmɑɯn	kyreselleʃmein
kɑdrolH	kɑdrolɯ	kɑdrolu
kontrollAr	kontrollɑr	kontroller
myddetʧA	myddetʧɑ	myddetʧe
minerɑllArH	minerɑllɑrɯ	minerɑlleri
modelA	modeld	modele
modemlAr	modemlɑr	modemler
operɑtørlArH	operɑtørlɑri	operɑtørleri
ɑnlAAbilmA	ɑnlɑɑbilmɑ	ɑnlɑɑbilme
bølymmHz	bølymmiz	bølymmyz
byjytmA	byjytmd	byjytme
belirlemADA	belirlemddi	belirlemede
dyzejlArDA	dyzejlɑrdɑ	dyzejlerde
devletlArA	devletlɑrd	devletlere
doɰruH	doɰruɯ	doɰruu
dojurHʤH	dojurɯʤi	dojuruʤu
gørynHʃH	gøryniʃɯ	gørynyʃy
gyneʃA	gyneʃɑ	gyneʃe
gidermA	gidermd	giderme
gitmAH	gitmdi	gitmei
iʃlemAA	iʃlemɑi	iʃlemee
iletiʃimA	iletiʃimi	iletiʃime
kimlArn	kimlɑrn	kimlern
merkezmHzDA	merkezmizdi	merkezmizde
mesɑfelAr	mesɑfelɑr	mesɑfeler
minerɑllAr	minerɑllɑr	minerɑller
sergiDA	sergidɑ	sergide
sezAn	sezdn	sezen
vyʤutDAki	vyʤutddki	vyʤuttɑki
jyrymA	jyrymd	jyryme
jyznʤH	jyznʤi	jyznʤy
jyzejlArHn	jyzejlɑrin	jyzejlerin
øɰretmA	øɰretmd	øɰretme
ørneklArHHn	ørneklɑriin	ørnekleriin
ʃehirlArHn	ʃehirlɑrin	ʃehirlerin
ʃejlArDAn	ʃejlɑrdɑn	ʃejlerden
ɑileDAn	ɑileddn	ɑileden
ɑnketA	ɑnketɑ	ɑnkete
bɑhʧeDA	bɑhʧedɑ	bɑhʧede
døkymHHn	døkymiin	døkymyyn
demA	demɑ	deme
doluH	doluɯ	doluu
eriʃkinlArDA	eriʃkinlɑrdi	eriʃkinlerde
evnHzDA	evnizdi	evnizde
gelirlArHn	gelirlɑrin	gelirlerin
hɑllArH	hɑllɑrɯ	hɑlleri
huzursHzlHk	huzursɯzlɯk	huzursuzluk
iʧimDA	iʧimdi	iʧimde
iʃletmelArHHn	iʃletmelɑriin	iʃletmeleriin
ihrɑʤɑtDA	ihrɑʤɑtdɑ	ihrɑʤɑttɑ
iliʃkiDA	iliʃkidi	iliʃkide
inʤelAnAn	inʤelɑndn	inʤelenen
onnʤH	onnʤɯ	onnʤu
syryʤylArH	syryʤylɑri	syryʤyleri
serilArH	serilɑri	serileri
tyrlArHn	tyrlɑrin	tyrlerin
tɑhminlArH	tɑhminlɑri	tɑhminleri
tebliɰlAr	tebliɰlɑr	tebliɰler
tedɑviDAn	tedɑvidɑn	tedɑviden
testlArHn	testlɑrin	testlerin
turizmA	turizmd	turizme
jyzejlArDA	jyzejlɑrdɑ	jyzejlerde
jijeʤeklArH	jijeʤeklɑri	jijeʤekleri
zijɑretDA	zijɑretdɑ	zijɑrette
ønʤyH	ønʤyi	ønʤyy
ʃɑmpijonH	ʃɑmpijonɯ	ʃɑmpijonu
byjytmA	byjytmd	byjytme
benimseAn	benimsedn	benimseen
birimlArDA	birimlɑrdɑ	birimlerde
dergiA	dergii	dergie
fɑizlArH	fɑizlɑri	fɑizleri
gelenA	gelend	gelene
hɑberA	hɑberɑ	hɑbere
iʧermAAn	iʧermɑdn	iʧermeen
køjlArHn	køjlɑrɯn	køjlerin
kimselArA	kimselɑrd	kimselere
olgunlHk	olgunlɯk	olgunluk
rezervlArHHn	rezervlɑriin	rezervleriin
syrmADA	syrmddɑ	syrmete
serilAr	serilɑr	seriler
sijɑsetDA	sijɑsetdɑ	sijɑsette
temelA	temeld	temele
toplummHzHn	toplummɯzɯn	toplummuzun
jøreA	jørei	jøree
jyryArAk	jyryɑrɑk	jyryerek
ʧɯkmADA	ʧɯkmɑdɑ	ʧɯkmɑtɑ
ʧevreDAn	ʧevreddn	ʧevreden
øɰelAr	øɰelɑr	øɰeler
øzDAn	øzdɑn	øzden
bɑʃvurulArHn	bɑʃvurulɑrin	bɑʃvurulɑrɯn
bejlAr	bejlɑr	bejler
binDAn	binddn	binden
denizlAr	denizlɑr	denizler
gøryʃlArHn	gøryʃlɑrin	gøryʃlerin
gøzlemlArH	gøzlemlɑri	gøzlemleri
grɑfiklArH	grɑfiklɑri	grɑfikleri
mydyrmHz	mydyrmiz	mydyrmyz
memurlArHHn	memurlɑriin	memurlɑrɯɯn
modellArDA	modellɑrdɑ	modellerde
modellArHHn	modellɑriin	modelleriin
nelArn	nelɑrn	nelern
sevijeDAki	sevijeddki	sevijedeki
ʧevirmA	ʧevirmi	ʧevirme
bøʤeklAr	bøʤeklɑr	bøʤekler
dønDHkDAn	døndikdɑn	døndykten
dønemlArA	dønemlɑrd	dønemlere
døvHʃ	døviʃ	døvyʃ
derneklArHn	derneklɑrin	derneklerin
dillArDA	dillɑrdɑ	dillerde
elnHzA	elnizd	elnize
enstitylArH	enstitylɑri	enstityleri
formɑsjonH	formɑsjonɯ	formɑsjonu
gøzlH	gøzli	gøzly
gelmAAn	gelmɑdn	gelmeen
hykymetDAn	hykymetddn	hykymetten
ilgilHlAr	ilgililɑr	ilgililer
kyrsyA	kyrsyd	kyrsye
merkezlArHn	merkezlɑrin	merkezlerin
meslekDAn	meslekddn	meslekten
sɯnɑvHHn	sɯnɑviin	sɯnɑvɯɯn
søjlemA	søjlemd	søjleme
sɑnɑjinDA	sɑnɑjindɑ	sɑnɑjinde
tiplArHHn	tiplɑriin	tipleriin
jetiʃkinlAr	jetiʃkinlɑr	jetiʃkinler
ʧekilmA	ʧekilmi	ʧekilme
yjelHklArH	yjeliklɑri	yjelikleri
ɑlmADAn	ɑlmɑdɑn	ɑlmɑtɑn
ɑlternɑtiflArH	ɑlternɑtiflɑri	ɑlternɑtifleri
bølymlArDAn	bølymlɑrdɑn	bølymlerden
bildirArAk	bildirɑrɑk	bildirerek
gørAlHm	gørɑlim	gørelim
gɑzeteʤilArA	gɑzeteʤilɑrd	gɑzeteʤilere
gɑzeteA	gɑzetei	gɑzetee
gemilArH	gemilɑri	gemileri
girmAH	girmdi	girmei
gijsilArH	gijsilɑri	gijsileri
hɑkimlAr	hɑkimlɑr	hɑkimler
illArH	illɑri	illeri
mezunlArHHn	mezunlɑriin	mezunlɑrɯɯn
oturumH	oturumɯ	oturumu
seferDA	seferdd	seferde
vɑlilHkʧA	vɑlilikʧɑ	vɑlilikʧe
jønelAn	jøneldn	jønelen
jyklAnAn	jyklɑnɑn	jyklenen
jenilHklArA	jeniliklɑrɑ	jeniliklere
ødemAlArHn	ødemɑlɑrin	ødemelerin
øteDAn	øteddn	øteden
ʃenliklArH	ʃenliklɑri	ʃenlikleri
yzermHzA	yzermizi	yzermize
ɑntibijotiklAr	ɑntibijotiklɑr	ɑntibijotikler
byjyDHkʧA	byjydikʧɑ	byjydykʧe
bedellArHHn	bedellɑriin	bedelleriin
dønyʃAn	dønyʃɑn	dønyʃen
depremlArHn	depremlɑrin	depremlerin
devletʧA	devletʧɑ	devletʧe
gørmADA	gørmɑdɑ	gørmete
izinlAr	izinlɑr	izinler
literɑtyrDA	literɑtyrdɑ	literɑtyrde
muɑmeleA	muɑmeleɑ	muɑmelee
normɑlDAn	normɑldɑn	normɑlden
penʤerelArH	penʤerelɑri	penʤereleri
piksAl	piksdl	piksel
syrtynmA	syrtynmd	syrtynme
sektørlArH	sektørlɑri	sektørleri
sembollAr	sembollɑr	semboller
sermɑjeA	sermɑjeɑ	sermɑjee
soruHHn	soruɯɯn	soruuun
uluslH	uluslɯ	uluslu
ulusH	ulusɯ	ulusu
virysHn	virysin	virysyn
jɑpAbilmAH	jɑpɑbilmɑi	jɑpɑbilmei
ɑdreslAr	ɑdreslɑr	ɑdresler
ɑskerlArHHn	ɑskerlɑriin	ɑskerleriin
bɑkterilArHn	bɑkterilɑrin	bɑkterilerin
bugynlArA	bugynlɑrd	bugynlere
dergilArH	dergilɑri	dergileri
gøryʃlArnHzH	gøryʃlɑrnɯzi	gøryʃlernizi
gyrsAl	gyrsdl	gyrsel
gɑzetelArH	gɑzetelɑri	gɑzeteleri
gemilArHn	gemilɑrin	gemilerin
hyʤreA	hyʤrei	hyʤree
hykymlHlAr	hykymlilɑr	hykymlyler
iʃlemlArnHzH	iʃlemlɑrnizi	iʃlemlernizi
istemAA	istemɑi	istemee
kyltyrlArHn	kyltyrlɑrin	kyltyrlerin
kombinɑsjonH	kombinɑsjonɯ	kombinɑsjonu
kullɑnmADAn	kullɑnmɑdɑn	kullɑnmɑtɑn
otellArDA	otellɑrdɑ	otellerde
sinjɑllArH	sinjɑllɑrɯ	sinjɑlleri
jykHn	jykin	jykyn
øɰretmenlArHHn	øɰretmenlɑriin	øɰretmenleriin
ørgytlAnmAH	ørgytlɑnmɑi	ørgytlenmei
yʧA	yʧɑ	yʧe
ɑrɑzilArH	ɑrɑzilɑri	ɑrɑzileri
dyʃynAlHm	dyʃyndlim	dyʃynelim
dyzenlemAH	dyzenlemdi	dyzenlemei
dikkɑtnHzH	dikkɑtnɯzɯ	dikkɑtnizi
dinleAn	dinledn	dinleen
evreDA	evredi	evrede
forumH	forumɯ	forumu
gøryntylAmA	gøryntylɑmɑ	gøryntyleme
hyʤrelArDA	hyʤrelɑrdɑ	hyʤrelerde
køkH	køki	køky
kesimlAr	kesimlɑr	kesimler
kitlelArH	kitlelɑri	kitleleri
menyDAki	menyddki	menydeki
sizlerDAn	sizlerdɑn	sizlerden
tymørlAr	tymørlɑr	tymørler
tetkiklArH	tetkiklɑri	tetkikleri
ujumlHlHk	ujumlɯlik	ujumluluk
verilArHHn	verilɑriin	verileriin
ønleAn	ønledn	ønleen
yrynDA	yryndd	yrynde
ɑfetlAr	ɑfetlɑr	ɑfetler
bølymmHzDA	bølymmizdi	bølymmyzde
bileʃiklAr	bileʃiklɑr	bileʃikler
ʤumhurijetlArH	ʤumhurijetlɑri	ʤumhurijetleri
dɯʃDAn	dɯʃdɑn	dɯʃtɑn
emzirmA	emzirmd	emzirme
etmAm	etmɑm	etmem
gøryʃlArA	gøryʃlɑrɑ	gøryʃlere
gyvenʤeA	gyvenʤei	gyvenʤee
geʤeA	geʤei	geʤee
hɑjɑtDAn	hɑjɑtdɑn	hɑjɑttɑn
hepmHzA	hepmizd	hepmize
hisselArHHn	hisselɑriin	hisseleriin
kesimlArHn	kesimlɑrin	kesimlerin
kodlH	kodlɯ	kodlu
kontrolA	kontrolɑ	kontrole
muhɑbirlArH	muhɑbirlɑri	muhɑbirleri
muhɑkemelArH	muhɑkemelɑri	muhɑkemeleri
pɑmuklH	pɑmuklɯ	pɑmuklu
sɯklHkDA	sɯklɯkdɑ	sɯklɯktɑ
sevijelArDA	sevijelɑrdɑ	sevijelerde
ʧeklAr	ʧeklɑr	ʧekler
ølʧmA	ølʧmɑ	ølʧme
ølymDAn	ølymddn	ølymden
belgelArDAn	belgelɑrdɑn	belgelerden
besinlAr	besinlɑr	besinler
denejimlAr	denejimlɑr	denejimler
dujgulArHn	dujgulɑrin	dujgulɑrɯn
filtrelAr	filtrelɑr	filtreler
gøllAr	gøllɑr	gøller
gøryʃArAk	gøryʃɑrɑk	gøryʃerek
gebelHkDA	gebelikdi	gebelikte
gerekʧelArH	gerekʧelɑri	gerekʧeleri
hɑstɑnelArHn	hɑstɑnelɑrin	hɑstɑnelerin
impɑrɑtorlHk	impɑrɑtorlɯk	impɑrɑtorluk
køjlHlArHn	køjlɯlɑrin	køjlylerin
komitelArH	komitelɑri	komiteleri
linklArH	linklɑri	linkleri
mɑhijetDA	mɑhijetdɑ	mɑhijette
mɑkɑlelArH	mɑkɑlelɑri	mɑkɑleleri
memleketA	memleketd	memlekete
reɑksijonH	reɑksijonɯ	reɑksijonu
rollArH	rollɑrɯ	rolleri
sɑnɑjiA	sɑnɑjiɑ	sɑnɑjie
sevArAk	sevɑrɑk	severek
tɑleplArHHn	tɑleplɑriin	tɑlepleriin
terʤihlArH	terʤihlɑri	terʤihleri
verAʤAklArH	verɑʤdklɑri	vereʤekleri
jɑʃɑmADA	jɑʃɑmɑdɑ	jɑʃɑmɑtɑ
ysH	ysi	ysy
bɑjilAr	bɑjilɑr	bɑjiler
birejA	birejɑ	bireje
bozHʤH	bozɯʤɯ	bozuʤu
diʃlArHn	diʃlɑrin	diʃlerin
durgunlHk	durgunlɯk	durgunluk
dujHnʤA	dujinʤɑ	dujunʤɑ
eɰilimlArH	eɰilimlɑri	eɰilimleri
ellArDA	ellɑrdɑ	ellerde
etmAmAH	etmɑmɑi	etmemei
filmlArHn	filmlɑrin	filmlerin
hukukʧH	hukukʧi	hukukʧu
kirlAnmA	kirlɑnmɑ	kirlenme
kitɑpDAn	kitɑpdɑn	kitɑptɑn
kontrolnA	kontrolnɑ	kontrolne
konumHz	konumɯz	konumuz
meʤlislArH	meʤlislɑri	meʤlisleri
pɑnoH	pɑnoɯ	pɑnou
poliʧeDA	poliʧedɑ	poliʧede
tyketiʤilArA	tyketiʤilɑrd	tyketiʤilere
toplummHzDA	toplummɯzdɑ	toplummuzdɑ
ørmA	ørmɑ	ørme
ʃiʃmA	ʃiʃmɑ	ʃiʃme
ɑbonelArHn	ɑbonelɑrin	ɑbonelerin
ɑvH	ɑvi	ɑvɯ
beledijelArH	beledijelɑri	beledijeleri
bildiriDA	bildiridi	bildiride
dyʃynmADAn	dyʃynmddɑn	dyʃynmeden
demAA	demɑɑ	demee
denemelArH	denemelɑri	denemeleri
doktornHzA	doktornɯzɑ	doktornuzɑ
etmenlAr	etmenlɑr	etmenler
gørynymA	gørynymd	gørynyme
gøstergelArH	gøstergelɑri	gøstergeleri
girDHklArH	girdiklɑri	girdikleri
iʧermAH	iʧermdi	iʧermei
kɑmpDA	kɑmpdɑ	kɑmptɑ
mɑhɑllinDA	mɑhɑllindɑ	mɑhɑllinde
mektupDA	mektupdɑ	mektuptɑ
metɑllAr	metɑllɑr	metɑller
sɑntrɑlH	sɑntrɑlɯ	sɑntrɑli
seʧAn	seʧɑn	seʧen
tɑleplArHn	tɑleplɑrin	tɑleplerin
televizjonH	televizjonɯ	televizjonu
tesisA	tesisd	tesise
velilAr	velilɑr	veliler
jøreDAki	jøreddki	jøredeki
jerjyzynA	jerjyzynd	jerjyzyne
zijɑretlArH	zijɑretlɑri	zijɑretleri
ʧøzymlArA	ʧøzymlɑrd	ʧøzymlere
ʧevirmA	ʧevirmi	ʧevirme
ɑlɯnmADA	ɑlɯnmɑdɑ	ɑlɯnmɑtɑ
belirlemAA	belirlemɑi	belirlemee
besinlArHn	besinlɑrin	besinlerin
elmHzDAki	elmizddki	elmizdeki
fɑizlAr	fɑizlɑr	fɑizler
geʧHnʤA	geʧinʤd	geʧinʤe
hykymetlArH	hykymetlɑri	hykymetleri
iʃlemA	iʃlemi	iʃleme
iʃlemAH	iʃlemdi	iʃlemei
kɑlemlArH	kɑlemlɑri	kɑlemleri
kesinlAʃAn	kesinldʃɑn	kesinleʃen
kitleA	kitlei	kitlee
pɑnelA	pɑneld	pɑnele
servislArHHn	servislɑriin	servisleriin
sesA	sesd	sese
jenilAmA	jenilɑmɑ	jenileme
zijɑretʧHlArA	zijɑretʧilɑrɑ	zijɑretʧilere
ʧøzHʤH	ʧøziʤi	ʧøzyʤy
ystDAn	ystddn	ystten
bileʃAn	bileʃɑn	bileʃen
dønmAA	dønmɑɑ	dønmee
dɑrbelArA	dɑrbelɑrɑ	dɑrbelere
demADAn	demɑdɑn	demeden
diʃlArH	diʃlɑri	diʃleri
hyzynlH	hyzynli	hyzynly
hɑberlArHn	hɑberlɑrin	hɑberlerin
iʧmHzDA	iʧmizdi	iʧmizde
iʃmHz	iʃmɯz	iʃmiz
ilerlemAlAr	ilerlemɑlɑr	ilerlemeler
iliʃkilArA	iliʃkilɑrd	iliʃkilere
ilkelArHHn	ilkelɑriin	ilkeleriin
syrelArDA	syrelɑrdɑ	syrelerde
sytʧH	sytʧi	sytʧy
senDA	sendd	sende
tɑhminlAr	tɑhminlɑr	tɑhminler
terørA	terørɑ	terøre
ʧekimlArH	ʧekimlɑri	ʧekimleri
ʧevrelArH	ʧevrelɑri	ʧevreleri
ødyllH	ødylli	ødylly
ødemelArDA	ødemelɑrdi	ødemelerde
ønerilArHn	ønerilɑrin	ønerilerin
yrynlArDAn	yrynlɑrddn	yrynlerden
ɑmelijɑtDAn	ɑmelijɑtdɑn	ɑmelijɑttɑn
bileʃiklArH	bileʃiklɑri	bileʃikleri
bulmADA	bulmɑdɑ	bulmɑtɑ
dyʃynyrlAr	dyʃynyrlɑr	dyʃynyrler
dyʃynsAl	dyʃynsdl	dyʃynsel
dengelArH	dengelɑri	dengeleri
dikkɑtlArH	dikkɑtlɑrɯ	dikkɑtleri
elmHzA	elmizd	elmize
emirlAr	emirlɑr	emirler
gyʧDA	gyʧdɑ	gyʧte
geʧirmAA	geʧirmɑi	geʧirmee
girdilArH	girdilɑri	girdileri
hɑlsHzlHk	hɑlsɯzlɯk	hɑlsizlik
hikɑjelAr	hikɑjelɑr	hikɑjeler
ilkelArHn	ilkelɑrin	ilkelerin
illArDAn	illɑrdɑn	illerden
illArHn	illɑrin	illerin
istɑtistiklArH	istɑtistiklɑri	istɑtistikleri
kuruluH	kuruluɯ	kuruluu
mɑterjɑllArH	mɑterjɑllɑrɯ	mɑterjɑlleri
merkezmHzA	merkezmizd	merkezmize
modernlAʃmA	modernldʃmɑ	modernleʃme
olArAkDA	olɑrɑkdɑ	olɑrɑktɑ
otobyslArH	otobyslɑri	otobysleri
penʤereA	penʤerei	penʤeree
personelDAn	personelddn	personelden
potɑnsijelA	potɑnsijeld	potɑnsijele
protokollAr	protokollɑr	protokoller
sektørlArHn	sektørlɑrin	sektørlerin
sergilAnAn	sergilɑndn	sergilenen
servisDA	servisdɑ	serviste
sinirlAr	sinirlɑr	sinirler
sistemnHzA	sistemnizd	sistemnize
tiplAr	tiplɑr	tipler
bulguH	bulguɯ	bulguu
dønyʃmAH	dønyʃmɑi	dønyʃmei
denizlArDA	denizlɑrdɑ	denizlerde
deriDA	deridɑ	deride
disklAr	disklɑr	diskler
dokuznʤH	dokuznʤɯ	dokuznʤu
elmA	elmd	elme
fɑkyltemHzDA	fɑkyltemizdɑ	fɑkyltemizde
gøkjyzynA	gøkjyzynd	gøkjyzyne
gyʧlyklArH	gyʧlyklɑri	gyʧlykleri
hisselArH	hisselɑri	hisseleri
iʃverenlAr	iʃverenlɑr	iʃverenler
indirimlAr	indirimlɑr	indirimler
kytyphɑneDAn	kytyphɑnedɑn	kytyphɑneden
konsoloslHk	konsoloslɯk	konsolosluk
misɑfirlAr	misɑfirlɑr	misɑfirler
nerelArDA	nerelɑrdɑ	nerelerde
rektørHn	rektørin	rektøryn
senetlAr	senetlɑr	senetler
telefonnHzHn	telefonnɯzɯn	telefonnuzun
tetkiklAr	tetkiklɑr	tetkikler
ʧoʤukDAn	ʧoʤukdɑn	ʧoʤuktɑn
ølʧytlArH	ølʧytlɑri	ølʧytleri
ønlemAA	ønlemɑi	ønlemee
ʃikɑjetlArHn	ʃikɑjetlɑrin	ʃikɑjetlerin
ɑlAbilmAH	ɑlɑbilmɑi	ɑlɑbilmei
betonHn	betonɯn	betonun
denejimA	denejimi	denejime
editørH	editøri	editøry
gynHHn	gyniin	gynyyn
geʤelAr	geʤelɑr	geʤeler
kømyrH	kømyri	kømyry
kyltyrlAr	kyltyrlɑr	kyltyrler
menfɑɑtlArH	menfɑɑtlɑrɯ	menfɑɑtleri
merkezDAki	merkezddki	merkezdeki
metinDA	metindd	metinde
olumsuzlHklAr	olumsuzlɯklɑr	olumsuzluklɑr
pɑrɑmetrelArHHn	pɑrɑmetrelɑriin	pɑrɑmetreleriin
senetlArHHn	senetlɑriin	senetleriin
telefonnHzA	telefonnɯzɑ	telefonnuzɑ
turistlArHn	turistlɑrin	turistlerin
jønetimlArH	jønetimlɑri	jønetimleri
jyklArH	jyklɑri	jykleri
jɑʃDAn	jɑʃdɑn	jɑʃtɑn
zɑmɑnkinDAn	zɑmɑnkinddn	zɑmɑnkinden
ɑrʃivlArH	ɑrʃivlɑri	ɑrʃivleri
byltenlArH	byltenlɑri	byltenleri
belgelArDA	belgelɑrdɑ	belgelerde
denemA	denemd	deneme
gyʧsHz	gyʧsiz	gyʧsyz
gylAn	gylɑn	gylen
gyndyzlArH	gyndyzlɑri	gyndyzleri
gerʧeklAʃmA	gerʧekldʃmɑ	gerʧekleʃme
komitelAr	komitelɑr	komiteler
metɑllArHn	metɑllɑrɯn	metɑllerin
oluʃmADA	oluʃmɑdɑ	oluʃmɑtɑ
olHnʤAA	olɯnʤɑɑ	olunʤɑɑ
pyryzsHz	pyryzsiz	pyryzsyz
primlArH	primlɑri	primleri
proteinlAr	proteinlɑr	proteinler
rekɑbetDA	rekɑbetdɑ	rekɑbette
søzleʃmelArHn	søzleʃmelɑrin	søzleʃmelerin
sɑɑtHn	sɑɑtɯn	sɑɑtin
sipɑriʃlAr	sipɑriʃlɑr	sipɑriʃler
tyketimA	tyketimi	tyketime
temizlAr	temizlɑr	temizler
terørH	terøri	terøry
tozlH	tozlɯ	tozlu
ødemADA	ødemddɑ	ødemede
ødemAHn	ødemdin	ødemein
ʃehirDAki	ʃehirddki	ʃehirdeki
ɑʧɯkDAn	ɑʧɯkdɑn	ɑʧɯktɑn
ɑboneA	ɑboned	ɑbonee
ɑletlArHn	ɑletlɑrin	ɑletlerin
bɑkɑnlɯkDAn	bɑkɑnlɯkdɑn	bɑkɑnlɯktɑn
belirtilArHn	belirtilɑrin	belirtilerin
bilHʃsAl	biliʃsɑl	biliʃsel
bitAʤAk	bitɑʤɑk	biteʤek
bizDAki	bizddki	bizdeki
buluʃH	buluʃɯ	buluʃu
buzlH	buzlɯ	buzlu
dønHʃDA	døniʃdɑ	dønyʃte
dyzeltmAlAr	dyzeltmdlɑr	dyzeltmeler
desteklArH	desteklɑri	destekleri
dillArHn	dillɑrin	dillerin
etkenlArDAn	etkenlɑrddn	etkenlerden
gøndermAnHz	gøndermdniz	gøndermeniz
iʧeʤeklAr	iʧeʤeklɑr	iʧeʤekler
kɑdroHn	kɑdroɯn	kɑdroun
kɑnserlArH	kɑnserlɑri	kɑnserleri
koʃulsHz	koʃulsɯz	koʃulsuz
mydɑhɑlelAr	mydɑhɑlelɑr	mydɑhɑleler
mɑkɑlelArHn	mɑkɑlelɑrin	mɑkɑlelerin
modellAnmAH	modellɑnmɑi	modellenmei
mutfɑkDA	mutfɑkdɑ	mutfɑktɑ
profillArH	profillɑri	profilleri
tyketAn	tyketdn	tyketen
tyjlArH	tyjlɑri	tyjleri
tenʤereA	tenʤerei	tenʤeree
tijɑtroHn	tijɑtroɯn	tijɑtroun
ʧɑlɯʃDHkDAn	ʧɑlɯʃdɯkdɑn	ʧɑlɯʃtɯktɑn
øɰrenʤiDAn	øɰrenʤiddn	øɰrenʤiden
ørneklArDAn	ørneklɑrdɑn	ørneklerden
ʃehirlArɑrɑsɯ	ʃehirlɑrɑrɑsɯ	ʃehirlerɑrɑsɯ
ɑtmosferA	ɑtmosferɑ	ɑtmosfere
byjyklHklArH	byjykliklɑri	byjyklykleri
beʃDA	beʃdɑ	beʃte
borʧlHHn	borʧlɯɯn	borʧluun
denetimlArH	denetimlɑri	denetimleri
dengelAr	dengelɑr	dengeler
diskA	diskd	diske
fɑkylteA	fɑkylteɑ	fɑkyltee
gørDHkDAn	gørdikdɑn	gørdykten
geʧHʃlAr	geʧiʃlɑr	geʧiʃler
girmADA	girmddi	girmete
hɑberleʃmAH	hɑberleʃmɑi	hɑberleʃmei
hɑzretlArH	hɑzretlɑri	hɑzretleri
iA	iɑ	ie
isimlArHn	isimlɑrin	isimlerin
isteklHlAr	isteklilɑr	istekliler
kyʧylmA	kyʧylmd	kyʧylme
kemiklArH	kemiklɑri	kemikleri
kimliklArH	kimliklɑri	kimlikleri
kirlAnmAH	kirlɑnmɑi	kirlenmei
kooperɑtiflArH	kooperɑtiflɑri	kooperɑtifleri
lekelAr	lekelɑr	lekeler
lezjonHn	lezjonɯn	lezjonun
lifA	lifɑ	life
myesseselAr	myesseselɑr	myesseseler
mɑhɑlleDA	mɑhɑlledɑ	mɑhɑllede
mɑhkemelArHn	mɑhkemelɑrin	mɑhkemelerin
mɑkinelArHn	mɑkinelɑrin	mɑkinelerin
mɑmullArH	mɑmullɑrɯ	mɑmulleri
nøbetlArH	nøbetlɑri	nøbetleri
nedenDAn	nedenddn	nedenden
prosedyrH	prosedyri	prosedyry
syryʤylArHn	syryʤylɑrin	syryʤylerin
sinjɑllAr	sinjɑllɑr	sinjɑller
tuvɑletA	tuvɑletɑ	tuvɑlete
vermAmAH	vermɑmɑi	vermemei
jøntemlArA	jøntemlɑrd	jøntemlere
jykymlHlHklAr	jykymliliklɑr	jykymlylykler
ʧoɰunlukDA	ʧoɰunlukdɑ	ʧoɰunluktɑ
ølymlArH	ølymlɑri	ølymleri
ynH	yni	yny
bitmAH	bitmɑi	bitmei
delillAr	delillɑr	deliller
dereʤelAr	dereʤelɑr	dereʤeler
ekiplArHHn	ekiplɑriin	ekipleriin
eleʃtirilArH	eleʃtirilɑri	eleʃtirileri
emekliA	emeklii	emeklie
etkinlHkDA	etkinlikdi	etkinlikte
ejlemlArHn	ejlemlɑrin	ejlemlerin
gøʧH	gøʧi	gøʧy
gøksAl	gøksdl	gøksel
gørevlArDA	gørevlɑrdi	gørevlerde
gørmADAn	gørmɑdɑn	gørmeten
gerʧeklArA	gerʧeklɑrd	gerʧeklere
iplAr	iplɑr	ipler
kɑnserA	kɑnserɑ	kɑnsere
kesitlAr	kesitlɑr	kesitler
kitlelAr	kitlelɑr	kitleler
liselArH	liselɑri	liseleri
sevijelArA	sevijelɑrd	sevijelere
telefonnHzH	telefonnɯzɯ	telefonnuzu
usullArA	usullɑrɑ	usullere
jøntemlArDAn	jøntemlɑrdɑn	jøntemlerden
zehirlAnmA	zehirlɑnmɑ	zehirlenme
zirveDA	zirvedi	zirvede
ʧɑlɯʃmADAn	ʧɑlɯʃmɑdɑn	ʧɑlɯʃmɑtɑn
øzyrlyA	øzyrlyi	øzyrlye
ɑbonelArHHn	ɑbonelɑriin	ɑboneleriin
ɑrɑzilAr	ɑrɑzilɑr	ɑrɑziler
bɑjilArH	bɑjilɑri	bɑjileri
beledijemHzA	beledijemizd	beledijemize
birimDA	birimdɑ	birimde
ʤisimlArHn	ʤisimlɑrin	ʤisimlerin
deɰiʃimlArA	deɰiʃimlɑrd	deɰiʃimlere
eserlArDAn	eserlɑrddn	eserlerden
gøkjyzynDA	gøkjyzyndd	gøkjyzynde
giderlArHn	giderlɑrin	giderlerin
hemʃirelAr	hemʃirelɑr	hemʃireler
køpeklAr	køpeklɑr	køpekler
køjHHn	køjiin	køjyyn
kɑdemeDA	kɑdemedɑ	kɑdemede
kemiklArHn	kemiklɑrin	kemiklerin
kooperɑtiflAr	kooperɑtiflɑr	kooperɑtifler
mydyrlAr	mydyrlɑr	mydyrler
myhendislArHHn	myhendislɑriin	myhendisleriin
memurHHn	memuriin	memuruun
nedenlArHn	nedenlɑrin	nedenlerin
nesneA	nesnei	nesnee
rɑdjoH	rɑdjoɯ	rɑdjou
riskA	riskd	riske
sergilAAn	sergilddn	sergileen
tørenlArH	tørenlɑri	tørenleri
tytynDA	tytyndd	tytynde
tepkilArH	tepkilɑri	tepkileri
terminɑllArH	terminɑllɑrɯ	terminɑlleri
uɰurlH	uɰurlɯ	uɰurlu
ødeAn	ødeɑn	ødeen
ølmA	ølmɑ	ølme
beʤerilArHHn	beʤerilɑriin	beʤerileriin
birimlArDAn	birimlɑrdɑn	birimlerden
birliklArHn	birliklɑrin	birliklerin
dyʃAnH	dyʃɑnɯ	dyʃeni
deɰerDA	deɰerdd	deɰerde
efektlArH	efektlɑri	efektleri
ejlemlArA	ejlemlɑrd	ejlemlere
gøryntyA	gøryntyi	gøryntye
gyvenDA	gyvendd	gyvende
gɑjretlArH	gɑjretlɑri	gɑjretleri
geʧHʃDA	geʧiʃdɑ	geʧiʃte
geʧmADA	geʧmddɑ	geʧmete
genʧlArmHzHn	genʧlɑrmizin	genʧlermizin
grɑfiksAl	grɑfiksdl	grɑfiksel
hɑstɑneDAn	hɑstɑnedɑn	hɑstɑneden
iʧmDAn	iʧmdɑn	iʧmden
kontrolHHn	kontrolɯɯn	kontrolyyn
menylAr	menylɑr	menyler
mejvelArH	mejvelɑri	mejveleri
portføjH	portføji	portføjy
proʒelArDAn	proʒelɑrdɑn	proʒelerden
rolA	rolɑ	role
jyzAn	jyzdn	jyzen
jemekDA	jemekdɑ	jemekte
ʃehirlArH	ʃehirlɑri	ʃehirleri
yrynlArmHzH	yrynlɑrmizi	yrynlermizi
bølymDAki	bølymddki	bølymdeki
beklentilArn	beklentilɑrn	beklentilern
ʤisimlAr	ʤisimlɑr	ʤisimler
dyzenDA	dyzendd	dyzende
denizlArHn	denizlɑrin	denizlerin
dikkɑtmH	dikkɑtmɯ	dikkɑtmi
eʃlAr	eʃlɑr	eʃler
ekonomiDAn	ekonomidɑn	ekonomiden
endystriDA	endystridɑ	endystride
etlAr	etlɑr	etler
fɑɑlijetDAn	fɑɑlijetdɑn	fɑɑlijetten
gøtyrHp	gøtyrip	gøtyryp
geʧirmAH	geʧirmii	geʧirmei
getirAbilmA	getirdbilmi	getirebilme
idɑrelArHn	idɑrelɑrin	idɑrelerin
kesimlArHHn	kesimlɑriin	kesimleriin
kitlelArHn	kitlelɑrin	kitlelerin
kodHHn	kodɯɯn	koduun
metreDAn	metreddn	metreden
nesillArA	nesillɑrɑ	nesillere
pɑrtiDAn	pɑrtidɑn	pɑrtiden
syreʧlArHHn	syreʧlɑriin	syreʧleriin
tymørHn	tymørin	tymøryn
uʧlH	uʧli	uʧlu
uzɑklɯkDAki	uzɑklɯkdɑki	uzɑklɯktɑki
jɑtɑkDA	jɑtɑkdɑ	jɑtɑktɑ
jetkilHlArA	jetkililɑrɑ	jetkililere
ʧevirArAk	ʧevirɑrɑk	ʧevirerek
ønʤeliklArH	ønʤeliklɑri	ønʤelikleri
biʧimsAl	biʧimsdl	biʧimsel
dønemsAl	dønemsdl	dønemsel
dynDAn	dynddn	dynden
deɰerlendirmAHn	deɰerlendirmdin	deɰerlendirmein
deɰiʃkenlArHn	deɰiʃkenlɑrin	deɰiʃkenlerin
deɰinAn	deɰindn	deɰinen
ellArA	ellɑrɑ	ellere
engellArHn	engellɑrin	engellerin
etkenlArHn	etkenlɑrin	etkenlerin
etmADA	etmddɑ	etmede
etmAHHn	etmɑiin	etmeiin
ejlemlArHHn	ejlemlɑriin	ejlemleriin
geliʃimlArH	geliʃimlɑri	geliʃimleri
geniʃlAmAH	geniʃlɑmɑi	geniʃlemei
iʃʧilArHHn	iʃʧilɑriin	iʃʧileriin
iʃlevlAr	iʃlevlɑr	iʃlevler
ithɑlH	ithɑlɯ	ithɑli
kelimelArA	kelimelɑrd	kelimelere
kentlArA	kentlɑrɑ	kentlere
kimlArA	kimlɑrɑ	kimlere
kulyplAr	kulyplɑr	kulypler
kuruluʃDAn	kuruluʃdɑn	kuruluʃtɑn
kurummHz	kurummɯz	kurummuz
liflArHn	liflɑrin	liflerin
olguHn	olguɯn	olguun
olumsuzlHklArA	olumsuzlɯklɑrɑ	olumsuzluklɑrɑ
sɯnɑvlArHHn	sɯnɑvlɑriin	sɯnɑvlɑrɯɯn
sɯvɯHn	sɯvɯin	sɯvɯɯn
søzʤyklArHn	søzʤyklɑrin	søzʤyklerin
servislArA	servislɑrɑ	servislere
skorH	skorɯ	skoru
sonuʧsHz	sonuʧsɯz	sonuʧsuz
tehlikelAr	tehlikelɑr	tehlikeler
teknoloʒiDA	teknoloʒidɑ	teknoloʒide
telefonnHz	telefonnɯz	telefonnuz
jenAn	jendn	jenen
jerleʃmAH	jerleʃmɑi	jerleʃmei
ʧøkmAH	ʧøkmɑi	ʧøkmei
ʧiftʧilAr	ʧiftʧilɑr	ʧiftʧiler
øɰrenimA	øɰrenimd	øɰrenime
ødemAAn	ødemɑdn	ødemeen
øneriDA	øneridi	øneride
ørneklArDA	ørneklɑrdɑ	ørneklerde
ʃirketlArDAn	ʃirketlɑrdɑn	ʃirketlerden
ɑltDAn	ɑltdɑn	ɑlttɑn
bɑʃlɑngɯʧDAn	bɑʃlɑngɯʧdɑn	bɑʃlɑngɯʧtɑn
benzerlHklAr	benzerliklɑr	benzerlikler
døvizA	døvizd	døvize
dyʃArAk	dyʃɑrɑk	dyʃerek
diskDA	diskdɑ	diskte
filmA	filmd	filme
gørynmAAn	gørynmddn	gørynmeen
gøsterimA	gøsterimd	gøsterime
getirmADA	getirmddi	getirmete
gitDHklArH	gitdiklɑri	gittikleri
kɑlemlAr	kɑlemlɑr	kɑlemler
kɑrdeʃlAr	kɑrdeʃlɑr	kɑrdeʃler
kelimeA	kelimei	kelimee
mɑliklArH	mɑliklɑri	mɑlikleri
mɑlzemelArDAn	mɑlzemelɑrdɑn	mɑlzemelerden
mɑlzemeA	mɑlzemei	mɑlzemee
nedenlArHHn	nedenlɑriin	nedenleriin
sɯvɯH	sɯvɯi	sɯvɯɯ
sɑɑtlArHHn	sɑɑtlɑrɯɯn	sɑɑtleriin
teknoloʒilArA	teknoloʒilɑrd	teknoloʒilere
temizlAmA	temizlɑmɑ	temizleme
viryslArH	viryslɑri	virysleri
jerjyzynDAki	jerjyzynddki	jerjyzyndeki
ʧekmAH	ʧekmɑi	ʧekmei
ʧerʧevelAr	ʧerʧevelɑr	ʧerʧeveler
ʧizgiDA	ʧizgidɑ	ʧizgide
øɰretmenA	øɰretmend	øɰretmene
ɑlbymHn	ɑlbymin	ɑlbymyn
ɑrɑʧDA	ɑrɑʧdɑ	ɑrɑʧtɑ
ɑteʃDAn	ɑteʃdɑn	ɑteʃten
beʤerilArHn	beʤerilɑrin	beʤerilerin
belgeDA	belgedi	belgede
dengelemA	dengelemd	dengeleme
gøʧHn	gøʧin	gøʧyn
gøzlArmH	gøzlɑrmɯ	gøzlermi
gereʧlAr	gereʧlɑr	gereʧler
ihɑlelArDA	ihɑlelɑrdɑ	ihɑlelerde
ilgilArH	ilgilɑri	ilgileri
isimlArHHn	isimlɑriin	isimleriin
isteklArHHn	isteklɑriin	istekleriin
kɑlmADA	kɑlmɑdɑ	kɑlmɑtɑ
kɑnserlArHHn	kɑnserlɑriin	kɑnserleriin
kutuplH	kutuplɯ	kutuplu
mɑhkemeDAn	mɑhkemedɑn	mɑhkemeden
mevzuɑtDA	mevzuɑtdɑ	mevzuɑttɑ
onurH	onurɯ	onuru
syzmA	syzmɑ	syzme
sɑlonHn	sɑlonɯn	sɑlonun
sevgilAr	sevgilɑr	sevgiler
sezonH	sezonɯ	sezonu
tyrkylAr	tyrkylɑr	tyrkyler
tyrlArDA	tyrlɑrdɑ	tyrlerde
tɑrifelArH	tɑrifelɑri	tɑrifeleri
tedbirlArA	tedbirlɑrɑ	tedbirlere
ujkusHzlHk	ujkusɯzlɯk	ujkusuzluk
jønetmeliklArHn	jønetmeliklɑrin	jønetmeliklerin
jineDA	jinedi	jinede
ʧekilmAA	ʧekilmɑi	ʧekilmee
ølmAH	ølmɑi	ølmei
ønerilArHHn	ønerilɑriin	ønerileriin
øjkylArH	øjkylɑri	øjkyleri
beklentilArHHn	beklentilɑriin	beklentileriin
bejA	bejɑ	beje
bitmADAn	bitmɑdɑn	bitmeden
deɰiʃmAA	deɰiʃmɑɑ	deɰiʃmee
durHʃ	durɯʃ	duruʃ
edenA	edend	edene
egzersizlAr	egzersizlɑr	egzersizler
gerʧeklArHn	gerʧeklɑrin	gerʧeklerin
giriʃimlArHn	giriʃimlɑrin	giriʃimlerin
iʧmAA	iʧmɑɑ	iʧmee
ihɑlelArH	ihɑlelɑri	ihɑleleri
isteklHlArHn	isteklilɑrin	isteklilerin
køprylAr	køprylɑr	køpryler
komʃulHk	komʃulɯk	komʃuluk
liderlArHHn	liderlɑriin	liderleriin
mɑterjɑllArHn	mɑterjɑllɑrɯn	mɑterjɑllerin
nedenlArA	nedenlɑrd	nedenlere
nerelArA	nerelɑrd	nerelere
problemA	problemɑ	probleme
proʒeDAn	proʒedɑn	proʒeden
syrmA	syrmɑ	syrme
seʧeneklArHHn	seʧeneklɑriin	seʧenekleriin
sebzelAr	sebzelɑr	sebzeler
sitemHzDAn	sitemizddn	sitemizden
sokɑkDAki	sokɑkdɑki	sokɑktɑki
sunmADA	sunmɑdɑ	sunmɑtɑ
teknoloʒiDAn	teknoloʒiddn	teknoloʒiden
uʧDAn	uʧdɑn	uʧtɑn
viryslArHn	viryslɑrin	viryslerin
jyzHn	jyzin	jyzyn
ʧɑmurHn	ʧɑmurɯn	ʧɑmurun
ʧerʧevelArH	ʧerʧevelɑri	ʧerʧeveleri
ʧoɰumHz	ʧoɰumɯz	ʧoɰumuz
ʃɑblonH	ʃɑblonɯ	ʃɑblonu
ʃirketDAn	ʃirketddn	ʃirketten
yrynlArmHzHn	yrynlɑrmizin	yrynlermizin
bytynsAl	bytynsdl	bytynsel
bɑhʧeA	bɑhʧeɑ	bɑhʧee
bilimlArHn	bilimlɑrin	bilimlerin
bitkilArDA	bitkilɑrdɑ	bitkilerde
ʤɑmiA	ʤɑmiɑ	ʤɑmie
døkymA	døkymd	døkyme
dyzlemDA	dyzlemdi	dyzlemde
deɰiʃimlArHn	deɰiʃimlɑrin	deɰiʃimlerin
eɰitmA	eɰitmd	eɰitme
esenlAr	esenlɑr	esenler
etlArH	etlɑri	etleri
fɑkyltelArHHn	fɑkyltelɑriin	fɑkylteleriin
fonksijonHn	fonksijonɯn	fonksijonun
gɑjrimenkullArHn	gɑjrimenkullɑrin	gɑjrimenkullerin
hyʤreDA	hyʤredɑ	hyʤrede
hɑstɑnelArA	hɑstɑnelɑrɑ	hɑstɑnelere
iʃnHz	iʃnɯz	iʃniz
kyltyrlH	kyltyrli	kyltyrly
kɑpɑsitelAr	kɑpɑsitelɑr	kɑpɑsiteler
koleksijonH	koleksijonɯ	koleksijonu
kuzejDAn	kuzejdɑn	kuzejden
myzelAr	myzelɑr	myzeler
mɑkbuzHn	mɑkbuzɯn	mɑkbuzun
mesleklArH	mesleklɑri	meslekleri
milletʧA	milletʧɑ	milletʧe
okuDHkDAn	okudɯkdɑn	okuduktɑn
olumsuzlHklArH	olumsuzlɯklɑrɯ	olumsuzluklɑrɯ
ortɑokulH	ortɑokulɯ	ortɑokulu
siteDAn	sitedɑn	siteden
sosH	sosɯ	sosu
suʧDAn	suʧdɑn	suʧtɑn
tytynlArHHn	tytynlɑriin	tytynleriin
temɑsDA	temɑsdɑ	temɑstɑ
temsiliA	temsilii	temsilie
tohumlHk	tohumlɯk	tohumluk
jyksekokullArH	jyksekokullɑri	jyksekokullɑrɯ
jeteneklArHHn	jeteneklɑriin	jetenekleriin
ʧøkmA	ʧøkmɑ	ʧøkme
ʧekmAH	ʧekmɑi	ʧekmei
øɰretAn	øɰretdn	øɰreten
ølʧylH	ølʧyli	ølʧyly
ʃuurH	ʃuurɯ	ʃuuru
yrynHHn	yryniin	yrynyyn
ɑjɑkDAn	ɑjɑkdɑn	ɑjɑktɑn
bøʤeklArHn	bøʤeklɑrin	bøʤeklerin
byjyArAk	byjyɑrɑk	byjyerek
bɑʃvuruHHn	bɑʃvuruiin	bɑʃvuruuun
bilDHklArH	bildiklɑri	bildikleri
bulAbilmA	bulɑbilmd	bulɑbilme
defterlAr	defterlɑr	defterler
denklemlArHn	denklemlɑrin	denklemlerin
dinlenmA	dinlenmd	dinlenme
dizilArH	dizilɑri	dizileri
etlArHn	etlɑrin	etlerin
fɑktørlArA	fɑktørlɑrɑ	fɑktørlere
fɑktørlArHHn	fɑktørlɑriin	fɑktørleriin
gøʧmenlArHn	gøʧmenlɑrin	gøʧmenlerin
gøsterHʃlH	gøsteriʃlɯ	gøsteriʃli
hususHn	hususɯn	hususun
huzursHz	huzursɯz	huzursuz
iʃtirɑkH	iʃtirɑkɯ	iʃtirɑki
mydyrA	mydyrd	mydyre
mydɑhɑleDA	mydɑhɑledɑ	mydɑhɑlede
menfɑɑtH	menfɑɑtɯ	menfɑɑti
mevsimDA	mevsimdi	mevsimde
seʧimlArDAn	seʧimlɑrdɑn	seʧimlerden
seʧDHklArH	seʧdiklɑri	seʧtikleri
seferA	seferd	sefere
senetlArHn	senetlɑrin	senetlerin
solunumH	solunumɯ	solunumu
tyrevlArH	tyrevlɑri	tyrevleri
tɑvsijelArH	tɑvsijelɑri	tɑvsijeleri
teʤrybeA	teʤrybei	teʤrybee
tekniklArn	tekniklɑrn	tekniklern
unlH	unlɯ	unlu
ujduH	ujduɯ	ujduu
vyʤutDAn	vyʤutddn	vyʤuttɑn
verAnlArHn	verɑnlɑrin	verenlerin
jønetmeliklArH	jønetmeliklɑri	jønetmelikleri
jyzejlArA	jyzejlɑrɑ	jyzejlere
zorlHklArA	zorlɯklɑrɑ	zorluklɑrɑ
ʧøkAn	ʧøkɑn	ʧøken
ʧevrenHzDAki	ʧevrenizddki	ʧevrenizdeki
ølʧytlAr	ølʧytlɑr	ølʧytler
ʃehirDAn	ʃehirddn	ʃehirden
ʃifrelAr	ʃifrelɑr	ʃifreler
bildirmAH	bildirmɑi	bildirmei
ʤiltDA	ʤiltdd	ʤiltte
dyʃynʤelArA	dyʃynʤelɑrd	dyʃynʤelere
dereʤelArDA	dereʤelɑrdɑ	dereʤelerde
dujguH	dujgui	dujguu
eɰrilArH	eɰrilɑri	eɰrileri
elementlArHn	elementlɑrin	elementlerin
enʒeksijonH	enʒeksijonɯ	enʒeksijonu
enstityDA	enstitydi	enstityde
erkeklArDAn	erkeklɑrddn	erkeklerden
evnHzA	evnizd	evnize
fertlArH	fertlɑri	fertleri
filmlArDA	filmlɑrdɑ	filmlerde
gøryntylAAn	gøryntylddn	gøryntyleen
gørmAlArH	gørmɑlɑri	gørmeleri
geʧirDHklArH	geʧirdiklɑri	geʧirdikleri
gelDHkʧA	geldikʧɑ	geldikʧe
gelAnlArA	gelɑnlɑrɑ	gelenlere
getirmAlArH	getirmɑlɑri	getirmeleri
girmAlArH	girmɑlɑri	girmeleri
hyʤrelArDAn	hyʤrelɑrdɑn	hyʤrelerden
hɑkDAn	hɑkdɑn	hɑktɑn
hɑmmɑddelAr	hɑmmɑddelɑr	hɑmmɑddeler
hesɑpDA	hesɑpdɑ	hesɑptɑ
iʃnHzH	iʃnɯzɯ	iʃnizi
iʃlemDA	iʃlemdi	iʃlemde
kesimDAn	kesimdɑn	kesimden
konuʃHp	konuʃɯp	konuʃup
kutuHHn	kutuɯɯn	kutuuun
myteɑhhitlAr	myteɑhhitlɑr	myteɑhhitler
mɑlijetlArHn	mɑlijetlɑrin	mɑlijetlerin
nesillAr	nesillɑr	nesiller
netiʤelArH	netiʤelɑri	netiʤeleri
syrelArHn	syrelɑrin	syrelerin
syrmA	syrmɑ	syrme
seʧimDAn	seʧimddn	seʧimden
seslArHn	seslɑrin	seslerin
tɑksitlAr	tɑksitlɑr	tɑksitler
tɑnsijonH	tɑnsijonɯ	tɑnsijonu
tɑrihmHzDA	tɑrihmizdɑ	tɑrihmizde
turistlAr	turistlɑr	turistler
vergiA	vergii	vergie
jykselmAA	jykselmɑi	jykselmee
jenilgiA	jenilgii	jenilgie
zijɑretlAr	zijɑretlɑr	zijɑretler
ʧelikDAn	ʧelikdɑn	ʧelikten
ʧizAn	ʧizɑn	ʧizen
ølʧytH	ølʧyti	ølʧyty
ɑdresDAn	ɑdresdɑn	ɑdresten
bilmAnHz	bilmdniz	bilmeniz
ʤymlelArH	ʤymlelɑri	ʤymleleri
dønyʃymlH	dønyʃymli	dønyʃymly
døvmA	døvmd	døvme
delegelArH	delegelɑri	delegeleri
direnmA	direnmd	direnme
doɰumH	doɰumɯ	doɰumu
egzersizlArH	egzersizlɑri	egzersizleri
elbiselAr	elbiselɑr	elbiseler
elmDAn	elmddn	elmden
felsefeA	felsefei	felsefee
geʧmAH	geʧmdi	geʧmei
geliʃArAk	geliʃɑrɑk	geliʃerek
hɑmurH	hɑmurɯ	hɑmuru
hejetlArH	hejetlɑri	hejetleri
hiʧA	hiʧɑ	hiʧe
hissetmA	hissetmd	hissetme
kømyrHn	kømyrin	kømyryn
kɑtDAn	kɑtdɑn	kɑttɑn
kentlArH	kentlɑri	kentleri
kulɑkDAn	kulɑkdɑn	kulɑktɑn
mutlulHklAr	mutlulɯklɑr	mutluluklɑr
ofislArH	ofislɑri	ofisleri
pilotH	pilotɯ	pilotu
sytHHn	sytiin	sytyyn
sɑvʤɯHn	sɑvʤɯin	sɑvʤɯɯn
sektørDAn	sektørdɑn	sektørden
stɑtyDA	stɑtydɑ	stɑtyde
teʤrybelAr	teʤrybelɑr	teʤrybeler
temsilʤilArHn	temsilʤilɑrin	temsilʤilerin
jønetimlArA	jønetimlɑrd	jønetimlere
jyryHʃA	jyryiʃɑ	jyryyʃe
jɑhudilAr	jɑhudilɑr	jɑhudiler
jelpɑzeDA	jelpɑzedɑ	jelpɑzede
jijeʤeklArHn	jijeʤeklɑrin	jijeʤeklerin
øjkylAr	øjkylɑr	øjkyler
ʃirketmHzDA	ʃirketmizdɑ	ʃirketmizde
ynA	ynd	yne
yretiʤilArA	yretiʤilɑrd	yretiʤilere
yzermA	yzermi	yzerme
ɑsitlAr	ɑsitlɑr	ɑsitler
byjylH	byjyli	byjyly
bɑʃvurDHklArH	bɑʃvurdiklɑri	bɑʃvurduklɑrɯ
bɑʃvurmAnHz	bɑʃvurmɑniz	bɑʃvurmɑnɯz
belirAn	belirɑn	beliren
dønymlHk	dønymlik	dønymlyk
dereʤeDAki	dereʤeddki	dereʤedeki
eɰitimlArA	eɰitimlɑrd	eɰitimlere
etkilAnmA	etkilɑnmɑ	etkilenme
etrɑfDA	etrɑfdɑ	etrɑftɑ
fonksijonHHn	fonksijonɯɯn	fonksijonuun
gøryʃlH	gøryʃli	gøryʃly
gøryntylAnmAH	gøryntylɑnmɑi	gøryntylenmei
gyndemDAki	gyndemddki	gyndemdeki
geleneklArH	geleneklɑri	gelenekleri
gitmAAn	gitmddn	gitmeen
iʧmA	iʧmd	iʧme
iʧsAl	iʧsdl	iʧsel
iʃlemʤilAr	iʃlemʤilɑr	iʃlemʤiler
isteklHlArA	isteklilɑrɑ	isteklilere
kɯjmetlArHn	kɯjmetlɑrin	kɯjmetlerin
køjlyHn	køjlyin	køjlyyn
kɑbuklH	kɑbuklɯ	kɑbuklu
kolHHn	kolɯɯn	koluun
kongrelAr	kongrelɑr	kongreler
kumɑʃDAn	kumɑʃdɑn	kumɑʃtɑn
mɑhkemeDA	mɑhkemedɑ	mɑhkemede
mɑkinelArHHn	mɑkinelɑriin	mɑkineleriin
meselelAr	meselelɑr	meseleler
muɑjeneA	muɑjeneɑ	muɑjenee
oʤɑkDAn	oʤɑkdɑn	oʤɑktɑn
olguHHn	olguɯɯn	olguuun
pɑrtiDA	pɑrtidɑ	pɑrtide
profesørH	profesøri	profesøry
søzlArA	søzlɑrɑ	søzlere
senelArDA	senelɑrdɑ	senelerde
tɑrifeDA	tɑrifedɑ	tɑrifede
tɑvsijelArDA	tɑvsijelɑrdɑ	tɑvsijelerde
tesʤilA	tesʤild	tesʤile
vɑzgeʧmA	vɑzgeʧmɑ	vɑzgeʧme
verAbilAn	veribildn	verebilen
jerjyzyHn	jerjyzyin	jerjyzyyn
ørtAn	ørtɑn	ørten
ɑdɑletA	ɑdɑletɑ	ɑdɑlete
ɑkɑdemisjenlAr	ɑkɑdemisjenlɑr	ɑkɑdemisjenler
ɑletlArHHn	ɑletlɑriin	ɑletleriin
ɑlkolHn	ɑlkolɯn	ɑlkolyn
ɑtmosferDA	ɑtmosferdɑ	ɑtmosferde
bileʃiklArHn	bileʃiklɑrin	bileʃiklerin
ʤetvellArH	ʤetvellɑri	ʤetvelleri
dyʃHp	dyʃip	dyʃyp
demAH	demɑi	demei
eʤzɑnelAr	eʤzɑnelɑr	eʤzɑneler
elementlAr	elementlɑr	elementler
enginA	engind	engine
formylA	formyld	formyle
gøʧlAr	gøʧlɑr	gøʧler
gøzykAn	gøzykɑn	gøzyken
geʧAnlArA	geʧɑnlɑrɑ	geʧenlere
gemiA	gemii	gemie
hɑreketlArA	hɑreketlɑrɑ	hɑreketlere
hekimlArHHn	hekimlɑriin	hekimleriin
inʤelemAH	inʤelemdi	inʤelemei
kesintilAr	kesintilɑr	kesintiler
logoH	logoɯ	logou
orduH	orduɯ	orduu
søzleʃmelArDA	søzleʃmelɑrdɑ	søzleʃmelerde
sergiA	sergii	sergie
servisDAn	servisdɑn	servisten
sevgiA	sevgii	sevgie
sejretmA	sejretmd	sejretme
sistemlArDAn	sistemlɑrdɑn	sistemlerden
soluklH	soluklɯ	soluklu
tɑʃɯmADA	tɑʃɯmɑdɑ	tɑʃɯmɑtɑ
temizlAHʤH	temizldiʤi	temizleiʤi
tepsiA	tepsii	tepsie
jemeklArHn	jemeklɑrin	jemeklerin
ʧiʧeklArHn	ʧiʧeklɑrin	ʧiʧeklerin
øɰrenHnʤA	øɰreninʤd	øɰreninʤe
ølAnlArHn	ølɑnlɑrin	ølenlerin
ʃubelArHn	ʃubelɑrin	ʃubelerin
yniteDA	ynitedi	ynitede
yniversiteDAki	yniversiteddki	yniversitedeki
ɑnlɑmADA	ɑnlɑmɑdɑ	ɑnlɑmɑtɑ
bebekDA	bebekdɑ	bebekte
beledijelArDA	beledijelɑrdi	beledijelerde
blokDA	blokdɑ	bloktɑ
bojutHHn	bojutɯin	bojutuun
bulDHklArH	buldɯklɑrɯ	bulduklɑrɯ
dɑireA	dɑireɑ	dɑiree
dɑvɑHHn	dɑvɑɯin	dɑvɑɯɯn
erkeklArH	erkeklɑri	erkekleri
fonksijonlH	fonksijonlɯ	fonksijonlu
gøʧmenlAr	gøʧmenlɑr	gøʧmenler
gønderDHklArH	gønderdiklɑri	gønderdikleri
gøstermAlArH	gøstermɑlɑri	gøstermeleri
gøzlArDA	gøzlɑrdɑ	gøzlerde
gereksinimlArHHn	gereksinimlɑriin	gereksinimleriin
geziA	gezii	gezie
hususDAki	hususdɑki	husustɑki
iʧermADA	iʧermddi	iʧermete
iʃnHzA	iʃnɯzɑ	iʃnize
ileriDAki	ileriddki	ilerideki
ilerleArAk	ilerleɑrdk	ilerleerek
køtyH	køtyi	køtyy
kesimlArDA	kesimlɑrdɑ	kesimlerde
konforH	konforɯ	konforu
krizlArH	krizlɑri	krizleri
kutuHn	kutuɯn	kutuun
mɑhkemelArA	mɑhkemelɑrɑ	mɑhkemelere
milletmHzA	milletmizd	milletmize
minimHzA	minimizd	minimize
sytunH	sytuni	sytunu
sitelArHn	sitelɑrin	sitelerin
sitelArHHn	sitelɑriin	siteleriin
typHn	typin	typyn
tɑrihʧilAr	tɑrihʧilɑr	tɑrihʧiler
teorilAr	teorilɑr	teoriler
topʧHlAr	topʧɯlɑr	topʧulɑr
ulusHHn	ulusɯɯn	ulusuun
jønHHn	jøniin	jønyyn
jɑɰmurlH	jɑɰmurlɯ	jɑɰmurlu
joɰunlHklH	joɰunlɯklɯ	joɰunluklu
ʧiɰnemA	ʧiɰnemi	ʧiɰneme
ʧillAr	ʧillɑr	ʧiller
ʧizArAk	ʧizɑrɑk	ʧizerek
ʧoʤuklH	ʧoʤuklɯ	ʧoʤuklu
øɰytmA	øɰytmd	øɰytme
øɰrenʤilArDA	øɰrenʤilɑrdɑ	øɰrenʤilerde
ʃiddetDA	ʃiddetdd	ʃiddette
ynitelArHHn	ynitelɑriin	yniteleriin
ɑrɑʧDAn	ɑrɑʧdɑn	ɑrɑʧtɑn
biʧimlArHHn	biʧimlɑriin	biʧimleriin
bilgiDAn	bilgidɑn	bilgiden
bojutDAki	bojutdɑki	bojuttɑki
ʤetvelDA	ʤetveldd	ʤetvelde
dønemlArDAn	dønemlɑrdɑn	dønemlerden
dɑvrɑnHʃDA	dɑvrɑnɯʃdɑ	dɑvrɑnɯʃtɑ
deɰiʃmADAn	deɰiʃmɑdɑn	deɰiʃmeden
dinlemAA	dinlemɑi	dinlemee
dujguHHn	dujguiin	dujguuun
etkilAmA	etkilɑmɑ	etkileme
gøryʃHHn	gøryʃiin	gøryʃyyn
gyvenAn	gyvendn	gyvenen
gɑjrimenkulHn	gɑjrimenkulin	gɑjrimenkulyn
gɑzetelArA	gɑzetelɑrɑ	gɑzetelere
gidermAA	gidermɑi	gidermee
hɑmmɑddelArH	hɑmmɑddelɑri	hɑmmɑddeleri
hɑjɑtDAki	hɑjɑtdɑki	hɑjɑttɑki
kyresAllAʃAn	kyresdlldʃɑn	kyreselleʃen
kɑrɑkterlArHn	kɑrɑkterlɑrin	kɑrɑkterlerin
kɑjbetmA	kɑjbetmɑ	kɑjbetme
kɑjbetmA	kɑjbetmɑ	kɑjbetme
kollH	kollɯ	kollu
kotH	kotɯ	kotu
kutuH	kutuɯ	kutuu
liselArDA	liselɑrdɑ	liselerde
merʤilArA	merʤilɑrɑ	merʤilere
nedenA	nedend	nedene
okuHʤHnHn	okuɯʤinin	okuuʤunun
rezervlArHn	rezervlɑrin	rezervlerin
seneDAn	seneddn	seneden
setlArH	setlɑri	setleri
sijɑsetʧHlAr	sijɑsetʧilɑr	sijɑsetʧiler
soɰukDAn	soɰukdɑn	soɰuktɑn
tehlikelArH	tehlikelɑri	tehlikeleri
teknelAr	teknelɑr	tekneler
teknoloʒiDAki	teknoloʒiddki	teknoloʒideki
tellArH	tellɑri	telleri
terøristlAr	terøristlɑr	terøristler
tesirlArH	tesirlɑri	tesirleri
titremA	titremd	titreme
ujkusHz	ujkusɯz	ujkusuz
ujumHn	ujumɯn	ujumun
veriA	verii	verie
jyksekDA	jyksekdɑ	jyksekte
jyzHHn	jyziin	jyzyyn
ʧeʃitlAr	ʧeʃitlɑr	ʧeʃitler
ʧeklArH	ʧeklɑri	ʧekleri
øɰrenʤilArmHzH	øɰrenʤilɑrmizi	øɰrenʤilermizi
ømyrlArH	ømyrlɑri	ømyrleri
øzellHklArDA	øzelliklɑrdi	øzelliklerde
ʃɑirlAr	ʃɑirlɑr	ʃɑirler
ʃekilDAki	ʃekilddki	ʃekildeki
yniversitemHzA	yniversitemizd	yniversitemize
yretimlAr	yretimlɑr	yretimler
ɑʧɯlɯʃDA	ɑʧɯlɯʃdɑ	ɑʧɯlɯʃtɑ
ɑbonelArA	ɑbonelɑrɑ	ɑbonelere
ɑnketlAr	ɑnketlɑr	ɑnketler
ɑrɑzilArHn	ɑrɑzilɑrin	ɑrɑzilerin
ɑzotlH	ɑzotlɯ	ɑzotlu
berɑbernDAki	berɑbernddki	berɑberndeki
bitmA	bitmɑ	bitme
døkymDA	døkymdd	døkymde
døngyH	døngyi	døngyy
dyʃynʤelArnHzH	dyʃynʤelɑrnizi	dyʃynʤelernizi
dyʃynmAH	dyʃynmdi	dyʃynmei
dekontH	dekontɯ	dekontu
delillArH	delillɑri	delilleri
dilDAki	dilddki	dildeki
dinɑmiklArH	dinɑmiklɑri	dinɑmikleri
dizilAr	dizilɑr	diziler
dostlHklAr	dostlɯklɑr	dostluklɑr
eksiklArH	eksiklɑri	eksikleri
fiʃlArH	fiʃlɑrɯ	fiʃleri
fiillAr	fiillɑr	fiiller
hykymetDA	hykymetdd	hykymette
hɑngilArHHn	hɑngilɑriin	hɑngileriin
hɑreketDA	hɑreketdɑ	hɑrekette
hɑriʤinDAki	hɑriʤinddki	hɑriʤindeki
hɑvuzHn	hɑvuzin	hɑvuzun
hesɑpDAn	hesɑpdɑn	hesɑptɑn
hormonH	hormonɯ	hormonu
hujlH	hujlɯ	hujlu
ilDAki	ilddki	ildeki
indirgemA	indirgemd	indirgeme
kelimelArHHn	kelimelɑriin	kelimeleriin
kemiklAr	kemiklɑr	kemikler
kesimlArA	kesimlɑrɑ	kesimlere
klɑvjeDAn	klɑvjeddn	klɑvjeden
limitlAr	limitlɑr	limitler
mylteʤilArA	mylteʤilɑrd	mylteʤilere
myzɑkerelArHn	myzɑkerelɑrin	myzɑkerelerin
mɑhkemelArDA	mɑhkemelɑrdɑ	mɑhkemelerde
minerɑlH	minerɑlɯ	minerɑli
minerɑllArHn	minerɑllɑrɯn	minerɑllerin
motiflAr	motiflɑr	motifler
numunelAr	numunelɑr	numuneler
primlAr	primlɑr	primler
reʧetelAr	reʧetelɑr	reʧeteler
rehberlArH	rehberlɑri	rehberleri
rizikoHn	rizikoin	rizikoun
søzleʃmeDAn	søzleʃmeddn	søzleʃmeden
sɑɑtHHn	sɑɑtɯɯn	sɑɑtiin
sɑntrɑllAr	sɑntrɑllɑr	sɑntrɑller
sirkA	sirkɑ	sirke
suʧlHlHk	suʧlɯlɯk	suʧluluk
tɑksitDA	tɑksitdɑ	tɑksitte
teklifDA	teklifdi	teklifte
temsilʤilHklAr	temsilʤiliklɑr	temsilʤilikler
tohumH	tohumɯ	tohumu
trɑfikDA	trɑfikdɑ	trɑfikte
ulɑʃAbilmAH	ulɑʃɑbilmɑi	ulɑʃɑbilmei
umutsHz	umutsɯz	umutsuz
verilArDAn	verilɑrdɑn	verilerden
jenilHklArHn	jeniliklɑrin	jeniliklerin
jetiʃmA	jetiʃmɑ	jetiʃme
ølymlArA	ølymlɑrd	ølymlere
ɑɰɯrlɯkDA	ɑɰɯrlɯkdɑ	ɑɰɯrlɯktɑ
ɑsitlArH	ɑsitlɑri	ɑsitleri
bulDHkʧA	buldɯkʧɑ	buldukʧɑ
dɑirelArn	dɑirelɑrn	dɑirelern
dɑvetlHlAr	dɑvetlilɑr	dɑvetliler
deliklArH	deliklɑri	delikleri
denetlAnAn	denetlɑndn	denetlenen
dengeDA	dengedi	dengede
destekDAn	destekddn	destekten
dilimlArH	dilimlɑri	dilimleri
direnAn	direndn	direnen
eɰilmA	eɰilmi	eɰilme
editørlAr	editørlɑr	editørler
gøʧA	gøʧɑ	gøʧe
gøryʃDA	gøryʃdɑ	gøryʃte
gøstermAAn	gøstermddn	gøstermeen
gyllAr	gyllɑr	gyller
gyvenA	gyvend	gyvene
geliʃmAHHn	geliʃmɑiin	geliʃmeiin
ilʧemHzDA	ilʧemizdi	ilʧemizde
izolɑsjonH	izolɑsjonɯ	izolɑsjonu
kesArAk	kesɑrɑk	keserek
kontrolDAn	kontroldɑn	kontrolden
konutH	konutɯ	konutu
myhendislArHn	myhendislɑrin	myhendislerin
myzɑkerelAr	myzɑkerelɑr	myzɑkereler
okʧHlHk	okʧɯlɯk	okʧuluk
proteinlArHn	proteinlɑrin	proteinlerin
restorɑsjonH	restorɑsjonɯ	restorɑsjonu
sɯnɯfDAki	sɯnɯfdɑki	sɯnɯftɑki
sɑhilA	sɑhilɑ	sɑhile
sɑhiplAr	sɑhiplɑr	sɑhipler
sevijelArHHn	sevijelɑriin	sevijeleriin
sponsorH	sponsorɯ	sponsoru
sunDHklArH	sundɯklɑrɯ	sunduklɑrɯ
tymørlArDA	tymørlɑrdɑ	tymørlerde
tyrkyH	tyrkyi	tyrkyy
tekliflArHHn	tekliflɑriin	teklifleriin
televizjonHn	televizjonɯn	televizjonun
tesislArDAn	tesislɑrdɑn	tesislerden
jønlAr	jønlɑr	jønler
zijɑretDAn	zijɑretdɑn	zijɑretten
ʧøzymlArHHn	ʧøzymlɑriin	ʧøzymleriin
ʧizgiA	ʧizgii	ʧizgie
ørneklArA	ørneklɑrd	ørneklere
ɑtɯfDA	ɑtɯfdɑ	ɑtɯftɑ
bɑʃlɑngɯʧDAki	bɑʃlɑngɯʧdɑki	bɑʃlɑngɯʧtɑki
bellekDA	bellekdɑ	bellekte
bilɑnʧoH	bilɑnʧoɯ	bilɑnʧou
bilgilArDA	bilgilɑrdɑ	bilgilerde
bilimDA	bilimdɑ	bilimde
boʃlukDA	boʃlukdɑ	boʃluktɑ
broʃyrlAr	broʃyrlɑr	broʃyrler
derinlHkDA	derinlikdɑ	derinlikte
dileDHklArH	dilediklɑri	diledikleri
dillArDAn	dillɑrdɑn	dillerden
disiplinA	disiplind	disipline
ekAn	ekɑn	eken
ekiplArHn	ekiplɑrin	ekiplerin
etkilAArAk	etkilɑɑrɑk	etkileerek
etmAmA	etmɑmɑ	etmeme
ejlemDA	ejlemdd	ejlemde
gøndermAlArH	gøndermɑlɑri	gøndermeleri
gøryʃmelArHHn	gøryʃmelɑriin	gøryʃmeleriin
gørmAnHzH	gørmɑnɯzɯ	gørmenizi
gydymlH	gydymli	gydymly
geniʃlAAn	geniʃlɑɑn	geniʃleen
gevʃemA	gevʃemi	gevʃeme
hɑreketlArDA	hɑreketlɑrdɑ	hɑreketlerde
herkesʧA	herkesʧɑ	herkesʧe
inArAk	inɑrɑk	inerek
kɯjɑfetlArH	kɯjɑfetlɑri	kɯjɑfetleri
kɑdromHz	kɑdromɯz	kɑdromuz
keʃfetmA	keʃfetmd	keʃfetme
kolHn	kolɯn	kolun
krediA	kredii	kredie
krizDA	krizdɑ	krizde
lyzumH	lyzumi	lyzumu
mɑʧDA	mɑʧdɑ	mɑʧtɑ
molekyllAr	molekyllɑr	molekyller
muɑjenelAr	muɑjenelɑr	muɑjeneler
odunHn	odunɯn	odunun
sebeplArHn	sebeplɑrin	sebeplerin
siteDAki	siteddki	sitedeki
stresA	stresd	strese
tehlikelArA	tehlikelɑrd	tehlikelere
telA	telɑ	tele
tepeA	tepei	tepee
terʤihlAr	terʤihlɑr	terʤihler
terimlArHn	terimlɑrin	terimlerin
ujgunsHz	ujgunsɯz	ujgunsuz
verAbiljor	verɑbiljor	verebiljor
vergiDAn	vergidɑn	vergiden
vizjonmHz	vizjonmɯz	vizjonmuz
jønetmeliklArA	jønetmeliklɑrɑ	jønetmeliklere
zevknA	zevknd	zevkne
ʧekimlAr	ʧekimlɑr	ʧekimler
ønmDA	ønmdɑ	ønmde
ʃebekelArH	ʃebekelɑri	ʃebekeleri
bytʧeDA	bytʧedɑ	bytʧede
bytʧelArH	bytʧelɑri	bytʧeleri
byjylAHʤH	byjyldiʤi	byjyleiʤi
dyzenlAnHp	dyzenldnip	dyzenlenip
direktiflArH	direktiflɑri	direktifleri
engellAmAA	engellɑmɑɑ	engellemee
fɑɑlijetlArmHz	fɑɑlijetlɑrmiz	fɑɑlijetlermiz
fɑkyltelArDA	fɑkyltelɑrdɑ	fɑkyltelerde
gøkDAn	gøkdɑn	gøkten
gømylH	gømyli	gømyly
gøryʃAn	gøryʃɑn	gøryʃen
gørynHʃDA	gøryniʃdɑ	gørynyʃte
gørAlH	gørɑli	gøreli
gørAnlArHn	gørɑnlɑrin	gørenlerin
gynejDAn	gynejdɑn	gynejden
geʧirmAH	geʧirmii	geʧirmei
geʤikmAlH	geʤikmɑli	geʤikmeli
geliʃimsAl	geliʃimsdl	geliʃimsel
gelirDAn	gelirddn	gelirden
genʧlArDA	genʧlɑrdɑ	genʧlerde
gezmA	gezmi	gezme
gururH	gururɯ	gururu
hɑkemlAr	hɑkemlɑr	hɑkemler
hɑrflArHn	hɑrflɑrɯn	hɑrflerin
hɑstɑlɯkDA	hɑstɑlɯkdɑ	hɑstɑlɯktɑ
hɑjɑllAr	hɑjɑllɑr	hɑjɑller
hoʃgørylH	hoʃgøryli	hoʃgøryly
hukukDA	hukukdɑ	hukuktɑ
iʃleDHklArH	iʃlediklɑri	iʃledikleri
ihɑlelAr	ihɑlelɑr	ihɑleler
istemlArH	istemlɑri	istemleri
køpryHn	køpryin	køpryyn
kɑlDHkDAn	kɑldɯkdɑn	kɑldɯktɑn
kɑpDA	kɑpdɑ	kɑptɑ
kɑjbetmAH	kɑjbetmɑi	kɑjbetmei
klɑsørH	klɑsøri	klɑsøry
komʃuH	komʃuɯ	komʃuu
kompozisjonH	kompozisjonɯ	kompozisjonu
kurulmHzHn	kurulmɯzɯn	kurulmuzun
myʃterilArnHzA	myʃterilɑrnizd	myʃterilernize
menylArH	menylɑri	menyleri
merkezlArA	merkezlɑrd	merkezlere
oturDHklArH	oturdɯklɑrɯ	oturduklɑrɯ
pɑrtilArHHn	pɑrtilɑriin	pɑrtileriin
prosedyrlArH	prosedyrlɑri	prosedyrleri
risklArA	risklɑrɑ	risklere
ruhHHn	ruhiin	ruhuun
søzlArHHn	søzlɑriin	søzleriin
sɑbɑhDAn	sɑbɑhdɑn	sɑbɑhtɑn
seʧeneklArDAn	seʧeneklɑrddn	seʧeneklerden
sevgilHlAr	sevgililɑr	sevgililer
teʤrybelArH	teʤrybelɑri	teʤrybeleri
teoremlArH	teoremlɑri	teoremleri
ujgulɑmADA	ujgulɑmɑdɑ	ujgulɑmɑtɑ
zenginlHklArH	zenginliklɑri	zenginlikleri
ʧøpA	ʧøpɑ	ʧøpe
ʧɑlɯʃAbilmAH	ʧɑlɯʃɑbilmɑi	ʧɑlɯʃɑbilmei
ʧiftlAr	ʧiftlɑr	ʧiftler
øɰrenDHklArH	øɰrendiklɑri	øɰrendikleri
ønlemlArA	ønlemlɑrd	ønlemlere
bildirimlAr	bildirimlɑr	bildirimler
bileʃenlAr	bileʃenlɑr	bileʃenler
bilimlArDA	bilimlɑrdɑ	bilimlerde
dyʃmAA	dyʃmɑɑ	dyʃmee
dyzejlArA	dyzejlɑrɑ	dyzejlere
deɰerDAn	deɰerddn	deɰerden
deɰerlArDAn	deɰerlɑrdɑn	deɰerlerden
deɰiʃiklHklArnA	deɰiʃikliklɑrnd	deɰiʃikliklerne
dekorɑsjonH	dekorɑsjonɯ	dekorɑsjonu
delillArHn	delillɑrin	delillerin
denemAA	denemɑi	denemee
devrelArHn	devrelɑrin	devrelerin
dejimlAr	dejimlɑr	dejimler
eɰilimlAr	eɰilimlɑr	eɰilimler
efsɑneA	efsɑneɑ	efsɑnee
enstityHHn	enstityiin	enstityyyn
eserlArDA	eserlɑrdɑ	eserlerde
eskilArA	eskilɑrd	eskilere
formyllArH	formyllɑri	formylleri
gøkjyzyHn	gøkjyzyin	gøkjyzyyn
gyʧlAnmAH	gyʧlɑnmdi	gyʧlenmei
geʧirmADAn	geʧirmdddn	geʧirmeden
gezArAk	gezɑrdk	gezerek
gijmA	gijmɑ	gijme
hɑʤimsAl	hɑʤimsdl	hɑʤimsel
hɑstɑnemHzDA	hɑstɑnemizdɑ	hɑstɑnemizde
hejetA	hejetd	hejete
iʧeriDAn	iʧeridɑn	iʧeriden
kɑbulA	kɑbulɑ	kɑbule
kɑlitelArH	kɑlitelɑri	kɑliteleri
klinikDA	klinikdɑ	klinikte
kurtulHʃH	kurtulɯʃɯ	kurtuluʃu
lɑstiklArH	lɑstiklɑri	lɑstikleri
myʤɑdelelAr	myʤɑdelelɑr	myʤɑdeleler
myejjidelAr	myejjidelɑr	myejjideler
mɑdenlArHn	mɑdenlɑrin	mɑdenlerin
milɑtDAn	milɑtdɑn	milɑttɑn
niteliklArHHn	niteliklɑriin	nitelikleriin
oluklH	oluklɯ	oluklu
operɑtørHn	operɑtørin	operɑtøryn
otH	otɯ	otu
pɑrtilArDAn	pɑrtilɑrdɑn	pɑrtilerden
sytunHn	sytunin	sytunun
soɰukDA	soɰukdɑ	soɰuktɑ
uʧsHz	uʧsɯz	uʧsuz
vɑlilAr	vɑlilɑr	vɑliler
jønergeDA	jønergedi	jønergede
jɑɰmurH	jɑɰmurɯ	jɑɰmuru
jɑklɑʃDHkʧA	jɑklɑʃdɯkʧɑ	jɑklɑʃtɯkʧɑ
jɑzDHkDAn	jɑzdɯkdɑn	jɑzdɯktɑn
jetkilArHHn	jetkilɑriin	jetkileriin
jetkiA	jetkii	jetkie
zeminlArDA	zeminlɑrdɑ	zeminlerde
ʧɯkHʃDA	ʧɯkɯʃdɑ	ʧɯkɯʃtɑ
ʧɑmurH	ʧɑmurɯ	ʧɑmuru
ʧekerlAr	ʧekerlɑr	ʧekerler
ʧevrelArHn	ʧevrelɑrin	ʧevrelerin
ødeDHklArH	ødediklɑri	ødedikleri
ødevlArH	ødevlɑri	ødevleri
ønʤeliklAr	ønʤeliklɑr	ønʤelikler
ʃehirlArA	ʃehirlɑrɑ	ʃehirlere
yʧnʤHlHk	yʧnʤilik	yʧnʤylyk
yrynDAn	yrynddn	yrynden
ɑktivitelArA	ɑktivitelɑrɑ	ɑktivitelere
ɑlAbilAn	ɑlɑbilɑn	ɑlɑbilen
ɑnneDAn	ɑnnedɑn	ɑnneden
ɑnneA	ɑnneɑ	ɑnnee
ɑnomɑlilArH	ɑnomɑlilɑri	ɑnomɑlileri
ɑvHn	ɑvin	ɑvɯn
ɑvʤɯlHk	ɑvʤɯlik	ɑvʤɯlɯk
ɑzɑlmADA	ɑzɑlmɑdɑ	ɑzɑlmɑtɑ
birejlArHHn	birejlɑriin	birejleriin
birleʃAn	birleʃɑn	birleʃen
blokH	blokɯ	bloku
bonoH	bonoɯ	bonou
ʤumhurijetA	ʤumhurijetɑ	ʤumhurijete
dønyʃymlArH	dønyʃymlɑri	dønyʃymleri
deɰiʃiklHklArDAn	deɰiʃikliklɑrdɑn	deɰiʃikliklerden
derinA	derind	derine
dillArHHn	dillɑriin	dilleriin
eɰitimlArHn	eɰitimlɑrin	eɰitimlerin
eʃlArH	eʃlɑri	eʃleri
elbetDAki	elbetddki	elbetteki
etiketlAr	etiketlɑr	etiketler
evrelArH	evrelɑri	evreleri
fɑkyltelArn	fɑkyltelɑrn	fɑkyltelern
gørynymDA	gørynymdi	gørynymde
gørDHkʧA	gørdikʧɑ	gørdykʧe
gøzHHn	gøziin	gøzyyn
gylArAk	gylɑrɑk	gylerek
gyvenArAk	gyvenɑrdk	gyvenerek
gelmAmAH	gelmɑmɑi	gelmemei
gereksinimlAr	gereksinimlɑr	gereksinimler
hykymlHHn	hykymliin	hykymlyyn
hɑdiselAr	hɑdiselɑr	hɑdiseler
hɑlHHn	hɑlɯɯn	hɑliin
hɑrflH	hɑrflɯ	hɑrfli
hɑvuzlArH	hɑvuzlɑri	hɑvuzlɑrɯ
ilgilHlArH	ilgililɑri	ilgilileri
istɑsjonHHn	istɑsjonɯɯn	istɑsjonuun
køjlHlArH	køjlɯlɑri	køjlyleri
kyʧyklAr	kyʧyklɑr	kyʧykler
kimDAn	kimdɑn	kimden
kimseDAn	kimseddn	kimseden
klɑsørHn	klɑsørin	klɑsøryn
kuʃH	kuʃɯ	kuʃu
kuvvetA	kuvveti	kuvvete
myzeDA	myzedi	myzede
memleketmHzDA	memleketmizdɑ	memleketmizde
merʤilAr	merʤilɑr	merʤiler
mejvelArHn	mejvelɑrin	mejvelerin
molekyllArH	molekyllɑri	molekylleri
neDA	nedɑ	nede
netiʤelAr	netiʤelɑr	netiʤeler
otomobillAr	otomobillɑr	otomobiller
prosedyrlAr	prosedyrlɑr	prosedyrler
syslAAn	sysldɑn	sysleen
senelAr	senelɑr	seneler
sitelArA	sitelɑrɑ	sitelere
typlAr	typlɑr	typler
tɑbloHHn	tɑbloɯɯn	tɑblouun
tɑvizlAr	tɑvizlɑr	tɑvizler
teʃekkyrlArmH	teʃekkyrlɑrmi	teʃekkyrlermi
teʤɑvyzA	teʤɑvyzd	teʤɑvyze
tehditlAr	tehditlɑr	tehditler
vɑzgeʧmA	vɑzgeʧmɑ	vɑzgeʧme
vurulAn	vuruldn	vurulɑn
jønlArDAn	jønlɑrdɑn	jønlerden
jyryHʃlArH	jyryiʃlɑri	jyryyʃleri
jyzlAr	jyzlɑr	jyzler
jɑhudilArHn	jɑhudilɑrin	jɑhudilerin
jɑrɑtDHklArH	jɑrɑtdɯklɑrɯ	jɑrɑttɯklɑrɯ
jenilHklArDAn	jeniliklɑrdɑn	jeniliklerden
ʧɑlɯʃAbilAn	ʧɑlɯʃɑbilɑn	ʧɑlɯʃɑbilen
ʧeklArHn	ʧeklɑrin	ʧeklerin
ʧeliʃkilAr	ʧeliʃkilɑr	ʧeliʃkiler
ødylHn	ødylin	ødylyn
ødeneklArH	ødeneklɑri	ødenekleri
øzetlAmA	øzetlɑmɑ	øzetleme
yretiʤiA	yretiʤii	yretiʤie
yzylArAk	yzylɑrdk	yzylerek
ɑʧDHklArH	ɑʧdɯklɑrɯ	ɑʧtɯklɑrɯ
ɑʤentelArH	ɑʤentelɑri	ɑʤenteleri
ɑdɑptørH	ɑdɑptøri	ɑdɑptøry
ɑdetlArH	ɑdetlɑri	ɑdetleri
ɑrɑlɯkDA	ɑrɑlɯkdɑ	ɑrɑlɯktɑ
bɑroHn	bɑroɯn	bɑroun
birejlArDAn	birejlɑrdɑn	birejlerden
bitymlH	bitymli	bitymly
dɯʃDA	dɯʃdɑ	dɯʃtɑ
dønyʃymlAr	dønyʃymlɑr	dønyʃymler
dønAlHm	dønɑlim	dønelim
dønerlAr	dønerlɑr	dønerler
delegelArHn	delegelɑrin	delegelerin
dillArA	dillɑrɑ	dillere
dizinA	dizind	dizine
durHʃH	durɯʃɯ	duruʃu
elimDAki	elimddki	elimdeki
erDAn	erddn	erden
fɑɑlijetlArDAn	fɑɑlijetlɑrdɑn	fɑɑlijetlerden
gøvdelArH	gøvdelɑri	gøvdeleri
gylymseArAk	gylymseɑrdk	gylymseerek
geʧmAlArH	geʧmɑlɑri	geʧmeleri
geʤikmADAn	geʤikmdddn	geʤikmeden
hizmetnHzDA	hizmetnizdɑ	hizmetnizde
hizmetlArmHzH	hizmetlɑrmizi	hizmetlermizi
ihɑlelArA	ihɑlelɑrɑ	ihɑlelere
ilgiA	ilgii	ilgie
illArDAki	illɑrddki	illerdeki
inmA	inmd	inme
kɯjɑfetlAr	kɯjɑfetlɑr	kɯjɑfetler
kømyrlArHn	kømyrlɑrin	kømyrlerin
kɑbloHn	kɑbloɯn	kɑbloun
kɑrelAr	kɑrelɑr	kɑreler
kɑtegoriA	kɑtegoriɑ	kɑtegorie
kitɑpDAki	kitɑpdɑki	kitɑptɑki
korkuHn	korkuɯn	korkuun
meʤlisDAn	meʤlisdɑn	meʤlisten
motiflArH	motiflɑri	motifleri
nøbetlAr	nøbetlɑr	nøbetler
oluʃumHn	oluʃumɯn	oluʃumun
poliplAr	poliplɑr	polipler
sevDHklArH	sevdiklɑri	sevdikleri
sonunʤuH	sonunʤuɯ	sonunʤuu
sorunmHz	sorunmɯz	sorunmuz
strɑteʒilArHHn	strɑteʒilɑriin	strɑteʒileriin
tyrDAki	tyrddki	tyrdeki
tɑrifeA	tɑrifeɑ	tɑrifee
teʃebbyslArH	teʃebbyslɑri	teʃebbysleri
tezlArH	tezlɑri	tezleri
uʧurumHn	uʧurumɯn	uʧurumun
umutlH	umutlɯ	umutlu
ujumsHzlHk	ujumsɯzlɯk	ujumsuzluk
vermAmHz	vermɑmiz	vermemiz
jyzAr	jyzɑr	jyzer
jenilAʃmA	jenildʃmɑ	jenileʃme
ʧevrenHzDA	ʧevrenizdi	ʧevrenizde
ʧiftʧilArHn	ʧiftʧilɑrin	ʧiftʧilerin
øɰrenArAk	øɰrenɑrdk	øɰrenerek
ɑdresDA	ɑdresdɑ	ɑdreste
ɑktivitelArHn	ɑktivitelɑrin	ɑktivitelerin
ɑlemDA	ɑlemdɑ	ɑlemde
ɑntrenørH	ɑntrenøri	ɑntrenøry
ɑrɑzilArDA	ɑrɑzilɑrdɑ	ɑrɑzilerde
bɑʃsɑvʤɯH	bɑʃsɑvʤɯi	bɑʃsɑvʤɯɯ
bɑʃvurulArHHn	bɑʃvurulɑriin	bɑʃvurulɑrɯɯn
bɑsitʧA	bɑsitʧɑ	bɑsitʧe
bedellAr	bedellɑr	bedeller
belgelAAn	belgelddn	belgeleen
besinlArH	besinlɑri	besinleri
ʤinsAllHk	ʤinsdllik	ʤinsellik
ʤinsDAn	ʤinsddn	ʤinsten
defterlArHn	defterlɑrin	defterlerin
denetimlArDA	denetimlɑrdɑ	denetimlerde
denetlAAn	denetlddn	denetleen
devirlArDA	devirlɑrdɑ	devirlerde
eɰitimlArHHn	eɰitimlɑriin	eɰitimleriin
esinlAnArAk	esinlɑnɑrɑk	esinlenerek
etkilAnmAH	etkilɑnmɑi	etkilenmei
fɑkylteDAn	fɑkyltedɑn	fɑkylteden
gøryʃlArmHzH	gøryʃlɑrmizi	gøryʃlermizi
gyʧsHzlHk	gyʧsizlik	gyʧsyzlyk
gyryltyH	gyryltyi	gyryltyy
geleʤeklAr	geleʤeklɑr	geleʤekler
kɑmpusH	kɑmpusɯ	kɑmpusu
kɑtDAki	kɑtdɑki	kɑttɑki
klorlH	klorlɯ	klorlu
kontrolHn	kontrolɯn	kontrolyn
konutHn	konutɯn	konutun
liderlArHn	liderlɑrin	liderlerin
myʃterilArnHzHn	myʃterilɑrnizin	myʃterilernizin
miljonHn	miljonɯn	miljonun
nesillArHn	nesillɑrin	nesillerin
nesnelArA	nesnelɑrd	nesnelere
ofislAr	ofislɑr	ofisler
optimizɑsjonH	optimizɑsjonɯ	optimizɑsjonu
protokolHn	protokolɯn	protokolyn
søzleʃmelArHHn	søzleʃmelɑriin	søzleʃmeleriin
sɑɑtlArA	sɑɑtlɑrɑ	sɑɑtlere
seminerlArA	seminerlɑrd	seminerlere
sinirlArHn	sinirlɑrin	sinirlerin
sunAbilmA	sunɑbilmd	sunɑbilme
sunuʤuHn	sunuʤuɯn	sunuʤuun
tymørH	tymøri	tymøry
tyrkylArH	tyrkylɑri	tyrkyleri
tytynlArA	tytynlɑrd	tytynlere
tɑkvimDA	tɑkvimdɑ	tɑkvimde
teʃviklAr	teʃviklɑr	teʃvikler
turizmDA	turizmdɑ	turizmde
tutAbilmA	tutɑbilmd	tutɑbilme
tutHʃ	tutɯʃ	tutuʃ
tutukluHn	tutukluɯn	tutukluun
ulɑʃDHkDAn	ulɑʃdɯkdɑn	ulɑʃtɯktɑn
unutHp	unutɯp	unutup
jønetimDAn	jønetimddn	jønetimden
jyrytmeA	jyrytmei	jyrytmee
jyzdelArH	jyzdelɑri	jyzdeleri
ʧizimA	ʧizimd	ʧizime
ynitelArHn	ynitelɑrin	ynitelerin
ɑnɑlizA	ɑnɑlizɑ	ɑnɑlize
byjyHp	byjyip	byjyyp
bɑʃørtyH	bɑʃørtyi	bɑʃørtyy
bɑsɑmɑkDA	bɑsɑmɑkdɑ	bɑsɑmɑktɑ
belirtmA	belirtmd	belirtme
biʧimlAr	biʧimlɑr	biʧimler
birejlArDA	birejlɑrdɑ	birejlerde
ʤepheDAn	ʤepheddn	ʤepheden
ʤepheA	ʤephei	ʤephee
ʤiroH	ʤiroi	ʤirou
dɑvetA	dɑvetɑ	dɑvete
depresjonH	depresjonɯ	depresjonu
dikilAn	dikildn	dikilen
disketA	disketd	diskete
eʤzɑnelArDA	eʤzɑnelɑrdɑ	eʤzɑnelerde
enzimlArHn	enzimlɑrin	enzimlerin
etkilAmHʃ	etkilɑmiʃ	etkilemiʃ
gørynmAH	gørynmdi	gørynmei
gøtyrmA	gøtyrmd	gøtyrme
gynʤellAnmAH	gynʤellɑnmɑi	gynʤellenmei
gynlH	gynli	gynly
geʤikmAlAr	geʤikmɑlɑr	geʤikmeler
gereksinmA	gereksinmd	gereksinme
gitmADA	gitmddɑ	gitmete
hɑllArA	hɑllɑrɑ	hɑllere
hizmetnHzA	hizmetnizd	hizmetnize
ikiDAn	ikidɑn	ikiden
køjlArDAn	køjlɑrdɑn	køjlerden
kyltyrDA	kyltyrdd	kyltyrde
kymelAr	kymelɑr	kymeler
kɑlɯnlHkDA	kɑlɯnlɯkdɑ	kɑlɯnlɯktɑ
kɑpɑsitelArHHn	kɑpɑsitelɑriin	kɑpɑsiteleriin
kemiklArDA	kemiklɑrdɑ	kemiklerde
kirletAn	kirletdn	kirleten
korkulH	korkulɯ	korkulu
koroH	koroɯ	korou
koruHp	koruɯp	koruup
motivɑsjonH	motivɑsjonɯ	motivɑsjonu
nɑmuslH	nɑmuslɯ	nɑmuslu
normɑlHn	normɑlɯn	normɑlin
oluʃumHHn	oluʃumɯɯn	oluʃumuun
resimlArA	resimlɑrɑ	resimlere
rezeksijonH	rezeksijonɯ	rezeksijonu
rolHHn	rolɯɯn	rolyyn
søzleʃmelArA	søzleʃmelɑrɑ	søzleʃmelere
sɑɰlɑmADAn	sɑɰlɑmɑdɑn	sɑɰlɑmɑtɑn
sɑhilDA	sɑhildɑ	sɑhilde
sembollArH	sembollɑrɯ	sembolleri
senɑrjoH	senɑrjoɯ	senɑrjou
simgelAr	simgelɑr	simgeler
simgelAAn	simgelddn	simgeleen
stɑtyA	stɑtyɑ	stɑtye
temelDAn	temelddn	temelden
tempoH	tempoi	tempou
tenʤereDA	tenʤeredi	tenʤerede
uzunlukDA	uzunlukdɑ	uzunluktɑ
vermAlH	vermɑli	vermeli
jyklAnHʤHA	jykldniʤii	jykleniʤie
jyrymAH	jyrymdi	jyrymei
jetiʃmAH	jetiʃmɑi	jetiʃmei
jollH	jollɯ	jollu
ʧiftʧiA	ʧiftʧii	ʧiftʧie
ønemlHlArH	ønemlilɑri	ønemlileri
øzetlAr	øzetlɑr	øzetler
ʃekillArHn	ʃekillɑrin	ʃekillerin
ylkemHzDAn	ylkemizddn	ylkemizden
yniversitelArHHn	yniversitelɑriin	yniversiteleriin
ɑnɑlizDA	ɑnɑlizdɑ	ɑnɑlizde
ɑjrɯlDHkDAn	ɑjrɯldɯkdɑn	ɑjrɯldɯktɑn
byjyklArHn	byjyklɑrin	byjyklerin
beklAnmAH	beklɑnmɑi	beklenmei
belirlemAH	belirlemdi	belirlemei
bilAlHm	bilɑlim	bilelim
ʤɑmilAr	ʤɑmilɑr	ʤɑmiler
døllAnmA	døllɑnmɑ	døllenme
dønHnʤA	døninʤɑ	dønynʤe
dyzenlemAlArDA	dyzenlemɑlɑrdi	dyzenlemelerde
deɰiʃmADA	deɰiʃmɑdɑ	deɰiʃmete
deɰiʃmAlArH	deɰiʃmɑlɑri	deɰiʃmeleri
deliklAr	deliklɑr	delikler
depremlArH	depremlɑri	depremleri
deriDAn	deridɑn	deriden
desteklAmAA	desteklɑmɑɑ	desteklemee
dinleArAk	dinleɑrɑk	dinleerek
dolHp	dolɯp	dolup
dostmHz	dostmɯz	dostmuz
efektlAr	efektlɑr	efektler
ekonomilAr	ekonomilɑr	ekonomiler
ekonomilArH	ekonomilɑri	ekonomileri
ellArnHzH	ellɑrnizi	ellernizi
etkilAmAH	etkilɑmɑi	etkilemei
formyllAr	formyllɑr	formyller
gøkjyzynH	gøkjyzyni	gøkjyzyny
gøndermAA	gøndermɑi	gøndermee
gørevlHlArA	gørevlilɑri	gørevlilere
gørmAHn	gørmɑin	gørmein
gøvdeA	gøvdei	gøvdee
geʤikmAH	geʤikmii	geʤikmei
geniʃlAmHʃ	geniʃlɑmiʃ	geniʃlemiʃ
gerekAnH	gerekɑni	gerekeni
girmAnHzDAn	girmdnizdɑn	girmenizden
grɑfikDA	grɑfikdɑ	grɑfikte
hɑjɑllArH	hɑjɑllɑrɯ	hɑjɑlleri
hisselAr	hisselɑr	hisseler
hisselArHn	hisselɑrin	hisselerin
hitlAr	hitlɑr	hitler
iʧmHzA	iʧmizd	iʧmize
ijilAʃmAH	ijildʃmɑɯ	ijileʃmei
kɑrɑrnɑmelAr	kɑrɑrnɑmelɑr	kɑrɑrnɑmeler
kɑtegorilAr	kɑtegorilɑr	kɑtegoriler
krizlArHn	krizlɑrin	krizlerin
kullHk	kullɯk	kulluk
myesseselArH	myesseselɑri	myesseseleri
mɑlijetA	mɑlijetɑ	mɑlijete
merdivenlAr	merdivenlɑr	merdivenler
mezunlArHn	mezunlɑrin	mezunlɑrɯn
pɑrlɑmentoHn	pɑrlɑmentoin	pɑrlɑmentoun
proseslArH	proseslɑri	prosesleri
syrymlArH	syrymlɑri	syrymleri
sɑɰlAnmADA	sɑɰlɑnmɑdɑ	sɑɰlɑnmɑtɑ
seslArHHn	seslɑriin	sesleriin
sinyslAr	sinyslɑr	sinysler
testlArDA	testlɑrdɑ	testlerde
testlArHHn	testlɑriin	testleriin
torunH	torunɯ	torunu
ujumsHz	ujumsɯz	ujumsuz
velilArHn	velilɑrin	velilerin
jyksekøɰretimA	jyksekøɰretimd	jyksekøɰretime
jyzejDAn	jyzejdɑn	jyzejden
jɑrɯʃDA	jɑrɯʃdɑ	jɑrɯʃtɑ
ʃɑrtnɑmeDA	ʃɑrtnɑmedɑ	ʃɑrtnɑmede
ʃubelArA	ʃubelɑrɑ	ʃubelere
ɑɰɑʧDAn	ɑɰɑʧdɑn	ɑɰɑʧtɑn
bɑnjoH	bɑnjoɯ	bɑnjou
bebeklArA	bebeklɑrd	bebeklere
benA	bend	bene
bitmAAn	bitmɑɑn	bitmeen
bizlerDAn	bizlerddn	bizlerden
ʤinɑjetlAr	ʤinɑjetlɑr	ʤinɑjetler
døkmA	døkmɑ	døkme
dønemlArHn	dønemlɑrin	dønemlerin
dyʃmA	dyʃmɑ	dyʃme
dynA	dynd	dyne
deriA	derii	derie
desteklAmAH	desteklɑmɑi	desteklemei
dolulHk	dolulɯk	doluluk
dujuH	dujui	dujuu
eleʃtirAn	eleʃtirdn	eleʃtiren
evlenmA	evlenmd	evlenme
fertlArHn	fertlɑrin	fertlerin
filmlArHHn	filmlɑriin	filmleriin
gøryntylAnAn	gøryntylɑndn	gøryntylenen
gøryH	gøryi	gøryy
gørmAnHz	gørmɑnɯz	gørmeniz
gøzlAnmAH	gøzlɑnmɑɯ	gøzlenmei
gynlArHHn	gynlɑriin	gynleriin
gyzellHklArHn	gyzelliklɑrin	gyzelliklerin
geleneklAr	geleneklɑr	gelenekler
geniʃlikDA	geniʃlikdi	geniʃlikte
gibilAr	gibilɑr	gibiler
gijAn	gijdn	gijen
hɑmmɑddelArHn	hɑmmɑddelɑrin	hɑmmɑddelerin
iletAn	iletdn	ileten
ilgiDAn	ilgidɑn	ilgiden
ilgilenmA	ilgilenmd	ilgilenme
kyrlAʃAn	kyrldʃɑn	kyrleʃen
kytyphɑnelArHn	kytyphɑnelɑrin	kytyphɑnelerin
kɑbulnH	kɑbulnɯ	kɑbulny
kɑdemeDAki	kɑdemeddki	kɑdemedeki
kɑdroHHn	kɑdroɯɯn	kɑdrouun
kɑlemlArHHn	kɑlemlɑriin	kɑlemleriin
kɑtegorilArH	kɑtegorilɑri	kɑtegorileri
kemerlArH	kemerlɑri	kemerleri
koʃullH	koʃullɯ	koʃullu
konserDA	konserdɑ	konserde
kriterlArHn	kriterlɑrin	kriterlerin
kurtulHp	kurtulɯp	kurtulup
lɑstiklArHn	lɑstiklɑrin	lɑstiklerin
lezjonH	lezjonɯ	lezjonu
listelArDA	listelɑrdɑ	listelerde
mydyrlArHHn	mydyrlɑriin	mydyrleriin
mydɑhɑleA	mydɑhɑleɑ	mydɑhɑlee
myrɑʤɑɑtDA	myrɑʤɑɑtdɑ	myrɑʤɑɑttɑ
myzɑkerelArH	myzɑkerelɑri	myzɑkereleri
modylɑsjonH	modylɑsjonɯ	modylɑsjonu
notHn	notɯn	notun
oʤɑkDA	oʤɑkdɑ	oʤɑktɑ
ortɑlɯkDA	ortɑlɯkdɑ	ortɑlɯktɑ
otobysH	otobysi	otobysy
otobysA	otobysd	otobyse
pɑrsellArHn	pɑrsellɑrin	pɑrsellerin
pulH	pulɯ	pulu
reʧetelArHn	reʧetelɑrin	reʧetelerin
rekorH	rekorɯ	rekoru
søjleHnʤA	søjleinʤd	søjleinʤe
sytunlArH	sytunlɑri	sytunlɑrɯ
senɑtoHn	senɑtoɯn	senɑtoun
sijɑsilAr	sijɑsilɑr	sijɑsiler
tɑhlillArH	tɑhlillɑri	tɑhlilleri
toplummHz	toplummɯz	toplummuz
turlH	turlɯ	turlu
verAʤAklAr	verɑʤdklɑr	vereʤekler
jykselDHkʧA	jykseldikʧɑ	jykseldikʧe
jyrytmADA	jyrytmddɑ	jyrytmete
jolsuzlHklArHn	jolsuzlɯklɑrɯn	jolsuzluklɑrɯn
zeminlAr	zeminlɑr	zeminler
zijɑretʧHlArH	zijɑretʧilɑri	zijɑretʧileri
ʧøkHʃ	ʧøkiʃ	ʧøkyʃ
ʧøzymlAmAH	ʧøzymlɑmɑi	ʧøzymlemei
ʧekmADA	ʧekmddɑ	ʧekmete
ʧekDHklArH	ʧekdiklɑri	ʧektikleri
ølymsHz	ølymsiz	ølymsyz
ølHnʤAA	ølinʤdɑ	ølynʤee
ønlemAHn	ønlemdin	ønlemein
øzgyrlHklArHHn	øzgyrliklɑriin	øzgyrlykleriin
ɑʧmADA	ɑʧmɑdɑ	ɑʧmɑtɑ
ɑlɯʃveriʃlArDA	ɑlɯʃveriʃlɑrdɑ	ɑlɯʃveriʃlerde
ɑmirlAr	ɑmirlɑr	ɑmirler
ɑnɑdilDA	ɑnɑdildɑ	ɑnɑdilde
bølmA	bølmɑ	bølme
bɑʃlɯkDA	bɑʃlɯkdɑ	bɑʃlɯktɑ
birikimlArH	birikimlɑri	birikimleri
bitHnʤAA	bitinʤdɑ	bitinʤee
bulHʃlAr	bulɯʃlɑr	buluʃlɑr
ʤemijetlAr	ʤemijetlɑr	ʤemijetler
ʤinsijetA	ʤinsijetd	ʤinsijete
dyzeltmAA	dyzeltmdi	dyzeltmee
deɰiʃiklHklArHHn	deɰiʃikliklɑriin	deɰiʃiklikleriin
dengeA	dengei	dengee
dileAn	dileɑn	dileen
doɰHp	doɰɯp	doɰup
eleʃtirilArA	eleʃtirilɑrd	eleʃtirilere
enstitylAr	enstitylɑr	enstityler
enstitymHz	enstitymiz	enstitymyz
eserlArA	eserlɑrd	eserlere
etDHkʧA	etdikʧɑ	ettikʧe
fɑizlArHn	fɑizlɑrin	fɑizlerin
fɑktørHHn	fɑktøriin	fɑktøryyn
felɑketA	felɑketɑ	felɑkete
gønyllylAr	gønyllylɑr	gønyllyler
gøndermAH	gøndermdi	gøndermei
gørevlHA	gørevlii	gørevlie
geʧDHklArH	geʧdiklɑri	geʧtikleri
geliʃDHkʧA	geliʃdikʧɑ	geliʃtikʧe
grevlArH	grevlɑri	grevleri
hykymetʧA	hykymetʧɑ	hykymetʧe
hɑkikɑtH	hɑkikɑtɯ	hɑkikɑti
hɑlDAki	hɑldɑki	hɑldeki
hukukʧHlAr	hukukʧilɑr	hukukʧulɑr
iʃverenlArHn	iʃverenlɑrin	iʃverenlerin
inDA	indd	inde
internetDAki	internetddki	internetteki
istekDA	istekdi	istekte
itAn	itɑn	iten
køjlArHHn	køjlɑrɯɯn	køjleriin
kyʧylAn	kyʧylɑn	kyʧylen
kɑjdetmA	kɑjdetmɑ	kɑjdetme
kesitlArDA	kesitlɑrdɑ	kesitlerde
kiliseA	kilisei	kilisee
kriterlArHHn	kriterlɑriin	kriterleriin
lekelArH	lekelɑri	lekeleri
myzɑkerelArA	myzɑkerelɑrɑ	myzɑkerelere
mɑɰdurH	mɑɰdurɯ	mɑɰduru
metinlArDA	metinlɑrdɑ	metinlerde
misjonmHz	misjonmɯz	misjonmuz
modelDAn	modeldɑn	modelden
otobyslAr	otobyslɑr	otobysler
potɑnsijellArH	potɑnsijellɑri	potɑnsijelleri
profesjonellAr	profesjonellɑr	profesjoneller
sɑntrɑllArH	sɑntrɑllɑrɯ	sɑntrɑlleri
tɑhɑkkukH	tɑhɑkkukɯ	tɑhɑkkuku
tepkilArHn	tepkilɑrin	tepkilerin
tespitlAr	tespitlɑr	tespitler
tipDAki	tipddki	tipteki
verAbilmAH	veribilmdi	verebilmei
verHnʤA	verinʤd	verinʤe
vitɑminlAr	vitɑminlɑr	vitɑminler
jønetmAA	jønetmɑɑ	jønetmee
jyrytDHklArH	jyrytdiklɑri	jyryttykleri
jokDAn	jokdɑn	joktɑn
ʧyrymA	ʧyrymd	ʧyryme
ʧevrelArDA	ʧevrelɑrdɑ	ʧevrelerde
ʧevremHzDA	ʧevremizdi	ʧevremizde
ølʧAn	ølʧɑn	ølʧen
ølymlArHHn	ølymlɑriin	ølymleriin
ønerilArA	ønerilɑrd	ønerilere
ørtyHHn	ørtyiin	ørtyyyn
ʃebekeA	ʃebekei	ʃebekee
ʃiʃirmA	ʃiʃirmi	ʃiʃirme
yrynmHz	yrynmiz	yrynmyz
ɑktivitelArHHn	ɑktivitelɑriin	ɑktiviteleriin
bytynHn	bytynin	bytynyn
bɑhʧelArDA	bɑhʧelɑrdɑ	bɑhʧelerde
bojHHn	bojɯin	bojuun
bozuklHklArHn	bozuklɯklɑrɯn	bozukluklɑrɯn
bulunmADAn	bulunmɑdɑn	bulunmɑtɑn
ʤymleDA	ʤymledi	ʤymlede
dyɰmelArH	dyɰmelɑri	dyɰmeleri
dyʃynʤeDA	dyʃynʤedi	dyʃynʤede
dyzenlAnmADA	dyzenlɑnmddɑ	dyzenlenmete
deɰerlendirmAlArnH	deɰerlendirmɑlɑrni	deɰerlendirmelerni
demokrɑsilArDA	demokrɑsilɑrdɑ	demokrɑsilerde
denetʧilArHn	denetʧilɑrin	denetʧilerin
desteklAArAk	desteklɑɑrɑk	destekleerek
eklAnHnʤA	ekldninʤd	ekleninʤe
ekDAki	ekddki	ekteki
elementlArH	elementlɑri	elementleri
emperjɑlizmA	emperjɑlizmɑ	emperjɑlizme
engellAArAk	engellɑɑrɑk	engelleerek
etmADHklArH	etmddiklɑri	etmedikleri
gøryʃHp	gøryʃip	gøryʃyp
gynʤellAnAn	gynʤellɑndn	gynʤellenen
gelirA	geliri	gelire
hɑvuzlH	hɑvuzli	hɑvuzlu
ilgilenmAA	ilgilenmdi	ilgilenmee
ipA	ipɑ	ipe
isteklArnHzH	isteklɑrnizi	isteklernizi
istemlAr	istemlɑr	istemler
izlAnArAk	izlɑnɑrɑk	izlenerek
kɑrɑʤiɰerDA	kɑrɑʤiɰerdɑ	kɑrɑʤiɰerde
kɑrɑjoluHn	kɑrɑjoluɯn	kɑrɑjoluun
kesintilArH	kesintilɑri	kesintileri
kulɑkDAki	kulɑkdɑki	kulɑktɑki
liseDA	lisedɑ	lisede
myʃɑvirlAr	myʃɑvirlɑr	myʃɑvirler
myesseselArHn	myesseselɑrin	myesseselerin
myziklArH	myziklɑri	myzikleri
medenijetlAr	medenijetlɑr	medenijetler
okuDHklArH	okudɯklɑrɯ	okuduklɑrɯ
rehɑbilitɑsjonH	rehɑbilitɑsjonɯ	rehɑbilitɑsjonu
resimlArDA	resimlɑrdɑ	resimlerde
resulH	resuli	resuly
syryʤyA	syryʤyi	syryʤye
seʧimlArHHn	seʧimlɑriin	seʧimleriin
tɑnɯmlAmADA	tɑnɯmlɑmɑdɑ	tɑnɯmlɑmɑtɑ
tɑnelArH	tɑnelɑri	tɑneleri
tɑriflArH	tɑriflɑri	tɑrifleri
tɑvlH	tɑvli	tɑvlɯ
telefonHHn	telefonɯɯn	telefonuun
terminɑllAr	terminɑllɑr	terminɑller
tesislArmHzDA	tesislɑrmizdɑ	tesislermizde
tutkuH	tutkuɯ	tutkuu
tuzlHlHk	tuzlɯlɯk	tuzluluk
vermAksHzHn	vermdksizin	vermeksizin
jyklArHn	jyklɑrin	jyklerin
jɑɰmurHn	jɑɰmurɯn	jɑɰmurun
ʧɑmurlH	ʧɑmurlɯ	ʧɑmurlu
ʧekirdeklArH	ʧekirdeklɑri	ʧekirdekleri
ʧimlAnmA	ʧimlɑnmd	ʧimlenme
ølʧylArA	ølʧylɑrd	ølʧylere
ølymHHn	ølymiin	ølymyyn
øzyrlylArHn	øzyrlylɑrin	øzyrlylerin
ʃehirA	ʃehird	ʃehire
ʃehirlAʃmA	ʃehirldʃmɑ	ʃehirleʃme
ʃiirA	ʃiird	ʃiire
ʃikɑjetDA	ʃikɑjetdɑ	ʃikɑjette
ʃubeDA	ʃubedɑ	ʃubede
ɑilelArDA	ɑilelɑrdɑ	ɑilelerde
ɑlemA	ɑlemd	ɑleme
ɑlejhDA	ɑlejhdɑ	ɑlejhte
ɑnomɑlilAr	ɑnomɑlilɑr	ɑnomɑliler
bollHk	bollɯk	bolluk
bojutlArHHn	bojutlɑrɯin	bojutlɑrɯɯn
dyʃynʤelArHHn	dyʃynʤelɑriin	dyʃynʤeleriin
dersnDAn	dersnddn	dersnden
dujgulH	dujguli	dujgulu
eklemlArDA	eklemlɑrdɑ	eklemlerde
etkenlArH	etkenlɑri	etkenleri
evnHzDAki	evnizddki	evnizdeki
evlArDAn	evlɑrdɑn	evlerden
fiillArH	fiillɑri	fiilleri
gørAbiljor	gørɑbiljor	gørebiljor
gylymsemA	gylymsemi	gylymseme
gynlAnmAH	gynlɑnmdi	gynlenmei
gytmAAn	gytmɑdn	gytmeen
gyzellHkDA	gyzellikdi	gyzellikte
geliʃimA	geliʃimi	geliʃime
geniʃlAr	geniʃlɑr	geniʃler
girmAnHzH	girmdnizi	girmenizi
hɑrʧDAn	hɑrʧdɑn	hɑrʧtɑn
iletilAr	iletilɑr	iletiler
indirimlArH	indirimlɑri	indirimleri
kykyrtlH	kykyrtli	kykyrtly
kɑbilijetlArH	kɑbilijetlɑri	kɑbilijetleri
kɑlelArH	kɑlelɑri	kɑleleri
kɑleA	kɑleɑ	kɑlee
kɑrdeʃlArH	kɑrdeʃlɑri	kɑrdeʃleri
kimselArH	kimselɑri	kimseleri
kodHn	kodɯn	kodun
kujuH	kujui	kujuu
lyzumsHz	lyzumsiz	lyzumsuz
lɑstiklAr	lɑstiklɑr	lɑstikler
listelAnmAH	listelɑnmɑi	listelenmei
myfettiʃlArH	myfettiʃlɑri	myfettiʃleri
mevsimA	mevsimi	mevsime
milletlArH	milletlɑri	milletleri
mitingA	mitingi	mitinge
ofisDA	ofisdɑ	ofiste
okʧH	okʧɯ	okʧu
otelDAn	oteldɑn	otelden
reʧeteA	reʧetei	reʧetee
reflekslArH	reflekslɑri	refleksleri
rezervA	rezervi	rezerve
syrgynA	syrgynd	syrgyne
syzylAn	syzyldn	syzylen
seʧmAlArH	seʧmɑlɑri	seʧmeleri
simylɑsjonH	simylɑsjonɯ	simylɑsjonu
strɑteʒilArHn	strɑteʒilɑrin	strɑteʒilerin
tymørlArH	tymørlɑri	tymørleri
vɑlilHklArA	vɑliliklɑrɑ	vɑliliklere
vɑzifelArH	vɑzifelɑri	vɑzifeleri
jenArAk	jenɑrɑk	jenerek
jeteneklAr	jeteneklɑr	jetenekler
joɰunlHkDA	joɰunlɯkdɑ	joɰunluktɑ
ʧøzAʤAk	ʧøzɑʤɑk	ʧøzeʤek
ʧetelAr	ʧetelɑr	ʧeteler
øɰelArHn	øɰelɑrin	øɰelerin
øɰretmenlArmHz	øɰretmenlɑrmiz	øɰretmenlermiz
ølDHkDAn	øldikdɑn	øldykten
øzgyrlHklArA	øzgyrliklɑri	øzgyrlyklere
ɑsgɑriA	ɑsgɑriɑ	ɑsgɑrie
bɯrɑkDHklArH	bɯrɑkdɯklɑrɯ	bɯrɑktɯklɑrɯ
bɑʃørtylH	bɑʃørtyli	bɑʃørtyly
belA	belɑ	bele
belgelAmA	belgelɑmɑ	belgeleme
bezlArHHn	bezlɑriin	bezleriin
bildirilArHn	bildirilɑrin	bildirilerin
binAn	bindn	binen
ʤɑmilArHn	ʤɑmilɑrin	ʤɑmilerin
ʤephelArDA	ʤephelɑrdɑ	ʤephelerde
ʤinslArH	ʤinslɑri	ʤinsleri
dyʃHʃH	dyʃiʃɯ	dyʃyʃy
dyʃynʤeDAn	dyʃynʤeddn	dyʃynʤeden
deɰerlendirmAlArDA	deɰerlendirmɑlɑrdɑ	deɰerlendirmelerde
denejlArHn	denejlɑrin	denejlerin
denizlArH	denizlɑri	denizleri
devirlAr	devirlɑr	devirler
devletlArɑrɑsɯ	devletlɑrɑrɑsɯ	devletlerɑrɑsɯ
disiplinlAr	disiplinlɑr	disiplinler
eɰitimDAki	eɰitimddki	eɰitimdeki
emekʧHlArH	emekʧilɑri	emekʧileri
erimA	erimi	erime
erozjonH	erozjonɯ	erozjonu
etkilArDAn	etkilɑrdɑn	etkilerden
etkinliklArDAn	etkinliklɑrddn	etkinliklerden
evrenDA	evrendd	evrende
fertlArHHn	fertlɑriin	fertleriin
gønyllylHk	gønyllylik	gønyllylyk
gøndermAH	gøndermdi	gøndermei
gøryntylArA	gøryntylɑrd	gøryntylere
gøzlArmHn	gøzlɑrmɯn	gøzlermin
gynejDAki	gynejddki	gynejdeki
gɑzeteʤilArH	gɑzeteʤilɑri	gɑzeteʤileri
geʧAlHm	geʧɑlim	geʧelim
hykymsHz	hykymsiz	hykymsyz
hɑngilArH	hɑngilɑri	hɑngileri
hɑvɑHHn	hɑvɑɯin	hɑvɑɯɯn
hemʃehrilArmHzHn	hemʃehrilɑrmizin	hemʃehrilermizin
iʃɑretlArHn	iʃɑretlɑrin	iʃɑretlerin
iʃgyʤyHn	iʃgyʤyin	iʃgyʤyyn
iʃlevlArHHn	iʃlevlɑriin	iʃlevleriin
iʃlevsAllHk	iʃlevsɑllik	iʃlevsellik
ifɑdelArHn	ifɑdelɑrin	ifɑdelerin
inʤelemADAn	inʤelemdddn	inʤelemeden
inʤelemAHn	inʤelemdin	inʤelemein
ithɑlɑtDA	ithɑlɑtdɑ	ithɑlɑttɑ
izlemAH	izlemdi	izlemei
køjDAki	køjdɑki	køjdeki
kytyphɑnemHzDA	kytyphɑnemizdɑ	kytyphɑnemizde
kesirlAr	kesirlɑr	kesirler
kokusHz	kokusɯz	kokusuz
kurmADA	kurmɑdɑ	kurmɑtɑ
mɑhɑlleA	mɑhɑlleɑ	mɑhɑllee
mɑhkemelArHHn	mɑhkemelɑriin	mɑhkemeleriin
mɑkineDA	mɑkinedɑ	mɑkinede
mɑkineA	mɑkineɑ	mɑkinee
mɑliklArHHn	mɑliklɑriin	mɑlikleriin
medenijetlArH	medenijetlɑri	medenijetleri
mesɑfelArH	mesɑfelɑri	mesɑfeleri
milletDAn	milletddn	milletten
modernizɑsjonH	modernizɑsjonɯ	modernizɑsjonu
pejgɑmberlAr	pejgɑmberlɑr	pejgɑmberler
protokolA	protokolɑ	protokole
sɑhnelAr	sɑhnelɑr	sɑhneler
seʧAʤAklArH	seʧɑʤɑklɑri	seʧeʤekleri
siDA	sidɑ	side
sipɑriʃlArHn	sipɑriʃlɑrin	sipɑriʃlerin
sorumsHz	sorumsɯz	sorumsuz
typlArH	typlɑri	typleri
tɑvɯrlArH	tɑvɯrlɑri	tɑvɯrlɑrɯ
teʃekkylH	teʃekkyli	teʃekkyly
tutDHklArH	tutdɯklɑrɯ	tuttuklɑrɯ
jønlArA	jønlɑrɑ	jønlere
jykselArAk	jykselɑrɑk	jykselerek
jyryHʃlAr	jyryiʃlɑr	jyryyʃler
jyzmA	jyzmd	jyzme
jyzejlArHHn	jyzejlɑriin	jyzejleriin
jɑtɑkDAn	jɑtɑkdɑn	jɑtɑktɑn
jenilAAn	jenilddn	jenileen
jetiʃkinlArDA	jetiʃkinlɑrdɑ	jetiʃkinlerde
jetiʃkinlArA	jetiʃkinlɑrd	jetiʃkinlere
ʧekinmADAn	ʧekinmdddn	ʧekinmeden
ʧerʧeveA	ʧerʧevei	ʧerʧevee
ʧizelgeDA	ʧizelgedi	ʧizelgede
ʧizimlArHn	ʧizimlɑrin	ʧizimlerin
ʧizmA	ʧizmd	ʧizme
ønnHzA	ønnɯzɑ	ønnyze
øjkyHn	øjkyin	øjkyyn
ʃɑirlArHn	ʃɑirlɑrin	ʃɑirlerin
ʃekillArHHn	ʃekillɑriin	ʃekilleriin
ʃoførH	ʃoføri	ʃoføry
ystynlHklArH	ystynliklɑri	ystynlykleri
yzernHzA	yzernizd	yzernize
ɑrɑbuluʤulHk	ɑrɑbuluʤulɯk	ɑrɑbuluʤuluk
bytynlAʃmAH	bytynldʃmɑɯ	bytynleʃmei
biʧimA	biʧimd	biʧime
bildirmAlArH	bildirmɑlɑri	bildirmeleri
biletlArH	biletlɑri	biletleri
bilmAlArH	bilmɑlɑri	bilmeleri
binmA	binmd	binme
dyʃynmAH	dyʃynmdi	dyʃynmei
dɑireDA	dɑiredɑ	dɑirede
delmA	delmd	delme
derinlHklArnA	derinliklɑrnd	derinliklerne
dilekʧelAr	dilekʧelɑr	dilekʧeler
dinlArHn	dinlɑrin	dinlerin
doɰuH	doɰuɯ	doɰuu
dolgunlHk	dolgunlɯk	dolgunluk
eʃmA	eʃmɑ	eʃme
elnHzDAn	elnizddn	elnizden
etkenlArA	etkenlɑrd	etkenlere
etkileʃimlArH	etkileʃimlɑri	etkileʃimleri
etmADHk	etmddik	etmedik
fertlAr	fertlɑr	fertler
fiʃlAr	fiʃlɑr	fiʃler
fiillArHn	fiillɑrin	fiillerin
gølHHn	gøliin	gølyyn
gølDA	gøldɑ	gølde
gølgeDA	gølgedɑ	gølgede
gølgelAr	gølgelɑr	gølgeler
gøllArH	gøllɑri	gølleri
gørynymlArH	gørynymlɑri	gørynymleri
gøzlemlAnAn	gøzlemlɑndn	gøzlemlenen
gylH	gyli	gyly
gyryltyHn	gyryltyin	gyryltyyn
geʧmAmAH	geʧmɑmɑi	geʧmemei
gemiDA	gemidi	gemide
geziDA	gezidi	gezide
hedijelArH	hedijelɑri	hedijeleri
iʧDA	iʧdɑ	iʧte
ideɑlH	ideɑlɯ	ideɑli
iniʃA	iniʃɑ	iniʃe
køpeklArHn	køpeklɑrin	køpeklerin
kyltyrmHzHn	kyltyrmizin	kyltyrmyzyn
kɑliteDAn	kɑlitedɑn	kɑliteden
kɑrikɑtyrlAr	kɑrikɑtyrlɑr	kɑrikɑtyrler
ligDA	ligdɑ	ligde
listelArA	listelɑrd	listelere
mydyrlyklArHHn	mydyrlyklɑriin	mydyrlykleriin
mɑdenlArH	mɑdenlɑri	mɑdenleri
mɑhɑllinA	mɑhɑllind	mɑhɑlline
mɑlzemeDA	mɑlzemedɑ	mɑlzemede
mɑmyllArH	mɑmyllɑri	mɑmylleri
misɑfirlArA	misɑfirlɑrɑ	misɑfirlere
modellArA	modellɑrɑ	modellere
monitørlAr	monitørlɑr	monitørler
numunelArH	numunelɑri	numuneleri
olumsuzlHk	olumsuzlɯk	olumsuzluk
operɑtørlArHn	operɑtørlɑrin	operɑtørlerin
pɑketlArHHn	pɑketlɑriin	pɑketleriin
problemlArDAn	problemlɑrdɑn	problemlerden
rɑdjɑsjonHn	rɑdjɑsjonɯn	rɑdjɑsjonun
renklArA	renklɑrɑ	renklere
sɯʤɑkDAn	sɯʤɑkdɑn	sɯʤɑktɑn
seʧmAlAr	seʧmɑlɑr	seʧmeler
seʧmAH	seʧmɑi	seʧmei
sempozjumHn	sempozjumin	sempozjumun
sinirlArH	sinirlɑri	sinirleri
sorumlulukDAn	sorumlulukdɑn	sorumluluktɑn
sorHp	sorɯp	sorup
suʧlHlAr	suʧlɯlɑr	suʧlulɑr
tørenlAr	tørenlɑr	tørenler
tɑrifelAr	tɑrifelɑr	tɑrifeler
testlArDAn	testlɑrdɑn	testlerden
umutsHzlHk	umutsɯzlɯk	umutsuzluk
velilArH	velilɑri	velileri
verimlArH	verimlɑri	verimleri
vermADA	vermddɑ	vermede
vermAlArnH	vermɑlɑrni	vermelerni
vurHʃ	vuriʃ	vuruʃ
jønelmAH	jønelmdi	jønelmei
jemAA	jemɑɑ	jemee
jerleʃimlArH	jerleʃimlɑri	jerleʃimleri
ʧøzymHHn	ʧøzymiin	ʧøzymyyn
ʧøzynAn	ʧøzyndn	ʧøzynen
ʧeʃitlArHn	ʧeʃitlɑrin	ʧeʃitlerin
ʧoɰumHzHn	ʧoɰumɯzɯn	ʧoɰumuzun
ødemAlArnHz	ødemɑlɑrniz	ødemelerniz
ødeneklArHn	ødeneklɑrin	ødeneklerin
ølʧymlArHn	ølʧymlɑrin	ølʧymlerin
ønDAki	ønddki	øndeki
ørgytlArDA	ørgytlɑrdɑ	ørgytlerde
ʃiirlArHHn	ʃiirlɑriin	ʃiirleriin
yjelArmHzDAn	yjelɑrmizdɑn	yjelermizden
yjelArmHzH	yjelɑrmizi	yjelermizi
ɑdreslArA	ɑdreslɑrɑ	ɑdreslere
ɑdreslArHHn	ɑdreslɑriin	ɑdresleriin
ɑmirA	ɑmirɑ	ɑmire
ɑntibijotiklArHn	ɑntibijotiklɑrin	ɑntibijotiklerin
ɑsitlArHHn	ɑsitlɑriin	ɑsitleriin
bɯrɑkDHkDAn	bɯrɑkdɯkdɑn	bɯrɑktɯktɑn
belgelAnmAH	belgelɑnmɑi	belgelenmei
bildirimlArH	bildirimlɑri	bildirimleri
bilemAm	bilemɑm	bilemem
bilgilArnHzHn	bilgilɑrnizin	bilgilernizin
bitkilArHHn	bitkilɑriin	bitkileriin
døkymlAr	døkymlɑr	døkymler
dyʃynʤelArnHz	dyʃynʤelɑrniz	dyʃynʤelerniz
deɰerlArDA	deɰerlɑrdɑ	deɰerlerde
desenlArH	desenlɑri	desenleri
dinDAn	dinddn	dinden
dinlemAH	dinlemdi	dinlemei
doɰuHn	doɰuɯn	doɰuun
dojumsHz	dojumsɯz	dojumsuz
edebijɑtDA	edebijɑtdɑ	edebijɑttɑ
eklemAA	eklemɑi	eklemee
emekʧHlArHn	emekʧilɑrin	emekʧilerin
esɑsiA	esɑsiɑ	esɑsie
eserA	eserd	esere
etiketlArH	etiketlɑri	etiketleri
evmA	evmi	evme
fiʃHn	fiʃɯn	fiʃin
gøklArA	gøklɑrɑ	gøklere
gynlArDAki	gynlɑrddki	gynlerdeki
geʧirDHkDAn	geʧirdikdɑn	geʧirdikten
geliʃAʤAk	geliʃɑʤdk	geliʃeʤek
gemilArA	gemilɑrd	gemilere
gizlAmA	gizlɑmi	gizleme
grevA	grevi	greve
hykymetlArA	hykymetlɑrd	hykymetlere
ilkokulH	ilkokuli	ilkokulu
iplArH	iplɑri	ipleri
isimlArA	isimlɑrd	isimlere
ijiDAn	ijiddn	ijiden
kɑrɑrnɑmeA	kɑrɑrnɑmeɑ	kɑrɑrnɑmee
kɑtɑlogH	kɑtɑlogɯ	kɑtɑlogu
kiliselAr	kiliselɑr	kiliseler
kirlAnmAHn	kirlɑnmɑin	kirlenmein
kuʃkulH	kuʃkulɯ	kuʃkulu
kursijerlAr	kursijerlɑr	kursijerler
ligA	ligɑ	lige
listemHzA	listemizd	listemize
myʃterilArDAn	myʃterilɑrdɑn	myʃterilerden
mɑɰdurHn	mɑɰdurɯn	mɑɰdurun
mɑhkumHn	mɑhkumɯn	mɑhkumun
minerɑllArHHn	minerɑllɑrɯɯn	minerɑlleriin
penʤerelArDAn	penʤerelɑrddn	penʤerelerden
reʧetelArH	reʧetelɑri	reʧeteleri
rektørlHkʧA	rektørlikʧɑ	rektørlykʧe
resimlArHHn	resimlɑriin	resimleriin
sɯnɑvsHz	sɯnɑvsiz	sɯnɑvsɯz
søkmA	søkmɑ	søkme
søjleʃilAr	søjleʃilɑr	søjleʃiler
sɑɰlɯkDA	sɑɰlɯkdɑ	sɑɰlɯktɑ
sɑntrɑlHn	sɑntrɑlɯn	sɑntrɑlin
seʧeneklArHn	seʧeneklɑrin	seʧeneklerin
seklHnDAki	seklinddki	seklindeki
sektørmHzHn	sektørmizin	sektørmyzyn
seminerlArDA	seminerlɑrdd	seminerlerde
seminerlArHn	seminerlɑrin	seminerlerin
sevmAH	sevmdi	sevmei
sistemmHzDA	sistemmizdɑ	sistemmizde
sistemnHzDA	sistemnizdɑ	sistemnizde
sitelArDA	sitelɑrdɑ	sitelerde
sitenHzA	sitenizd	sitenize
stokH	stokɯ	stoku
tytynlArDAn	tytynlɑrdɑn	tytynlerden
tɑvsijelAr	tɑvsijelɑr	tɑvsijeler
triljonlHk	triljonlɯk	triljonluk
tutɑnɑkDA	tutɑnɑkdɑ	tutɑnɑktɑ
tutuklulHk	tutuklulɯk	tutukluluk
uʧɑkDA	uʧɑkdɑ	uʧɑktɑ
unsurHn	unsurɯn	unsurun
usulDA	usuldɑ	usulde
jønetimlArHHn	jønetimlɑriin	jønetimleriin
jykymlHlHklArHn	jykymliliklɑrin	jykymlylyklerin
jyksekokulmHz	jyksekokulmɯz	jyksekokulmuz
jyzejDAki	jyzejddki	jyzejdeki
ʧoɰulʤulHk	ʧoɰulʤulɯk	ʧoɰulʤuluk
øɰrenmAlArH	øɰrenmɑlɑri	øɰrenmeleri
øɰretmAA	øɰretmdi	øɰretmee
øteDA	øtedi	øtede
ʃehitlAr	ʃehitlɑr	ʃehitler
ʃubelArHHn	ʃubelɑriin	ʃubeleriin
ʃubemHzA	ʃubemizd	ʃubemize
yʧHHn	yʧiin	yʧyyn
ɑnnelArH	ɑnnelɑri	ɑnneleri
bøbreklAr	bøbreklɑr	bøbrekler
bɑjilArHn	bɑjilɑrin	bɑjilerin
bebeklArH	bebeklɑri	bebekleri
beledijeDAn	beledijeddn	beledijeden
belirtmADA	belirtmddɑ	belirtmete
beslemA	beslemd	besleme
bileʃenlArHn	bileʃenlɑrin	bileʃenlerin
bilmAlH	bilmɑli	bilmeli
birikimA	birikimd	birikime
bitkilArDAn	bitkilɑrdɑn	bitkilerden
boruHHn	boruɯɯn	boruuun
brɑnʃDA	brɑnʃdɑ	brɑnʃtɑ
dønemlArHHn	dønemlɑriin	dønemleriin
dyzenlArH	dyzenlɑri	dyzenleri
deneklArHn	deneklɑrin	deneklerin
derneklArHHn	derneklɑriin	dernekleriin
devletlArDA	devletlɑrdɑ	devletlerde
dinlenAn	dinlendn	dinlenen
dinlAHʤHlArA	dinldiʤilɑrɑ	dinleiʤilere
enerʒiDAn	enerʒidɑn	enerʒiden
esirgemA	esirgemd	esirgeme
etytlArH	etytlɑri	etytleri
ejlemlArDA	ejlemlɑrdɑ	ejlemlerde
fijɑtDAn	fijɑtdɑn	fijɑttɑn
gørmAmA	gørmɑmɑ	gørmeme
gøstermADAn	gøstermddɑn	gøstermeden
gɑjrimenkullAr	gɑjrimenkullɑr	gɑjrimenkuller
gɑzetelArDAn	gɑzetelɑrdɑn	gɑzetelerden
genʧlArDAn	genʧlɑrdɑn	genʧlerden
getirmAHn	getirmdin	getirmein
girAnlArA	girɑnlɑrɑ	girenlere
girAnlArHn	girɑnlɑrin	girenlerin
giriʃimlArA	giriʃimlɑrd	giriʃimlere
giriʃimsAl	giriʃimsdl	giriʃimsel
iʧlArH	iʧlɑri	iʧleri
iʃlArnHzH	iʃlɑrnɯzɯ	iʃlernizi
idɑrelArA	idɑrelɑrɑ	idɑrelere
ilʧelArDAn	ilʧelɑrdɑn	ilʧelerden
ilDAn	ilddn	ilden
iliʃkilArmHz	iliʃkilɑrmiz	iliʃkilermiz
kɯlɑvuzlHk	kɯlɑvuzlik	kɯlɑvuzluk
kɑnserlArHn	kɑnserlɑrin	kɑnserlerin
kɑjbetmAA	kɑjbetmɑɑ	kɑjbetmee
kendimDAn	kendimddn	kendimden
kesitlArH	kesitlɑri	kesitleri
kimselArDAn	kimselɑrdɑn	kimselerden
koʃuH	koʃuɯ	koʃuu
komʃumHz	komʃumɯz	komʃumuz
konsɑntrɑsjonHHn	konsɑntrɑsjonɯɯn	konsɑntrɑsjonuun
konHʃ	konɯʃ	konuʃ
kuʃɑkDAn	kuʃɑkdɑn	kuʃɑktɑn
kurAbilmA	kurɑbilmd	kurɑbilme
kuruluʃmHz	kuruluʃmɯz	kuruluʃmuz
kuzejDAki	kuzejdɑki	kuzejdeki
liseDAn	liseddn	liseden
listelArHn	listelɑrin	listelerin
mykelleflArHn	mykelleflɑrin	mykelleflerin
mylkijetA	mylkijetd	mylkijete
mɑhɑllelArDA	mɑhɑllelɑrdɑ	mɑhɑllelerde
metinDAn	metinddn	metinden
obʒelAr	obʒelɑr	obʒeler
opsijonHn	opsijonɯn	opsijonun
otojolH	otojolɯ	otojolu
oturumHn	oturumɯn	oturumun
pɑrɑʃytH	pɑrɑʃyti	pɑrɑʃyty
pɑrkDA	pɑrkdɑ	pɑrktɑ
pɑtronH	pɑtronɯ	pɑtronu
penʤerelArHn	penʤerelɑrin	penʤerelerin
plɑtformHn	plɑtformɯn	plɑtformun
resimDAn	resimdɑn	resimden
søkHp	søkip	søkyp
søjlentilAr	søjlentilɑr	søjlentiler
seʧDHkDAn	seʧdikdɑn	seʧtikten
sijɑsilArHn	sijɑsilɑrin	sijɑsilerin
sokɑkDAn	sokɑkdɑn	sokɑktɑn
stɑndɑrtDA	stɑndɑrtdɑ	stɑndɑrttɑ
tyjlAr	tyjlɑr	tyjler
tɑbiɑtDA	tɑbiɑtdɑ	tɑbiɑttɑ
tɑhɑmmylH	tɑhɑmmyli	tɑhɑmmyly
tedɑvilArDA	tedɑvilɑrdɑ	tedɑvilerde
tepkilArA	tepkilɑrd	tepkilere
ujduHn	ujduɯn	ujduun
jønetimsAl	jønetimsdl	jønetimsel
jønlArHHn	jønlɑrɯɯn	jønleriin
jeʃilA	jeʃild	jeʃile
jolʤulukDA	jolʤulukdɑ	jolʤuluktɑ
jorgunlHkDAn	jorgunlɯkdɑn	jorgunluktɑn
ʧevrelArHHn	ʧevrelɑriin	ʧevreleriin
ølHnʤA	ølinʤd	ølynʤe
ønʤeDA	ønʤedɑ	ønʤede
ønerAn	ønerdn	øneren
øzyrlylHk	øzyrlylik	øzyrlylyk
øzyrlylArA	øzyrlylɑrd	øzyrlylere
ʃebekelArHHn	ʃebekelɑriin	ʃebekeleriin
ʃeritlAr	ʃeritlɑr	ʃeritler
yniteA	ynitei	ynitee
yniversitelArDAki	yniversitelɑrddki	yniversitelerdeki
yrynlArnHzH	yrynlɑrnizi	yrynlernizi
yretimDAki	yretimddki	yretimdeki
ɑlɯʃveriʃA	ɑlɯʃveriʃɑ	ɑlɯʃveriʃe
ɑtmosferDAki	ɑtmosferddki	ɑtmosferdeki
byltenDA	byltendd	byltende
bɑsDAn	bɑsdɑn	bɑstɑn
bildirmAA	bildirmɑɑ	bildirmee
bilginHzA	bilginizd	bilginize
bozuklHklArHHn	bozuklɯklɑrɯɯn	bozukluklɑrɯɯn
bulunmAmADA	bulunmɑmɑdɑ	bulunmɑmɑtɑ
ʤennetA	ʤennetd	ʤennete
ʤephelAr	ʤephelɑr	ʤepheler
dønyʃymHn	dønyʃymin	dønyʃymyn
dørtlH	dørtli	dørtly
demokrɑsiDAn	demokrɑsidɑn	demokrɑsiden
dikkɑtmHzH	dikkɑtmɯzɯ	dikkɑtmizi
dikmA	dikmɑ	dikme
eɰitimsAl	eɰitimsdl	eɰitimsel
eksiklAr	eksiklɑr	eksikler
ellArHHn	ellɑriin	elleriin
erlAr	erlɑr	erler
etkiDA	etkidɑ	etkide
etkilAmADA	etkildmɑdɑ	etkilemete
fermɑntɑsjonHn	fermɑntɑsjonɯn	fermɑntɑsjonun
fikirlArA	fikirlɑrɑ	fikirlere
filtrelArH	filtrelɑri	filtreleri
fotokopilArH	fotokopilɑri	fotokopileri
futbolH	futbolɯ	futbolu
gøkDA	gøkdɑ	gøkte
gørevlArDAn	gørevlɑrddn	gørevlerden
gøtyrmAA	gøtyrmɑi	gøtyrmee
gøzetArAk	gøzetɑrdk	gøzeterek
gylmAA	gylmɑi	gylmee
gyryltyA	gyryltyi	gyryltye
geliʃmADA	geliʃmɑdɑ	geliʃmede
genʧlArmHz	genʧlɑrmiz	genʧlermiz
gereʧlArHn	gereʧlɑrin	gereʧlerin
gezmAA	gezmɑi	gezmee
gitmAlArH	gitmɑlɑri	gitmeleri
globɑllAʃAn	globɑllɑʃɑn	globɑlleʃen
hɑberleʃmAHn	hɑberleʃmɑin	hɑberleʃmein
hɑʤimlArH	hɑʤimlɑri	hɑʤimleri
hɑlHn	hɑlɯn	hɑlin
husulA	husulɑ	husule
ihɑleDA	ihɑledɑ	ihɑlede
iklimA	iklimd	iklime
kɯlɑvuzlArH	kɯlɑvuzlɑri	kɯlɑvuzlɑrɯ
køʃeDAki	køʃeddki	køʃedeki
køʃelArH	køʃelɑri	køʃeleri
kytyphɑnemHzA	kytyphɑnemizd	kytyphɑnemize
kɑrɑkterA	kɑrɑkterɑ	kɑrɑktere
kɑjnɑkDA	kɑjnɑkdɑ	kɑjnɑktɑ
kesinlAʃmAH	kesinldʃmɑɯ	kesinleʃmei
klɑsørA	klɑsørɑ	klɑsøre
kopHp	kopɯp	kopup
koruAbilmA	koruɑbilmd	koruɑbilme
mykelleflAr	mykelleflɑr	mykellefler
noterlAr	noterlɑr	noterler
ojunHHn	ojunɯɯn	ojunuun
penʤereDAki	penʤereddki	penʤeredeki
proʒelArmHz	proʒelɑrmiz	proʒelermiz
søjlemADAn	søjlemddɑn	søjlemeden
søjlemADAn	søjlemddɑn	søjlemeten
søzlArmH	søzlɑrmɯ	søzlermi
sytunA	sytund	sytunɑ
sɑkinlArHHn	sɑkinlɑriin	sɑkinleriin
seferlAr	seferlɑr	seferler
serbestlAʃmA	serbestldʃmɑ	serbestleʃme
sinyslArHn	sinyslɑrin	sinyslerin
sorumlulHklArHHn	sorumlulɯklɑrɯɯn	sorumluluklɑrɯɯn
tørenlArDA	tørenlɑrdɑ	tørenlerde
tyfA	tyfɑ	tyfe
tebliɰlArH	tebliɰlɑri	tebliɰleri
tehlikeDA	tehlikedi	tehlikede
telefonnHzDAn	telefonnɯzdɑn	telefonnuzdɑn
testA	testd	teste
tiplArDA	tiplɑrdɑ	tiplerde
ujkuH	ujkuɯ	ujkuu
verenA	verend	verene
jønetimlArDA	jønetimlɑrdɑ	jønetimlerde
jønetmeliklArDA	jønetmeliklɑrdɑ	jønetmeliklerde
jyklAnAʤAk	jyklɑnɑʤɑk	jykleneʤek
jerleʃimA	jerleʃimi	jerleʃime
jeteneklArHn	jeteneklɑrin	jeteneklerin
zorlHklArHn	zorlɯklɑrɯn	zorluklɑrɯn
ʧøkHʃH	ʧøkiʃɯ	ʧøkyʃy
ʧyrymAA	ʧyrymdi	ʧyrymee
ʧiʧeklAnmA	ʧiʧeklɑnmɑ	ʧiʧeklenme
ølmADAn	ølmɑdɑn	ølmeden
ønHHn	øniin	ønyyn
øzgyrlHkʧH	øzgyrlikʧi	øzgyrlykʧy
ʃɑirlArH	ʃɑirlɑri	ʃɑirleri
ʃejDA	ʃejdɑ	ʃejde
ɑntenlAr	ɑntenlɑr	ɑntenler
bedelA	bedeld	bedele
bilmAmHz	bilmɑmiz	bilmemiz
bozuklHklArA	bozuklɯklɑrɑ	bozukluklɑrɑ
broʃyrH	broʃyri	broʃyry
bulutlH	bulutlɯ	bulutlu
ʤɑddeDA	ʤɑddedɑ	ʤɑddede
ʤebirsAl	ʤebirsdl	ʤebirsel
døkymHn	døkymin	døkymyn
døkArAk	døkɑrɑk	døkerek
denejlArDA	denejlɑrdɑ	denejlerde
denizlArA	denizlɑrɑ	denizlere
depremlArDA	depremlɑrdɑ	depremlerde
dernekDA	dernekdɑ	dernekte
direktiflAr	direktiflɑr	direktifler
eɰitimlArDA	eɰitimlɑrdi	eɰitimlerde
edinDHklArH	edindiklɑri	edindikleri
ekimDA	ekimdi	ekimde
eleʃtirilArHn	eleʃtirilɑrin	eleʃtirilerin
eriʃmA	eriʃmɑ	eriʃme
erimAH	erimdi	erimei
etmAlArHHn	etmɑlɑriin	etmeleriin
etmAArAk	etmɑɑrɑk	etmeerek
fiʃlArHn	fiʃlɑrɯn	fiʃlerin
finɑlA	finɑlɑ	finɑle
frenlAr	frenlɑr	frenler
gyzelA	gyzeld	gyzele
geʧmADHkʧA	geʧmddikʧɑ	geʧmedikʧe
gelAbilmAH	geldbilmdi	gelebilmei
gemilArHHn	gemilɑriin	gemileriin
geriDAn	geridɑn	geriden
girAlHm	girɑlim	girelim
girmADAn	girmdddn	girmeten
gitDHkDAn	gitdikdɑn	gittikten
hɑberleʃmAA	hɑberleʃmɑɑ	hɑberleʃmee
iʃɑretlAArAk	iʃɑretlɑɑrɑk	iʃɑretleerek
iʃlAnArAk	iʃlɑnɑrɑk	iʃlenerek
iʃletmelArDAn	iʃletmelɑrddn	iʃletmelerden
iʃlevA	iʃlevi	iʃleve
ilmHzA	ilmizd	ilmize
izlenimlAr	izlenimlɑr	izlenimler
izlAHʤHlArHn	izlɑiʤilɑrin	izleiʤilerin
køprylArH	køprylɑri	køpryleri
kɑtegorilArA	kɑtegorilɑrɑ	kɑtegorilere
kentDAki	kentddki	kentteki
kesmAA	kesmɑɑ	kesmee
kliniklArH	kliniklɑri	klinikleri
kongrelArH	kongrelɑri	kongreleri
kulelArH	kulelɑri	kuleleri
mɑtemɑtikDA	mɑtemɑtikdɑ	mɑtemɑtikte
medreselAr	medreselɑr	medreseler
merʤilArH	merʤilɑri	merʤileri
merdivenlArH	merdivenlɑri	merdivenleri
mesɑfeDAn	mesɑfedɑn	mesɑfeden
miniklAr	miniklɑr	minikler
obʒelArHn	obʒelɑrin	obʒelerin
olDHklArHHn	oldɯklɑrɯɯn	olduklɑrɯɯn
orgɑnizɑsjonHHn	orgɑnizɑsjonɯɯn	orgɑnizɑsjonuun
otomobillArHn	otomobillɑrin	otomobillerin
otoritelAr	otoritelɑr	otoriteler
otoritelArH	otoritelɑri	otoriteleri
pɑrtilHlAr	pɑrtililɑr	pɑrtililer
perdelAr	perdelɑr	perdeler
pilɑvH	pilɑvi	pilɑvɯ
pillArH	pillɑri	pilleri
polislArA	polislɑrɑ	polislere
portføjA	portføjɑ	portføje
profesørlHk	profesørlik	profesørlyk
proseslAr	proseslɑr	prosesler
protokolHHn	protokolɯɯn	protokolyyn
syryʤyH	syryʤyi	syryʤyy
syreʧDAn	syreʧdɑn	syreʧten
sɑlonHHn	sɑlonɯɯn	sɑlonuun
sejɑhɑtH	sejɑhɑtɯ	sejɑhɑti
solH	solɯ	solu
sorHnʤA	sorɯnʤɑ	sorunʤɑ
suʧlHlArHn	suʧlɯlɑrɯn	suʧlulɑrɯn
suretlArH	suretlɑri	suretleri
tɑhtDAn	tɑhtdɑn	tɑhttɑn
tɑsɑrrufDA	tɑsɑrrufdɑ	tɑsɑrruftɑ
teʃekkyllH	teʃekkylli	teʃekkylly
tebliɰDA	tebliɰdd	tebliɰde
tedɑvilArHn	tedɑvilɑrin	tedɑvilerin
tulumH	tulumɯ	tulumu
tutmADA	tutmɑdɑ	tutmɑtɑ
jønelmA	jønelmd	jønelme
jyklAnmA	jyklɑnmɑ	jyklenme
jetinmAHp	jetinmdip	jetinmeip
jolluksHz	jolluksɯz	jolluksuz
zeminlArHn	zeminlɑrin	zeminlerin
zinʤirlArH	zinʤirlɑri	zinʤirleri
ʧoklHk	ʧoklɯk	ʧokluk
ʧubuklH	ʧubukli	ʧubuklu
ødemAlArHHn	ødemɑlɑriin	ødemeleriin
ørgytlAnmAlArH	ørgytlɑnmɑlɑri	ørgytlenmeleri
ørgytlArA	ørgytlɑrd	ørgytlere
ʃokH	ʃokɯ	ʃoku
ʃuurlH	ʃuurlɯ	ʃuurlu
yʤretlArA	yʤretlɑrd	yʤretlere
ystlenArAk	ystlenɑrdk	ystlenerek
ɑʧlɯkDAn	ɑʧlɯkdɑn	ɑʧlɯktɑn
ɑrɑzilArHHn	ɑrɑzilɑriin	ɑrɑzileriin
ɑrterlAr	ɑrterlɑr	ɑrterler
bɑʃvurunHzH	bɑʃvurunizi	bɑʃvurunuzu
bɑsɯnʧDA	bɑsɯnʧdɑ	bɑsɯnʧtɑ
bilgilAnmA	bilgilɑnmɑ	bilgilenme
birimDAn	birimddn	birimden
birliklArA	birliklɑrɑ	birliklere
bisikletA	bisikletd	bisiklete
ʤemɑɑtH	ʤemɑɑtɯ	ʤemɑɑti
ʤAr	ʤɑr	ʤer
ʤevherlArH	ʤevherlɑri	ʤevherleri
dyɰynlArDA	dyɰynlɑrdɑ	dyɰynlerde
dyʃHʃlAr	dyʃiʃlɑr	dyʃyʃler
dyzeltmAlArH	dyzeltmɑlɑri	dyzeltmeleri
dɑrbelAr	dɑrbelɑr	dɑrbeler
deɰiʃmAHn	deɰiʃmɑin	deɰiʃmein
derlemAlAr	derlemɑlɑr	derlemeler
dernekDAn	dernekddn	dernekten
devletlArDAn	devletlɑrddn	devletlerden
dilekʧeA	dilekʧei	dilekʧee
dinlenmAA	dinlenmdd	dinlenmee
editørDAn	editørddn	editørden
eleʃtiriA	eleʃtirii	eleʃtirie
erenlAr	erenlɑr	erenler
fermentA	fermentd	fermente
fiksA	fiksd	fikse
frekɑnsDA	frekɑnsdɑ	frekɑnstɑ
gøzetAn	gøzetdn	gøzeten
gøzlArDAn	gøzlɑrdɑn	gøzlerden
gyreʃA	gyreʃɑ	gyreʃe
geʧHʃlH	geʧiʃlɯ	geʧiʃli
gelmAHHn	gelmdiin	gelmeiin
gezmA	gezmi	gezme
hykymetlArHHn	hykymetlɑriin	hykymetleriin
hɑreketlArDAn	hɑreketlɑrdɑn	hɑreketlerden
hɑrfHn	hɑrfɯn	hɑrfin
hekimDAn	hekimddn	hekimden
iʧerDHklArH	iʧerdiklɑri	iʧerdikleri
ifɑdelArHHn	ifɑdelɑriin	ifɑdeleriin
ilɑvelAr	ilɑvelɑr	ilɑveler
iletmA	iletmd	iletme
imɑlH	imɑlɯ	imɑli
irɑdeA	irɑdeɑ	irɑdee
isimlArDAn	isimlɑrdɑn	isimlerden
kyltyrDAn	kyltyrddn	kyltyrden
kyrsyH	kyrsyi	kyrsyy
kɑdɑstroH	kɑdɑstroɯ	kɑdɑstrou
kɑjɯtDA	kɑjɯtdɑ	kɑjɯttɑ
kiliselArH	kiliselɑri	kiliseleri
kongrelArDA	kongrelɑrdɑ	kongrelerde
konserlArH	konserlɑri	konserleri
kriterA	kriterɑ	kritere
kursDA	kursdɑ	kurstɑ
lehDA	lehdɑ	lehte
listelAnAn	listelɑndn	listelenen
mynɑsebetlArH	mynɑsebetlɑri	mynɑsebetleri
mɑlzemelArDA	mɑlzemelɑrdɑ	mɑlzemelerde
mɑlzemelArA	mɑlzemelɑrɑ	mɑlzemelere
meseleA	meselei	meselee
otellArHn	otellɑrin	otellerin
perdelArH	perdelɑri	perdeleri
potɑnsijellAr	potɑnsijellɑr	potɑnsijeller
primlArHHn	primlɑriin	primleriin
reʒimlAr	reʒimlɑr	reʒimler
syryʤylArHHn	syryʤylɑriin	syryʤyleriin
syrylAr	syrylɑr	syryler
sɑtHʃDA	sɑtɯʃdɑ	sɑtɯʃtɑ
sektørlArDAki	sektørlɑrddki	sektørlerdeki
servislArDA	servislɑrdɑ	servislerde
tɑkvimA	tɑkvimd	tɑkvime
tɑleplArA	tɑleplɑrɑ	tɑleplere
tɑslɑkDA	tɑslɑkdɑ	tɑslɑktɑ
tɑtilDA	tɑtildɑ	tɑtilde
tekneDA	teknedɑ	teknede
temellArA	temellɑrd	temellere
trɑnsferlArH	trɑnsferlɑri	trɑnsferleri
ujHp	ujɯp	ujup
vermAnHzH	vermɑnizi	vermenizi
virysHHn	virysiin	virysyyn
jolmHzA	jolmɯzɑ	jolmuzɑ
ʧøzynyrlyklH	ʧøzynyrlykli	ʧøzynyrlykly
ʧevirilAr	ʧevirilɑr	ʧeviriler
ʧiftʧilArA	ʧiftʧilɑrd	ʧiftʧilere
ʧizimDA	ʧizimdi	ʧizimde
øɰretmenlArDAn	øɰretmenlɑrddn	øɰretmenlerden
ølʧekDAki	ølʧekddki	ølʧekteki
ønmA	ønmɑ	ønme
øzelDA	øzeldd	øzelde
ʃeflArH	ʃeflɑri	ʃefleri
ʃiirDA	ʃiirdd	ʃiirde
ɑfiʃlAr	ɑfiʃlɑr	ɑfiʃler
ɑnimɑsjonH	ɑnimɑsjonɯ	ɑnimɑsjonu
ɑskerlArA	ɑskerlɑrɑ	ɑskerlere
byroHn	byroɯn	byroun
bɑɰɯʃDA	bɑɰɯʃdɑ	bɑɰɯʃtɑ
belirlemAnHzH	belirlemdnizi	belirlemenizi
benzerlHklArH	benzerliklɑri	benzerlikleri
birleʃHnʤA	birleʃinʤd	birleʃinʤe
bizlerDA	bizlerdd	bizlerde
dønmAH	dønmɑi	dønmei
dyʃynʤelArmH	dyʃynʤelɑrmi	dyʃynʤelermi
dyʃmADAn	dyʃmɑdɑn	dyʃmeden
dyzenlemADA	dyzenlemddi	dyzenlemede
deɰerlendirmAlArHn	deɰerlendirmɑlɑrin	deɰerlendirmelerin
demirDAn	demirddn	demirden
derilArH	derilɑri	derileri
dinlenmAH	dinlenmdi	dinlenmei
dokuH	dokuɯ	dokuu
dujgulArHHn	dujgulɑriin	dujgulɑrɯɯn
eklemAlAr	eklemɑlɑr	eklemeler
eklArHHn	eklɑriin	ekleriin
enerʒiDA	enerʒidi	enerʒide
erkekDA	erkekdi	erkekte
etmAmHzH	etmɑmizi	etmemizi
filoH	filoi	filou
finɑlDA	finɑldɑ	finɑlde
geʧirmADA	geʧirmddi	geʧirmete
germA	germi	germe
hɑkemA	hɑkemɑ	hɑkeme
iʃgɑlA	iʃgɑlɑ	iʃgɑle
iʃmHzH	iʃmɯzi	iʃmizi
ifɑdelArA	ifɑdelɑrɑ	ifɑdelere
ihmɑlH	ihmɑlɯ	ihmɑli
ilʧelArA	ilʧelɑrd	ilʧelere
iliʃkilArmHzHn	iliʃkilɑrmizin	iliʃkilermizin
kɑrɑkterDAn	kɑrɑkterdɑn	kɑrɑkterden
kesilmA	kesilmi	kesilme
kesimlArDAn	kesimlɑrdɑn	kesimlerden
killAr	killɑr	killer
komiteA	komitei	komitee
komutHHn	komutɯɯn	komutuun
krizlArA	krizlɑrɑ	krizlere
lenslAr	lenslɑr	lensler
listelArHHn	listelɑriin	listeleriin
mɑmullAr	mɑmullɑr	mɑmuller
metreDA	metredɑ	metrede
mitingDA	mitingdɑ	mitingde
okulmHzA	okulmɯzɑ	okulmuzɑ
okuHnʤA	okuɯnʤɑ	okuunʤɑ
otobysHn	otobysin	otobysyn
pɑketlArHn	pɑketlɑrin	pɑketlerin
pɑnellArHn	pɑnellɑrin	pɑnellerin
pɑrɑmetrelArA	pɑrɑmetrelɑrɑ	pɑrɑmetrelere
pɑrsellAr	pɑrsellɑr	pɑrseller
rivɑjetA	rivɑjetɑ	rivɑjete
sɑhnelArH	sɑhnelɑri	sɑhneleri
simgesAl	simgesdl	simgesel
sinDA	sindɑ	sinde
sivillAr	sivillɑr	siviller
sohbetlAr	sohbetlɑr	sohbetler
sohbetlArH	sohbetlɑri	sohbetleri
suʧlHlArH	suʧlɯlɑrɯ	suʧlulɑrɯ
tyketiʤilArH	tyketiʤilɑri	tyketiʤileri
tymørlArHn	tymørlɑrin	tymørlerin
tytynA	tytynd	tytyne
teʃekkyrlArmHzH	teʃekkyrlɑrmizi	teʃekkyrlermizi
tellAr	tellɑr	teller
terørizmA	terørizmi	terørizme
tespitlArH	tespitlɑri	tespitleri
testDA	testdɑ	testte
unsurHHn	unsurɯɯn	unsuruun
vyʤutlArH	vyʤutlɑri	vyʤutlɑrɯ
jøntemDAn	jøntemddn	jøntemden
jyʤelAn	jyʤeldn	jyʤelen
jyklAmAH	jyklɑmɑi	jyklemei
jyklAnHʤHnHn	jykldniʤinin	jykleniʤinin
jɑvruH	jɑvrui	jɑvruu
jetkilHlArDAn	jetkililɑrdɑn	jetkililerden
ʧøplArH	ʧøplɑri	ʧøpleri
ʧiftlArHn	ʧiftlɑrin	ʧiftlerin
ʧizelgelArH	ʧizelgelɑri	ʧizelgeleri
ønleArAk	ønleɑrɑk	ønleerek
øzetlAnAn	øzetlɑndn	øzetlenen
ʃɑhitlAr	ʃɑhitlɑr	ʃɑhitler
ʃehitlArH	ʃehitlɑri	ʃehitleri
ʃerhlAr	ʃerhlɑr	ʃerhler
yniteDAn	yniteddn	yniteden
ystlenmA	ystlenmd	ystlenme
ystlArH	ystlɑri	ystleri
ɑkʤiɰerlArA	ɑkʤiɰerlɑrɑ	ɑkʤiɰerlere
bɑsɑmɑkDAn	bɑsɑmɑkdɑn	bɑsɑmɑktɑn
beʤeriA	beʤerii	beʤerie
belirsizlHklAr	belirsizliklɑr	belirsizlikler
belirtmAH	belirtmɑi	belirtmei
benimsemA	benimsemi	benimseme
bejinDAki	bejinddki	bejindeki
bildirmAnHz	bildirmɑniz	bildirmeniz
døngyHn	døngyin	døngyyn
dønmelArH	dønmelɑri	dønmeleri
dyzelmAH	dyzelmdi	dyzelmei
deɰerlArmHz	deɰerlɑrmiz	deɰerlermiz
deɰinArAk	deɰinɑrɑk	deɰinerek
deDHkDAn	dedikdɑn	dedikten
dengelArHn	dengelɑrin	dengelerin
denklemlArHHn	denklemlɑriin	denklemleriin
denklAr	denklɑr	denkler
desenlAr	desenlɑr	desenler
devrimlArH	devrimlɑri	devrimleri
dilsAl	dilsdl	dilsel
doktornHzHn	doktornɯzɯn	doktornuzun
dokulH	dokulɯ	dokulu
eɰlenʤelAr	eɰlenʤelɑr	eɰlenʤeler
eʃitsizliklAr	eʃitsizliklɑr	eʃitsizlikler
edilAmAmAH	edilɑmɑmɑi	edilememei
ellArmH	ellɑrmi	ellermi
eriʃimA	eriʃimi	eriʃime
ejlylDA	ejlyldd	ejlylde
fɑktørHn	fɑktørin	fɑktøryn
filozofH	filozofɯ	filozofu
gørynyrDA	gørynyrdi	gørynyrde
gørmAmAH	gørmɑmɑɯ	gørmemei
gøzmHn	gøzmɯn	gøzmyn
gøzetlemA	gøzetlemi	gøzetleme
gybrelAr	gybrelɑr	gybreler
gyzellHklArA	gyzelliklɑri	gyzelliklere
gɑjeA	gɑjeɑ	gɑjee
gebelArDA	gebelɑrdɑ	gebelerde
geʤikAn	geʤikɑn	geʤiken
gelmAnHz	gelmɑniz	gelmeniz
gemilArDA	gemilɑrdi	gemilerde
genlAr	genlɑr	genler
gezegenlAr	gezegenlɑr	gezegenler
gitmADAn	gitmddɑn	gitmeten
hedeflArmHz	hedeflɑrmiz	hedeflermiz
hemʃirelArHn	hemʃirelɑrin	hemʃirelerin
hejkellAr	hejkellɑr	hejkeller
hiʧDA	hiʧdɑ	hiʧte
ibɑdetA	ibɑdetɑ	ibɑdete
ilkelArDAn	ilkelɑrddn	ilkelerden
istɑtistiklArA	istɑtistiklɑrɑ	istɑtistiklere
isteklArHn	isteklɑrin	isteklerin
istemDA	istemdi	istemde
izlAHʤHlArA	izlɑiʤilɑrɑ	izleiʤilere
kyltyrmHz	kyltyrmiz	kyltyrmyz
kɑnserlAr	kɑnserlɑr	kɑnserler
kɑnunsHz	kɑnunsɯz	kɑnunsuz
kesintilArHn	kesintilɑrin	kesintilerin
kiʃiliklArH	kiʃiliklɑri	kiʃilikleri
komisjonmHz	komisjonmɯz	komisjonmuz
komutHn	komutɯn	komutun
kujrukDA	kujrukdɑ	kujruktɑ
mɑddesAl	mɑddesdl	mɑddesel
meselelArHn	meselelɑrin	meselelerin
milletlArA	milletlɑrd	milletlere
obstryksijonH	obstryksijonɯ	obstryksijonu
olguH	olguɯ	olguu
otelmHzDA	otelmizdɑ	otelmizde
pyryzlH	pyryzli	pyryzly
reʒimA	reʒimi	reʒime
reʒimlArH	reʒimlɑri	reʒimleri
sømyrgelAr	sømyrgelɑr	sømyrgeler
søzlykDA	søzlykdɑ	søzlykte
syrykleAn	syrykledn	syrykleen
senɑtoHHn	senɑtoɯɯn	senɑtouun
sensørlAr	sensørlɑr	sensørler
sijɑsetDAn	sijɑsetdɑn	sijɑsetten
sorumlHlAr	sorumlɯlɑr	sorumlulɑr
sunuʤuHHn	sunuʤuɯɯn	sunuʤuuun
tyzyklAr	tyzyklɑr	tyzykler
tɑɑrruzH	tɑɑrruzɯ	tɑɑrruzu
tɑbɑkhɑnelAr	tɑbɑkhɑnelɑr	tɑbɑkhɑneler
tɑburH	tɑburɯ	tɑburu
tɑvukʧHlHk	tɑvukʧilik	tɑvukʧuluk
teknelArH	teknelɑri	tekneleri
uʧHp	uʧip	uʧup
velilArmHz	velilɑrmiz	velilermiz
veriʤilAr	veriʤilɑr	veriʤiler
vitɑminlArH	vitɑminlɑri	vitɑminleri
vurgulAnAn	vurgulɑndn	vurgulɑnɑn
jykseklHkDAki	jykseklikddki	jykseklikteki
jolsuzlHklAr	jolsuzlɯklɑr	jolsuzluklɑr
zorunlulHklAr	zorunlulɯklɑr	zorunluluklɑr
ølʧytlArA	ølʧytlɑrd	ølʧytlere
ølylArHn	ølylɑrin	ølylerin
ʃɑrtnɑmelAr	ʃɑrtnɑmelɑr	ʃɑrtnɑmeler
ʃiirsAl	ʃiirsdl	ʃiirsel
ʃirketmHzA	ʃirketmizd	ʃirketmize
yremAH	yremdi	yremei
ɑdɑptɑsjonH	ɑdɑptɑsjonɯ	ɑdɑptɑsjonu
ɑhilArHn	ɑhilɑrin	ɑhilerin
ɑilesAl	ɑilesdl	ɑilesel
bølAn	bølɑn	bølen
byjymADA	byjymddɑ	byjymete
bɑʃlɑmADA	bɑʃlɑmɑdɑ	bɑʃlɑmɑtɑ
bɑromHz	bɑromɯz	bɑromuz
beledijelArHHn	beledijelɑriin	beledijeleriin
bileʃiklArHHn	bileʃiklɑriin	bileʃikleriin
boɰHʤH	boɰɯʤɯ	boɰuʤu
døʃemelAr	døʃemelɑr	døʃemeler
døkyntylAr	døkyntylɑr	døkyntyler
dyʃynʤelArDAn	dyʃynʤelɑrddn	dyʃynʤelerden
dyzlemsAl	dyzlemsdl	dyzlemsel
deɰiʃimDAn	deɰiʃimddn	deɰiʃimden
deɰiʃkenlArA	deɰiʃkenlɑrd	deɰiʃkenlere
deɰmADAn	deɰmddɑn	deɰmeden
defterlArA	defterlɑrɑ	defterlere
denetimDAn	denetimddn	denetimden
dergimHzDA	dergimizdi	dergimizde
devretmA	devretmd	devretme
diA	diɑ	die
dinlenDHkDAn	dinlendikdɑn	dinlendikten
eʃlArHn	eʃlɑrin	eʃlerin
ekimDAn	ekimddn	ekimden
elbiselArH	elbiselɑri	elbiseleri
etydlArH	etydlɑri	etydleri
etkilAnAʤAk	etkilɑnɑʤdk	etkileneʤek
etmAksHzHn	etmdksizin	etmeksizin
evlenAn	evlendn	evlenen
formylHn	formylin	formylyn
gøryʃmeDAn	gøryʃmeddn	gøryʃmeden
gørynAʤAk	gørynɑʤdk	gøryneʤek
gøryntylArHHn	gøryntylɑriin	gøryntyleriin
gøzlArmHz	gøzlɑrmɯz	gøzlermiz
gyneʃDA	gyneʃdɑ	gyneʃte
gyzellAr	gyzellɑr	gyzeller
gerʧeklArDAn	gerʧeklɑrddn	gerʧeklerden
getirAlHm	getirɑlim	getirelim
gezilArA	gezilɑrd	gezilere
girAbilmAH	girdbilmdi	girebilmei
girHnʤAA	girinʤdɑ	girinʤee
hɑʤimDA	hɑʤimdɑ	hɑʤimde
hɑkimA	hɑkimɑ	hɑkime
hɑlmA	hɑlmɑ	hɑlme
iʧmHzDAki	iʧmizddki	iʧmizdeki
iʧmAH	iʧmdi	iʧmei
iʃmHzA	iʃmɯzɑ	iʃmize
ilʧemHzA	ilʧemizd	ilʧemize
ilerlemAHn	ilerlemdin	ilerlemein
islArHn	islɑrin	islerin
istemADAn	istemdddn	istemeden
kømyrlAr	kømyrlɑr	kømyrler
køpyklH	køpykli	køpykly
kytyphɑnelArDA	kytyphɑnelɑrdɑ	kytyphɑnelerde
kɑsetlArH	kɑsetlɑri	kɑsetleri
kɑjɯtDAn	kɑjɯtdɑn	kɑjɯttɑn
kiriʃlAr	kiriʃlɑr	kiriʃler
kistlAr	kistlɑr	kistler
koltukDA	koltukdɑ	koltuktɑ
komplikɑsjonH	komplikɑsjonɯ	komplikɑsjonu
kortH	kortɯ	kortu
kredilArHHn	kredilɑriin	kredileriin
kristɑllArH	kristɑllɑrɯ	kristɑlleri
kulH	kulɯ	kulu
kumHn	kumɯn	kumun
myʤɑdelelArH	myʤɑdelelɑri	myʤɑdeleleri
mylkH	mylki	mylky
mɑʧDAn	mɑʧdɑn	mɑʧtɑn
mɑhɑllelArH	mɑhɑllelɑri	mɑhɑlleleri
mɑmulHn	mɑmulɯn	mɑmulyn
mesɑfeA	mesɑfeɑ	mesɑfee
mevzuH	mevzui	mevzuu
modyllArHn	modyllɑrin	modyllerin
molekylH	molekyli	molekyly
muhɑsebeA	muhɑsebeɑ	muhɑsebee
odunH	odunɯ	odunu
ordumHzHn	ordumɯzɯn	ordumuzun
pɑketDA	pɑketdɑ	pɑkette
pɑsɑportH	pɑsɑportɯ	pɑsɑportu
posterlAr	posterlɑr	posterler
rezervɑsjonH	rezervɑsjonɯ	rezervɑsjonu
søzmHz	søzmɯz	søzmyz
syrykleArAk	syrykleɑrdk	syrykleerek
syzylArAk	syzylɑrɑk	syzylerek
sellAr	sellɑr	seller
sensørH	sensøri	sensøry
sejɑhɑtA	sejɑhɑtɑ	sejɑhɑte
sezonHn	sezonɯn	sezonun
sivillArA	sivillɑrɑ	sivillere
sivillArHn	sivillɑrin	sivillerin
sonHHn	sonɯɯn	sonuun
sporHHn	sporɯɯn	sporuun
stɑtyHHn	stɑtyiin	stɑtyyyn
tɑnsijonHn	tɑnsijonɯn	tɑnsijonun
teknisjenlAr	teknisjenlɑr	teknisjenler
temizlAAn	temizlddn	temizleen
tepeDA	tepedɑ	tepede
tesʤilDAn	tesʤilddn	tesʤilden
tijɑtroH	tijɑtroɯ	tijɑtrou
tonHn	tonɯn	tonun
trenA	trend	trene
tutumHn	tutumɯn	tutumun
uʧHʃH	uʧiʃɯ	uʧuʃu
jønergelArH	jønergelɑri	jønergeleri
jønetAnlArHn	jønetɑnlɑrin	jønetenlerin
jyklAnArAk	jyklɑnɑrɑk	jyklenerek
jɑzmADAn	jɑzmɑdɑn	jɑzmɑtɑn
jemeklArDAn	jemeklɑrdɑn	jemeklerden
jetkilArn	jetkilɑrn	jetkilern
zehirlAnmAH	zehirlɑnmɑi	zehirlenmei
ʧøkelmA	ʧøkelmd	ʧøkelme
ʧizgilArHn	ʧizgilɑrin	ʧizgilerin
øɰrenmAnHz	øɰrenmdniz	øɰrenmeniz
øɰretmenDAn	øɰretmenddn	øɰretmenden
ønlemlArHHn	ønlemlɑriin	ønlemleriin
ørtyHn	ørtyin	ørtyyn
ʃɑmpijonlHk	ʃɑmpijonlɯk	ʃɑmpijonluk
ɑdetA	ɑdetɑ	ɑdete
ɑkʤiɰerlAr	ɑkʤiɰerlɑr	ɑkʤiɰerler
ɑktørlAr	ɑktørlɑr	ɑktørler
ɑnɑlizlArDA	ɑnɑlizlɑrdɑ	ɑnɑlizlerde
ɑtDHklArH	ɑtdɯklɑrɯ	ɑttɯklɑrɯ
bykmA	bykmd	bykme
bytʧelAr	bytʧelɑr	bytʧeler
byjyklHklAr	byjykliklɑr	byjyklykler
byjyklArA	byjyklɑrd	byjyklere
bɑkɑnlɯkDA	bɑkɑnlɯkdɑ	bɑkɑnlɯktɑ
bɑkterilArH	bɑkterilɑri	bɑkterileri
bejliklAr	bejliklɑr	bejlikler
bilmADHklArH	bilmddiklɑri	bilmedikleri
bitAnA	bitɑnd	bitene
bitkilArA	bitkilɑrd	bitkilere
bulHnʤA	bulɯnʤɑ	bulunʤɑ
ʤɑddeA	ʤɑddeɑ	ʤɑddee
ʤemijetlArH	ʤemijetlɑri	ʤemijetleri
ʤevɑpDA	ʤevɑpdɑ	ʤevɑptɑ
ʤisimlArH	ʤisimlɑri	ʤisimleri
dyʃHʃA	dyʃiʃɑ	dyʃyʃe
dyʃmAAn	dyʃmɑɑn	dyʃmeen
dyzenlemAlArDAn	dyzenlemɑlɑrddn	dyzenlemelerden
delikDAn	delikdɑn	delikten
demAHn	demɑin	demein
demirjoluHn	demirjoluɯn	demirjoluun
denetʧilArH	denetʧilɑri	denetʧileri
denklemA	denklemd	denkleme
derinlArA	derinlɑrd	derinlere
dejimlArH	dejimlɑri	dejimleri
dujHp	dujɯp	dujup
eɰitHʤHlArHn	eɰitiʤilɑrin	eɰitiʤilerin
eklArHn	eklɑrin	eklerin
emekʧHlAr	emekʧilɑr	emekʧiler
emekʧHlArHHn	emekʧilɑriin	emekʧileriin
eskilArHn	eskilɑrin	eskilerin
evmHzA	evmizd	evmize
evnHzDAn	evnizddn	evnizden
fɯrsɑtDAn	fɯrsɑtdɑn	fɯrsɑttɑn
geʤikmAA	geʤikmɑi	geʤikmee
hyrrijetlArH	hyrrijetlɑri	hyrrijetleri
hɑkikɑtA	hɑkikɑtɑ	hɑkikɑte
hɑriʧDAn	hɑriʧdɑn	hɑriʧten
hɑjretA	hɑjretɑ	hɑjrete
huzurnHzDA	huzurnɯzdɑ	huzurnuzdɑ
iʧAʤAklArn	iʧɑʤdklɑrn	iʧeʤeklern
iʧkilAr	iʧkilɑr	iʧkiler
iʧmAAn	iʧmɑdn	iʧmeen
iʃletmeDAn	iʃletmeddn	iʃletmeden
iʃleArAk	iʃleɑrɑk	iʃleerek
ilerlemAH	ilerlemdi	ilerlemei
ilklArA	ilklɑrɑ	ilklere
izlemAH	izlemdi	izlemei
køʃkH	køʃkɯ	køʃky
køpryDAn	køprydɑn	køpryden
kɑlmADAn	kɑlmɑdɑn	kɑlmɑtɑn
kɑmjonHn	kɑmjonɯn	kɑmjonun
kɑreA	kɑreɑ	kɑree
kɑvimlAr	kɑvimlɑr	kɑvimler
koʃHp	koʃɯp	koʃup
konserA	konserɑ	konsere
kojDHklArH	kojdɯklɑri	kojduklɑrɯ
kuʃHn	kuʃɯn	kuʃun
liselAr	liselɑr	liseler
myʃteriDAn	myʃteridɑn	myʃteriden
mykemmelA	mykemmeld	mykemmele
mɑʤunH	mɑʤunɯ	mɑʤunu
medenijetA	medenijetd	medenijete
medenijetlArHn	medenijetlɑrin	medenijetlerin
modylDA	modyldɑ	modylde
molekyllArHHn	molekyllɑriin	molekylleriin
nesilA	nesild	nesile
nikA	nikɑ	nike
noterDA	noterdɑ	noterde
olumsuzlHklArn	olumsuzlɯklɑrn	olumsuzluklɑrn
otoriteA	otoriteɑ	otoritee
peʃA	peʃɑ	peʃe
plɑtformHHn	plɑtformɯɯn	plɑtformuun
primA	primɑ	prime
reddetmA	reddetmd	reddetme
reseptørlArH	reseptørlɑri	reseptørleri
søjleAlHm	søjleɑlim	søjleelim
sɑɰdujulH	sɑɰdujulɯ	sɑɰdujulu
sɑtHʃDAn	sɑtɯʃdɑn	sɑtɯʃtɑn
sebeplArA	sebeplɑrɑ	sebeplere
sebzelArH	sebzelɑri	sebzeleri
sektørmHz	sektørmiz	sektørmyz
sermɑjelArH	sermɑjelɑri	sermɑjeleri
sejirʤilAr	sejirʤilɑr	sejirʤiler
siʤillArH	siʤillɑri	siʤilleri
suʧsHz	suʧsɯz	suʧsuz
tymDAn	tymdɑn	tymden
teknikDA	teknikdɑ	teknikte
tijɑtroHHn	tijɑtroɯɯn	tijɑtrouun
usulsHz	usulsɯz	usulsyz
vɑzgeʧmAH	vɑzgeʧmɑi	vɑzgeʧmei
vurHp	vurip	vurup
jyksekokullArHn	jyksekokullɑrin	jyksekokullɑrɯn
jyzmA	jyzmd	jyzme
jerleʃimlAr	jerleʃimlɑr	jerleʃimler
jijeʤeklArDAn	jijeʤeklɑrddn	jijeʤeklerden
jolʤuHn	jolʤuɯn	jolʤuun
ʧølDA	ʧøldɑ	ʧølde
ʧekmADAn	ʧekmddɑn	ʧekmeden
ʧetelArHn	ʧetelɑrin	ʧetelerin
ʧoʤuklHkDAn	ʧoʤuklɯkdɑn	ʧoʤukluktɑn
øɰrenimlArH	øɰrenimlɑri	øɰrenimleri
ønlemADA	ønlemddɑ	ønlemede
ørgytlAnmAA	ørgytlɑnmɑɑ	ørgytlenmee
øjkyH	øjkyi	øjkyy
ʃɑrtnɑmeA	ʃɑrtnɑmeɑ	ʃɑrtnɑmee
ʃebekelAr	ʃebekelɑr	ʃebekeler
ʃekillAnAn	ʃekillɑndn	ʃekillenen
ʃenliklAr	ʃenliklɑr	ʃenlikler
ystlenmAH	ystlenmdi	ystlenmei
yzerlArH	yzerlɑri	yzerleri
ɑʧDHkDAn	ɑʧdɯkdɑn	ɑʧtɯktɑn
ɑʤentelAr	ɑʤentelɑr	ɑʤenteler
ɑfetlArA	ɑfetlɑrɑ	ɑfetlere
ɑlɯʃveriʃDA	ɑlɯʃveriʃdɑ	ɑlɯʃveriʃte
ɑlevlAr	ɑlevlɑr	ɑlevler
ɑlkolsHz	ɑlkolsɯz	ɑlkolsyz
ɑmirlArHHn	ɑmirlɑriin	ɑmirleriin
ɑnɑlizlArHn	ɑnɑlizlɑrin	ɑnɑlizlerin
ɑnnelArA	ɑnnelɑrɑ	ɑnnelere
ɑskerDAn	ɑskerdɑn	ɑskerden
ɑtøljeDA	ɑtøljedɑ	ɑtøljede
bɑʃDAki	bɑʃdɑki	bɑʃtɑki
bɑkijelArH	bɑkijelɑri	bɑkijeleri
bulunDHkDAn	bulundɯkdɑn	bulunduktɑn
ʤemɑɑtHn	ʤemɑɑtɯn	ʤemɑɑtin
ʤephelArH	ʤephelɑri	ʤepheleri
ʤoʃkuH	ʤoʃkuɯ	ʤoʃkuu
døʃemelArH	døʃemelɑri	døʃemeleri
dyʃynmAHn	dyʃynmdin	dyʃynmein
deɰiʃiklHklArDA	deɰiʃikliklɑrdɑ	deɰiʃikliklerde
denklArHn	denklɑrin	denklerin
derelAr	derelɑr	dereler
dergilArA	dergilɑrd	dergilere
devrelArHHn	devrelɑriin	devreleriin
diʃilAr	diʃilɑr	diʃiler
doɰrultuH	doɰrultuɯ	doɰrultuu
durumnHz	durumnɯz	durumnuz
ebedijetA	ebedijetd	ebedijete
enstitymHzDA	enstitymizdi	enstitymyzde
eriʃimDA	eriʃimdi	eriʃimde
evmHzDA	evmizdi	evmizde
fyzelAr	fyzelɑr	fyzeler
fɑkyltemHzA	fɑkyltemizd	fɑkyltemize
felɑketlAr	felɑketlɑr	felɑketler
felsefeDA	felsefedi	felsefede
gøryʃmelArDAn	gøryʃmelɑrddn	gøryʃmelerden
gørAnHn	gørɑnin	gørenin
gørmAmHz	gørmɑmɯz	gørmemiz
gøsterimlArH	gøsterimlɑri	gøsterimleri
gøstermAH	gøstermdi	gøstermei
gøtyrArAk	gøtyrɑrɑk	gøtyrerek
gøzmHz	gøzmɯz	gøzmyz
gøzetmA	gøzetmd	gøzetme
gyʧlArA	gyʧlɑri	gyʧlere
geʧinAn	geʧindn	geʧinen
genlAʃmA	genldʃmɑ	genleʃme
getirAbilmAH	getirdbilmdi	getirebilmei
getirmADA	getirmddi	getirmede
girdilArHn	girdilɑrin	girdilerin
giriʃimlArHHn	giriʃimlɑriin	giriʃimleriin
girmAHn	girmdin	girmein
hykymDAn	hykymddn	hykymden
hɑberlArDA	hɑberlɑrdɑ	hɑberlerde
hɑllArHn	hɑllɑrɯn	hɑllerin
herkesDA	herkesdɑ	herkeste
iʧeriDAki	iʧeriddki	iʧerideki
ihtijɑʧDAn	ihtijɑʧdɑn	ihtijɑʧtɑn
ilʧelAr	ilʧelɑr	ilʧeler
ilerlemAlArH	ilerlemɑlɑri	ilerlemeleri
islAAn	isldɑn	isleen
izlArHHn	izlɑriin	izleriin
kymelArH	kymelɑri	kymeleri
kyrsyDAn	kyrsyddn	kyrsyden
kɑhveDA	kɑhvedɑ	kɑhvede
kɑlAbilmA	kɑlɑbilmd	kɑlɑbilme
kɑnɑɑtH	kɑnɑɑtɯ	kɑnɑɑti
kɑvimlArHn	kɑvimlɑrin	kɑvimlerin
kelimelArDAn	kelimelɑrdɑn	kelimelerden
kereDA	keredɑ	kerede
kilolH	kilolɯ	kilolu
klɑsørlAr	klɑsørlɑr	klɑsørler
komplekslArH	komplekslɑri	kompleksleri
konumHHn	konumɯɯn	konumuun
kristɑlHn	kristɑlɯn	kristɑlin
kurʃunlH	kurʃunlɯ	kurʃunlu
mɑkinelArDA	mɑkinelɑrdɑ	mɑkinelerde
mɑrketlArDA	mɑrketlɑrdɑ	mɑrketlerde
mɑtrislAr	mɑtrislɑr	mɑtrisler
memeDA	memedɑ	memede
menfɑɑtlAr	menfɑɑtlɑr	menfɑɑtler
metinlArDAn	metinlɑrdɑn	metinlerden
metrekɑreA	metrekɑreɑ	metrekɑree
mezunlArmHzHn	mezunlɑrmizin	mezunlɑrmɯzɯn
millAr	millɑr	miller
mimɑriDA	mimɑridɑ	mimɑride
morɑlH	morɑlɯ	morɑli
muɑjeneDAn	muɑjeneddn	muɑjeneden
olHʃHHn	olɯʃɯɯn	oluʃuun
pɑletlAr	pɑletlɑr	pɑletler
pɑrselDA	pɑrseldɑ	pɑrselde
pɑrtimHzA	pɑrtimizd	pɑrtimize
profesørlAr	profesørlɑr	profesørler
rølelArH	rølelɑri	røleleri
rɑkiplArH	rɑkiplɑri	rɑkipleri
reʧetelArA	reʧetelɑrɑ	reʧetelere
reformHHn	reformɯɯn	reformuun
rekɑbetDAn	rekɑbetdɑn	rekɑbetten
renklArDAn	renklɑrdɑn	renklerden
sytA	sytd	syte
sɑntrɑllArHn	sɑntrɑllɑrɯn	sɑntrɑllerin
sɑvʤɯlArH	sɑvʤɯlɑri	sɑvʤɯlɑrɯ
sɑvʤɯlArHn	sɑvʤɯlɑrin	sɑvʤɯlɑrɯn
sebzelArHn	sebzelɑrin	sebzelerin
semtlArDA	semtlɑrdɑ	semtlerde
serAn	serdn	seren
sermɑjeDAn	sermɑjedɑn	sermɑjeden
sejirʤiA	sejirʤii	sejirʤie
silArAk	silɑrɑk	silerek
sitenHzDA	sitenizdɑ	sitenizde
sunmADAn	sunmɑdɑn	sunmɑtɑn
tɑhsilA	tɑhsild	tɑhsile
tɑkdirA	tɑkdirɑ	tɑkdire
tehlikelArDAn	tehlikelɑrddn	tehlikelerden
tekerryrH	tekerryri	tekerryry
tersɑnelAr	tersɑnelɑr	tersɑneler
tesismHzDA	tesismizdi	tesismizde
tesislArmHz	tesislɑrmiz	tesislermiz
tiʤɑretDAki	tiʤɑretddki	tiʤɑretteki
tuzHn	tuzɯn	tuzun
ufukDA	ufukdɑ	ufuktɑ
vɑliA	vɑliɑ	vɑlie
vektørlAr	vektørlɑr	vektørler
viryslH	virysli	virysly
jønetiʤilArmHz	jønetiʤilɑrmiz	jønetiʤilermiz
jyreklArH	jyreklɑri	jyrekleri
jɑʃɑmADAn	jɑʃɑmɑdɑn	jɑʃɑmɑtɑn
jɑrɑtmADA	jɑrɑtmɑdɑ	jɑrɑtmɑtɑ
jemeklArDA	jemeklɑrdɑ	jemeklerde
zorH	zorɯ	zoru
ʧekinArAk	ʧekinɑrɑk	ʧekinerek
ʧetelArH	ʧetelɑri	ʧeteleri
ʧizmAA	ʧizmɑɑ	ʧizmee
ɯʃɯkDA	ɯʃɯkdɑ	ɯʃɯktɑ
øɰretmenlArmHzHn	øɰretmenlɑrmizin	øɰretmenlermizin
øgelArH	øgelɑri	øgeleri
ølʧmAA	ølʧmɑɑ	ølʧmee
ølylAr	ølylɑr	ølyler
ørgytlArmHzHn	ørgytlɑrmizin	ørgytlermizin
øvgylAr	øvgylɑr	øvgyler
ʃypheA	ʃyphei	ʃyphee
ʃifrelArH	ʃifrelɑri	ʃifreleri
ylkesAl	ylkesdl	ylkesel
yzymH	yzymi	yzymy
ɑhilAr	ɑhilɑr	ɑhiler
ɑnɑlizlArHHn	ɑnɑlizlɑriin	ɑnɑlizleriin
ɑnketDA	ɑnketdɑ	ɑnkette
ɑntrenørlHk	ɑntrenørlik	ɑntrenørlyk
ɑrmutlH	ɑrmutlɯ	ɑrmutlu
ɑsitlArHn	ɑsitlɑrin	ɑsitlerin
ɑvluHn	ɑvluin	ɑvluun
bøʤeklArH	bøʤeklɑri	bøʤekleri
byroHHn	byroɯin	byrouun
bɑjilArA	bɑjilɑrɑ	bɑjilere
beʒA	beʒɑ	beʒe
beledijeDA	beledijedi	beledijede
belirlemADA	belirlemddi	belirlemete
benzemAAn	benzemɑdn	benzemeen
betonH	betonɯ	betonu
bezlAr	bezlɑr	bezler
dyzeltmAH	dyzeltmdi	dyzeltmei
demADAn	demɑdɑn	demeten
desteklAmADA	destekldmɑdɑ	desteklemete
devirlArH	devirlɑri	devirleri
devrelArDA	devrelɑrdɑ	devrelerde
eɰlenʤeA	eɰlenʤei	eɰlenʤee
editørHn	editørin	editøryn
efsɑnelAr	efsɑnelɑr	efsɑneler
eklemAH	eklemdi	eklemei
emisjonH	emisjonɯ	emisjonu
emsɑlH	emsɑlɯ	emsɑli
emzirAn	emzirdn	emziren
enstitylArHHn	enstitylɑriin	enstityleriin
eriʃkinDA	eriʃkindd	eriʃkinde
etmADHkʧA	etmddikʧɑ	etmedikʧe
etmAmAA	etmɑmɑɑ	etmemee
federɑsjonHn	federɑsjonɯn	federɑsjonun
fenerlAr	fenerlɑr	fenerler
filmlArDAn	filmlɑrdɑn	filmlerden
fizikDA	fizikdi	fizikte
gøllArHn	gøllɑrin	gøllerin
gønyllAr	gønyllɑr	gønyller
gøsterAlHm	gøsterdlim	gøsterelim
gøzmHzHn	gøzmɯzin	gøzmyzyn
gøzmA	gøzmɑ	gøzme
gyʧlAnAn	gyʧlɑndn	gyʧlenen
geʧmAnHz	geʧmdniz	geʧmeniz
geʤelArDA	geʤelɑrdɑ	geʤelerde
geliʃmADAn	geliʃmɑdɑn	geliʃmeden
gemiDAn	gemiddn	gemiden
genʧlArmHzA	genʧlɑrmizd	genʧlermize
gereksinmAlArH	gereksinmɑlɑri	gereksinmeleri
hɑdislAr	hɑdislɑr	hɑdisler
hɑreketDAn	hɑreketdɑn	hɑreketten
hekimlArDAn	hekimlɑrdɑn	hekimlerden
hissetmAA	hissetmɑɑ	hissetmee
iʧeriklArHHn	iʧeriklɑriin	iʧerikleriin
iʧimDAki	iʧimddki	iʧimdeki
ihɑlelArHn	ihɑlelɑrin	ihɑlelerin
ihtimɑlHHn	ihtimɑlɯɯn	ihtimɑliin
ikiDA	ikidɑ	ikide
ilɑʧDAn	ilɑʧdɑn	ilɑʧtɑn
iliʃkilArDAn	iliʃkilɑrddn	iliʃkilerden
iliʃkilArmHzH	iliʃkilɑrmizi	iliʃkilermizi
illArmHzDA	illɑrmizdi	illermizde
inʤelemAlArnH	inʤelemɑlɑrni	inʤelemelerni
istikɑmetDA	istikɑmetdɑ	istikɑmette
izlAHʤHnHn	izlɑiʤinin	izleiʤinin
kømyrA	kømyrɑ	kømyre
kytyphɑnelArA	kytyphɑnelɑrɑ	kytyphɑnelere
kɑlemlArHn	kɑlemlɑrin	kɑlemlerin
kɑrɑkterDA	kɑrɑkterdɑ	kɑrɑkterde
kɑrɑrnɑmeDA	kɑrɑrnɑmedɑ	kɑrɑrnɑmede
kelimeDAn	kelimeddn	kelimeden
kelimelArDA	kelimelɑrdɑ	kelimelerde
kendinHzDAn	kendinizddn	kendinizden
kokuH	kokuɯ	kokuu
komitelArHn	komitelɑrin	komitelerin
konfederɑsjonH	konfederɑsjonɯ	konfederɑsjonu
kontrolDA	kontroldɑ	kontrolde
konHp	konɯp	konup
koordinɑsjonHn	koordinɑsjonɯn	koordinɑsjonun
kujumʤulHk	kujumʤulɯk	kujumʤuluk
mydyrlyklArA	mydyrlyklɑrd	mydyrlyklere
myfettiʃlAr	myfettiʃlɑr	myfettiʃler
mylteʤiA	mylteʤii	mylteʤie
mɑlijetlArA	mɑlijetlɑrɑ	mɑlijetlere
mɑterjɑllArHHn	mɑterjɑllɑrɯɯn	mɑterjɑlleriin
meʤlislArHHn	meʤlislɑriin	meʤlisleriin
menyHn	menyin	menyyn
mevʤutlArH	mevʤutlɑri	mevʤutlɑrɯ
mimɑriA	mimɑriɑ	mimɑrie
niteliklArHn	niteliklɑrin	niteliklerin
noterA	noterɑ	notere
obʒektiflAr	obʒektiflɑr	obʒektifler
okumADA	okumɑdɑ	okumɑtɑ
okumADAn	okumɑdɑn	okumɑtɑn
olH	olɯ	olu
onurHHn	onurɯɯn	onuruun
operɑtørA	operɑtørɑ	operɑtøre
operɑtørlArA	operɑtørlɑrɑ	operɑtørlere
petrolH	petrolɯ	petroly
portføjHHn	portføjiin	portføjyyn
protokolDA	protokoldɑ	protokolde
renklArHHn	renklɑriin	renkleriin
sytunlH	sytunli	sytunlu
sɑndɑljeA	sɑndɑljeɑ	sɑndɑljee
seɑnsDA	seɑnsdɑ	seɑnstɑ
sergilArA	sergilɑrd	sergilere
servislArDAn	servislɑrdɑn	servislerden
sevDHklArnHzA	sevdiklɑrnizd	sevdiklernize
sorumlHlArHHn	sorumlɯlɑrɯɯn	sorumlulɑrɯɯn
sponsorlHk	sponsorlɯk	sponsorluk
tyketimDA	tyketimdi	tyketimde
tɑrihlArA	tɑrihlɑrɑ	tɑrihlere
teʃebbysHn	teʃebbysin	teʃebbysyn
teʃebbyslAr	teʃebbyslɑr	teʃebbysler
tedɑvilArHHn	tedɑvilɑriin	tedɑvileriin
teoriDA	teoridɑ	teoride
tespitA	tespitd	tespite
tiʤɑretDAn	tiʤɑretdɑn	tiʤɑretten
jønelmA	jønelmd	jønelme
jørelAr	jørelɑr	jøreler
jɑrHn	jɑrɯn	jɑrin
jɑvrulArH	jɑvrulɑri	jɑvrulɑrɯ
jemeklArHHn	jemeklɑriin	jemekleriin
jemlAr	jemlɑr	jemler
jerleʃmAA	jerleʃmɑɑ	jerleʃmee
jolʤulukDAn	jolʤulukdɑn	jolʤuluktɑn
ʧɑrelArH	ʧɑrelɑri	ʧɑreleri
ʧekiʃmAlH	ʧekiʃmɑli	ʧekiʃmeli
ʧeliʃAn	ʧeliʃɑn	ʧeliʃen
øɰleA	øɰlei	øɰlee
ølʧymlArDA	ølʧymlɑrdɑ	ølʧymlerde
ølyHn	ølyin	ølyyn
ølAnlArA	ølɑnlɑrɑ	ølenlere
ʃikɑjetlArHHn	ʃikɑjetlɑriin	ʃikɑjetleriin
ʃuHn	ʃuɯn	ʃuun
yʤretDAn	yʤretddn	yʤretten
yjelHklAr	yjeliklɑr	yjelikler
ɑkʤiɰerlArDA	ɑkʤiɰerlɑrdɑ	ɑkʤiɰerlerde
ɑlkolA	ɑlkolɑ	ɑlkole
ɑnketlArH	ɑnketlɑri	ɑnketleri
ɑnlɑtmADA	ɑnlɑtmɑdɑ	ɑnlɑtmɑtɑ
ɑnormɑllHk	ɑnormɑllɯk	ɑnormɑllik
ɑrʃivA	ɑrʃivi	ɑrʃive
bølymmHzHn	bølymmizin	bølymmyzyn
bølgemHzA	bølgemizd	bølgemize
bytynlAʃAn	bytynldʃɑn	bytynleʃen
byjykʧA	byjykʧɑ	byjykʧe
byjyklArmHz	byjyklɑrmiz	byjyklermiz
bɑʃvurHp	bɑʃvurip	bɑʃvurup
beklemADA	beklemddɑ	beklemete
beklentilArA	beklentilɑrd	beklentilere
belirleDHklArH	belirlediklɑri	belirledikleri
belirleDHkDAn	belirledikdɑn	belirledikten
biʧmA	biʧmd	biʧme
bilɑnʧoHn	bilɑnʧoɯn	bilɑnʧoun
bilmADA	bilmddɑ	bilmete
birikmAH	birikmɑi	birikmei
bitmA	bitmɑ	bitme
ʤymleDAn	ʤymleddn	ʤymleden
dyɰynH	dyɰyni	dyɰyny
dyzeltmAH	dyzeltmdi	dyzeltmei
dyzenlemAlArnH	dyzenlemɑlɑrni	dyzenlemelerni
demokrɑsiDA	demokrɑsidɑ	demokrɑside
depremlArDAn	depremlɑrdɑn	depremlerden
dereʤelArHHn	dereʤelɑriin	dereʤeleriin
desteklArHn	desteklɑrin	desteklerin
ebevejnlAr	ebevejnlɑr	ebevejnler
eklemlAr	eklemlɑr	eklemler
endiʃelAr	endiʃelɑr	endiʃeler
erDHkDAn	erdikdɑn	erdikten
etmAnHzA	etmɑnizɑ	etmenize
fɑrelAr	fɑrelɑr	fɑreler
gøklArDA	gøklɑrdɑ	gøklerde
gøllArDA	gøllɑrdɑ	gøllerde
gørynmA	gørynmd	gørynme
gyʧlyklArA	gyʧlyklɑrd	gyʧlyklere
gyreʃʧHlAr	gyreʃʧilɑr	gyreʃʧiler
geʧirmAlArH	geʧirmɑlɑri	geʧirmeleri
geleʤekDAn	geleʤekddn	geleʤekten
genelgeDA	genelgedi	genelgede
girmAmAH	girmɑmɑi	girmemei
hɑkɑretA	hɑkɑretɑ	hɑkɑrete
hɑrfnA	hɑrfnɑ	hɑrfne
hɑstɑhɑneA	hɑstɑhɑneɑ	hɑstɑhɑnee
hedefmHzA	hedefmizi	hedefmize
hemʃehrilArmHzA	hemʃehrilɑrmizd	hemʃehrilermize
hejkellArH	hejkellɑri	hejkelleri
iʧAnlArHn	iʧɑnlɑrin	iʧenlerin
ilgilHlArDAn	ilgililɑrdɑn	ilgililerden
istemADHklArH	istemddiklɑri	istemedikleri
istemAArAk	istemɑɑrɑk	istemeerek
izleDHklArH	izlediklɑri	izledikleri
kyresAllAʃmAH	kyresɑlldʃmɑɯ	kyreselleʃmei
kɑnserDAn	kɑnserdɑn	kɑnserden
kɑrɑkolH	kɑrɑkolɯ	kɑrɑkolu
kɑjbetDHklArH	kɑjbetdiklɑri	kɑjbettikleri
kɑjbolHp	kɑjbolɯp	kɑjbolup
kistlArH	kistlɑri	kistleri
komiteDA	komitedɑ	komitede
korkuH	korkuɯ	korkuu
kredilArA	kredilɑrɑ	kredilere
kuʃʧH	kuʃʧɯ	kuʃʧu
kurummHzHn	kurummɯzɯn	kurummuzun
kuvvetlArA	kuvvetlɑri	kuvvetlere
listelAnAʤAk	listelɑnɑʤɑk	listeleneʤek
myʤɑdeleDAn	myʤɑdeleddn	myʤɑdeleden
myhyrlH	myhyrli	myhyrly
mylteʤilArH	mylteʤilɑri	mylteʤileri
merkezlArDAn	merkezlɑrddn	merkezlerden
mesɑfelArDA	mesɑfelɑrdɑ	mesɑfelerde
metodlArHHn	metodlɑrɯin	metodlɑrɯɯn
metodHHn	metodɯin	metoduun
nehirlArH	nehirlɑri	nehirleri
oksitlAr	oksitlɑr	oksitler
okjɑnusH	okjɑnusɯ	okjɑnusu
olAbilmAnHn	olɑbilmɑnin	olɑbilmenin
olurH	olurɯ	oluru
pɑrtikyllAr	pɑrtikyllɑr	pɑrtikyller
perdeA	perdei	perdee
piʃmA	piʃmɑ	piʃme
pilotHn	pilotɯn	pilotun
polislArH	polislɑri	polisleri
prensiplArA	prensiplɑrɑ	prensiplere
primlArHn	primlɑrin	primlerin
proʒeDAki	proʒeddki	proʒedeki
purolHk	purolɯk	puroluk
rɑkiplArHHn	rɑkiplɑriin	rɑkipleriin
rɑportørlHk	rɑportørlik	rɑportørlyk
reʒimlArHn	reʒimlɑrin	reʒimlerin
resimlArnHzH	resimlɑrnizi	resimlernizi
sɯvɯlArH	sɯvɯlɑri	sɯvɯlɑrɯ
søzlArDAn	søzlɑrdɑn	søzlerden
syrmAA	syrmɑɑ	syrmee
sɑnɑjiDAki	sɑnɑjidɑki	sɑnɑjideki
sonuʧDAn	sonuʧdɑn	sonuʧtɑn
sorunnHz	sorunnɯz	sorunnuz
stresDAn	stresdɑn	stresten
suʧlHH	suʧlɯɯ	suʧluu
tyjH	tyji	tyjy
tɑhlillAr	tɑhlillɑr	tɑhliller
tɑvuklArHn	tɑvuklɑrin	tɑvuklɑrɯn
teʤɑvyzHn	teʤɑvyzin	teʤɑvyzyn
telgrɑfDA	telgrɑfdɑ	telgrɑftɑ
temizlAnAn	temizlɑnɑn	temizlenen
tepelAr	tepelɑr	tepeler
tepkimA	tepkimd	tepkime
vermAm	vermɑm	vermem
jøntemlArDA	jøntemlɑrdɑ	jøntemlerde
jyrymADA	jyrymddɑ	jyrymete
jemAn	jemdn	jemen
ʧɯkDHklArH	ʧɯkdɯklɑrɯ	ʧɯktɯklɑrɯ
ʧøzymDA	ʧøzymdi	ʧøzymde
ʧɑrelAr	ʧɑrelɑr	ʧɑreler
ʧekiʃmA	ʧekiʃmɑ	ʧekiʃme
ʧevrelArA	ʧevrelɑri	ʧevrelere
ʧimentoHn	ʧimentoin	ʧimentoun
ʧizgisAl	ʧizgisdl	ʧizgisel
øɰelArHHn	øɰelɑriin	øɰeleriin
ødA	ødɑ	øde
ødeneklAr	ødeneklɑr	ødenekler
ølʧyA	ølʧyi	ølʧye
ølmAA	ølmɑɑ	ølmee
ønemlArH	ønemlɑri	ønemleri
øzetlAAn	øzetlddn	øzetleen
ʃiʃelAr	ʃiʃelɑr	ʃiʃeler
ʃiʃlHklAr	ʃiʃlɯklɑr	ʃiʃlikler
ʃikɑjetA	ʃikɑjetɑ	ʃikɑjete
ʃikɑjetlArnHzH	ʃikɑjetlɑrnizi	ʃikɑjetlernizi
yniversitelArmHzDA	yniversitelɑrmizdi	yniversitelermizde
yniversitelArmHzHn	yniversitelɑrmizin	yniversitelermizin
yretimlArHHn	yretimlɑriin	yretimleriin
yzyntyA	yzyntyi	yzyntye
yzAn	yzdn	yzen
yzernDAken	yzernddken	yzerndeken
ɑfetlArDA	ɑfetlɑrdɑ	ɑfetlerde
ɑhiretDA	ɑhiretdɑ	ɑhirette
ɑktiviteA	ɑktivitei	ɑktivitee
ɑnormɑllHklAr	ɑnormɑllɯklɑr	ɑnormɑllikler
ɑvʤɯlArH	ɑvʤɯlɑri	ɑvʤɯlɑrɯ
bølArAk	bølɑrɑk	bølerek
bɑrɯʃDA	bɑrɯʃdɑ	bɑrɯʃtɑ
bebekDAn	bebekddn	bebekten
bekleDHklArH	beklediklɑri	bekledikleri
beklentilArmHz	beklentilɑrmiz	beklentilermiz
binAr	binɑr	biner
birlikDAn	birlikddn	birlikten
bulunHʃH	bulunɯʃɯ	bulunuʃu
ʤɑddelAr	ʤɑddelɑr	ʤɑddeler
ʤɑmiDA	ʤɑmidɑ	ʤɑmide
ʤerrɑhiA	ʤerrɑhiɑ	ʤerrɑhie
ʤumhurijetDAn	ʤumhurijetdɑn	ʤumhurijetten
døʃemeA	døʃemei	døʃemee
dyʃmH	dyʃmi	dyʃmy
dyʃlAr	dyʃlɑr	dyʃler
dyʃmADA	dyʃmɑdɑ	dyʃmete
dyʃmAmA	dyʃmɑmɑ	dyʃmeme
dyʃmAmAH	dyʃmɑmɑɯ	dyʃmemei
dɑrbelArH	dɑrbelɑri	dɑrbeleri
dɑrbeA	dɑrbeɑ	dɑrbee
deɰiʃmA	deɰiʃmɑ	deɰiʃme
deɰiʃmAlArA	deɰiʃmɑlɑrɑ	deɰiʃmelere
deɰiʃmAlArHn	deɰiʃmɑlɑrin	deɰiʃmelerin
defterlArHHn	defterlɑriin	defterleriin
dehʃetA	dehʃetd	dehʃete
deneArAk	deneɑrɑk	deneerek
denejimlArHn	denejimlɑrin	denejimlerin
denizDAki	denizddki	denizdeki
denizlArmHzDA	denizlɑrmizdɑ	denizlermizde
depresjonHn	depresjonɯn	depresjonun
derleAn	derleɑn	derleen
devrimlAr	devrimlɑr	devrimler
diʃlArDA	diʃlɑrdɑ	diʃlerde
dinlAAlHm	dinldɑlim	dinleelim
doɰrultulH	doɰrultulɯ	doɰrultulu
doɰumHHn	doɰumɯɯn	doɰumuun
dolguH	dolguɯ	dolguu
eɰlenmA	eɰlenmd	eɰlenme
editørA	editøri	editøre
ekiplArmHz	ekiplɑrmiz	ekiplermiz
elementlArHHn	elementlɑriin	elementleriin
endystriA	endystrii	endystrie
fɑrelArHn	fɑrelɑrin	fɑrelerin
fiʃHHn	fiʃɯin	fiʃiin
figyrlArH	figyrlɑri	figyrleri
fonHHn	fonɯɯn	fonuun
fotoɰrɑfDAn	fotoɰrɑfdɑn	fotoɰrɑftɑn
gønderAʤAk	gønderɑʤdk	gøndereʤek
gøndermAnHzH	gøndermdnizi	gøndermenizi
gøsteriA	gøsterii	gøsterie
gøzlAmA	gøzlɑmɑ	gøzleme
gyryltylAr	gyryltylɑr	gyryltyler
geliʃmA	geliʃmɑ	geliʃme
gerekAnDAn	gerekɑnddn	gerekenden
gerilArDA	gerilɑrdɑ	gerilerde
girmAHHn	girmdiin	girmeiin
hɑmurHn	hɑmurɯn	hɑmurun
hɑzretlArHHn	hɑzretlɑriin	hɑzretleriin
iʃʧiDAn	iʃʧiddn	iʃʧiden
iʃɑretlAnmAH	iʃɑretlɑnmɑi	iʃɑretlenmei
iʃlArnHzDA	iʃlɑrnɯzdɑ	iʃlernizde
iʃlevlArHn	iʃlevlɑrin	iʃlevlerin
ihtilɑlH	ihtilɑlɯ	ihtilɑli
ilkeA	ilkei	ilkee
isteDHklArnHzH	istediklɑrnizi	istediklernizi
izlAnmADA	izlɑnmɑdɑ	izlenmete
kørlAr	kørlɑr	kørler
køjlylArA	køjlylɑrɑ	køjlylere
kyltyrmHzH	kyltyrmizi	kyltyrmyzy
kytlelArH	kytlelɑri	kytleleri
kɑhveA	kɑhveɑ	kɑhvee
kɑpsylH	kɑpsyli	kɑpsyly
kɑpsɑmADA	kɑpsɑmɑdɑ	kɑpsɑmɑtɑ
kɑrdeʃlArHn	kɑrdeʃlɑrin	kɑrdeʃlerin
kɑtɯlmADA	kɑtɯlmɑdɑ	kɑtɯlmɑtɑ
kemerlAr	kemerlɑr	kemerler
kesilmA	kesilmi	kesilme
kimlArDAn	kimlɑrdɑn	kimlerden
konsejlArH	konsejlɑri	konsejleri
konsolosH	konsolosɯ	konsolosu
kontrollArA	kontrollɑrɑ	kontrollere
kojmADA	kojmɑdɑ	kojmɑtɑ
kulyplArA	kulyplɑrɑ	kulyplere
kujruklH	kujruklɯ	kujruklu
kujuHn	kujuin	kujuun
liflArHHn	liflɑriin	lifleriin
liselArHn	liselɑrin	liselerin
myzikDA	myzikdɑ	myzikte
mɑkbulA	mɑkbulɑ	mɑkbule
mɑmyllAr	mɑmyllɑr	mɑmyller
mɑmullArHHn	mɑmullɑrɯɯn	mɑmulleriin
mertebeDAn	mertebeddn	mertebeden
mesɑfeDAki	mesɑfeddki	mesɑfedeki
mesɑfelArA	mesɑfelɑrɑ	mesɑfelere
metinlArHHn	metinlɑriin	metinleriin
mevsimlArA	mevsimlɑrd	mevsimlere
modylHHn	modyliin	modylyyn
muhɑbirlArHHn	muhɑbirlɑriin	muhɑbirleriin
nøbetlArHn	nøbetlɑrin	nøbetlerin
nyfuslArH	nyfuslɑri	nyfuslɑrɯ
nehirlAr	nehirlɑr	nehirler
niteliksAl	niteliksdl	niteliksel
otobysDA	otobysdɑ	otobyste
pɑjlɑʃmADAn	pɑjlɑʃmɑdɑn	pɑjlɑʃmɑtɑn
polimerlArHn	polimerlɑrin	polimerlerin
profillAr	profillɑr	profiller
reʧinelAr	reʧinelɑr	reʧineler
refɑkɑtʧH	refɑkɑtʧɯ	refɑkɑtʧi
sønAn	sønɑn	sønen
søzlyklAr	søzlyklɑr	søzlykler
syrprizlAr	syrprizlɑr	syrprizler
syslAr	syslɑr	sysler
sɑɰlAAbilAn	sɑɰlɑɑbilɑn	sɑɰlɑɑbilen
sɑnɑjilAʃmAHn	sɑnɑjilɑʃmɑɯn	sɑnɑjileʃmein
sɑvH	sɑvi	sɑvɯ
semtA	semtd	semte
sinjɑllArHn	sinjɑllɑrɯn	sinjɑllerin
sirkylɑsjonH	sirkylɑsjonɯ	sirkylɑsjonu
sistemmHzA	sistemmizd	sistemmize
soɰuklHk	soɰuklɯk	soɰukluk
sohbetA	sohbetɑ	sohbete
tɑɑhhytlAr	tɑɑhhytlɑr	tɑɑhhytler
tɑrihlAnAn	tɑrihlɑnɑn	tɑrihlenen
tɑtillAr	tɑtillɑr	tɑtiller
tɑvsijeDA	tɑvsijedi	tɑvsijede
tekerleklAr	tekerleklɑr	tekerlekler
temɑsDAn	temɑsdɑn	temɑstɑn
vɑdeA	vɑdeɑ	vɑdee
vekillAr	vekillɑr	vekiller
velilArmHzA	velilɑrmizd	velilermize
vermAHHn	vermɑiin	vermeiin
jønergelAr	jønergelɑr	jønergeler
jønetiʤiA	jønetiʤii	jønetiʤie
jykA	jykɑ	jyke
jyklAnmA	jyklɑnmɑ	jyklenme
jykselmA	jykselmd	jykselme
jɑpDHklArHHn	jɑpdɯklɑrɯɯn	jɑptɯklɑrɯɯn
jeʃillHklAr	jeʃilliklɑr	jeʃillikler
jemAH	jemdi	jemei
jerjyzynDAn	jerjyzynddn	jerjyzynden
jetmiʃA	jetmiʃɑ	jetmiʃe
jolmHz	jolmɯz	jolmuz
jolmHzH	jolmɯzɯ	jolmuzu
ʧimentoH	ʧimentoi	ʧimentou
ɯʃɯkDAn	ɯʃɯkdɑn	ɯʃɯktɑn
øzDA	øzdɑ	øzde
ʃubelArDA	ʃubelɑrdɑ	ʃubelerde
ynitelArDA	ynitelɑrdi	ynitelerde
yniversitenHzDA	yniversitenizdi	yniversitenizde
ynlylArHn	ynlylɑrin	ynlylerin
yretiʤilArDAn	yretiʤilɑrddn	yretiʤilerden
yreAn	yreɑn	yreen
ɑbonelArmHz	ɑbonelɑrmiz	ɑbonelermiz
ɑlbymDAn	ɑlbymdɑn	ɑlbymden
ɑjlɯkDAn	ɑjlɯkdɑn	ɑjlɯktɑn
ɑzɯnlɯkDA	ɑzɯnlɯkdɑ	ɑzɯnlɯktɑ
beʃA	beʃɑ	beʃe
bedenA	bedend	bedene
belirtmADAn	belirtmddɑn	belirtmeden
benimseArAk	benimseɑrdk	benimseerek
benzerlAr	benzerlɑr	benzerler
bileʃenlArHHn	bileʃenlɑriin	bileʃenleriin
bitAnH	bitɑni	biteni
bolmH	bolmɯ	bolmu
bulutH	bulutɯ	bulutu
bursHn	bursɯn	bursun
dønyʃymA	dønyʃymi	dønyʃyme
dyʃH	dyʃi	dyʃy
dyʃHʃHn	dyʃiʃɯn	dyʃyʃyn
dyʃynʤelArmHzH	dyʃynʤelɑrmizi	dyʃynʤelermizi
dyʃynmAmHz	dyʃynmɑmiz	dyʃynmemiz
deɰerlArmHzH	deɰerlɑrmizi	deɰerlermizi
denetimlArHn	denetimlɑrin	denetimlerin
derAn	derɑn	deren
dergimHzA	dergimizd	dergimize
dijetA	dijeti	dijete
dujHʃsAl	dujɯʃsɑl	dujuʃsɑl
ekipDA	ekipdɑ	ekipte
ekmeklAr	ekmeklɑr	ekmekler
eksenDA	eksendd	eksende
eleʃtirmA	eleʃtirmi	eleʃtirme
emellArH	emellɑri	emelleri
emArAk	emɑrɑk	emerek
emnijetA	emnijetd	emnijete
endystrilAr	endystrilɑr	endystriler
enerʒilArH	enerʒilɑri	enerʒileri
engellArDAn	engellɑrddn	engellerden
etkilAmAA	etkilɑmɑɑ	etkilemee
felɑketDAn	felɑketdɑn	felɑketten
fermɑntɑsjonH	fermɑntɑsjonɯ	fermɑntɑsjonu
figyrlAr	figyrlɑr	figyrler
fiilA	fiili	fiile
gøndermADAn	gøndermdddn	gøndermeden
gøryʃlArDAn	gøryʃlɑrdɑn	gøryʃlerden
gøzlemlAmA	gøzlemlɑmi	gøzlemleme
gøzlemlArHn	gøzlemlɑrin	gøzlemlerin
gɑrɑntilArH	gɑrɑntilɑri	gɑrɑntileri
gɑjrimenkulA	gɑjrimenkuld	gɑjrimenkule
geniʃliklArH	geniʃliklɑri	geniʃlikleri
genlArHn	genlɑrin	genlerin
gereklArHHn	gereklɑriin	gerekleriin
gereksinimlArHn	gereksinimlɑrin	gereksinimlerin
getirilArH	getirilɑri	getirileri
giriʃimA	giriʃimi	giriʃime
golDAn	goldɑn	golden
hykymsHzlHk	hykymsizlik	hykymsyzlyk
hɑdiselArHn	hɑdiselɑrin	hɑdiselerin
hɑfifA	hɑfifɑ	hɑfife
hɑkimlArHn	hɑkimlɑrin	hɑkimlerin
hɑriʧDA	hɑriʧdɑ	hɑriʧte
hemʃirelArH	hemʃirelɑri	hemʃireleri
hikɑjelArHn	hikɑjelɑrin	hikɑjelerin
hobilArH	hobilɑri	hobileri
iʧAnlArDA	iʧɑnlɑrdɑ	iʧenlerde
iʃɑretlAmA	iʃɑretlɑmɑ	iʃɑretleme
iʃlArnHzHn	iʃlɑrnɯzɯn	iʃlernizin
ifɑdeA	ifɑdeɑ	ifɑdee
ikɑmetgɑhHHn	ikɑmetgɑhɯin	ikɑmetgɑhɯɯn
indirimDAn	indirimddn	indirimden
isteHnʤA	isteinʤd	isteinʤe
izlemADA	izlemddi	izlemete
kytyklArH	kytyklɑri	kytykleri
kɑleDAn	kɑledɑn	kɑleden
kɑlplArH	kɑlplɑrɯ	kɑlpleri
kɑmpysDA	kɑmpysdɑ	kɑmpyste
kɑmjonH	kɑmjonɯ	kɑmjonu
kɑrʃɯlAAbilmA	kɑrʃɯlɑɑbilmd	kɑrʃɯlɑɑbilme
kɑvimlArH	kɑvimlɑri	kɑvimleri
kɑjbetmAH	kɑjbetmɑi	kɑjbetmei
kɑzɑnAbilmA	kɑzɑnɑbilmd	kɑzɑnɑbilme
keʃfetmA	keʃfetmd	keʃfetme
kemɑlH	kemɑlɯ	kemɑli
kolesterolHn	kolesterolɯn	kolesterolyn
konsorsijumH	konsorsijumi	konsorsijumu
kontrollArDA	kontrollɑrdɑ	kontrollerde
kristɑllAr	kristɑllɑr	kristɑller
kulyplArHHn	kulyplɑriin	kulypleriin
kursijerlArA	kursijerlɑrɑ	kursijerlere
kuruDHkDAn	kurudɯkdɑn	kuruduktɑn
linkA	linkd	linke
livA	livi	live
mɑhɑlleDAn	mɑhɑlledɑn	mɑhɑlleden
mɑhɑllelAr	mɑhɑllelɑr	mɑhɑlleler
mɑmullArHn	mɑmullɑrɯn	mɑmullerin
mɑskelAr	mɑskelɑr	mɑskeler
merʤeklAr	merʤeklɑr	merʤekler
merdivenlArDAn	merdivenlɑrddn	merdivenlerden
mesleksAl	mesleksdl	mesleksel
mideDA	midedɑ	midede
molekylHn	molekylin	molekylyn
molekyllArHn	molekyllɑrin	molekyllerin
nelArDAn	nelɑrdɑn	nelerden
netiʤeA	netiʤei	netiʤee
nitelenAn	nitelendn	nitelenen
okulmHzH	okulmɯzɯ	okulmuzu
operɑtørlArHHn	operɑtørlɑriin	operɑtørleriin
otelmHzA	otelmizd	otelmize
pɑrɑgrɑfDA	pɑrɑgrɑfdɑ	pɑrɑgrɑftɑ
pɑrtilArDA	pɑrtilɑrdɑ	pɑrtilerde
pɑtentDAn	pɑtentddn	pɑtentten
renkDAki	renkddki	renkteki
syrgylH	syrgyli	syrgyly
sytDAn	sytdɑn	sytten
sɑbunlH	sɑbunlɯ	sɑbunlu
sɑvʤɯHHn	sɑvʤɯiin	sɑvʤɯɯɯn
seʧmAA	seʧmɑɑ	seʧmee
sergilArH	sergilɑri	sergileri
sevgilHA	sevgilii	sevgilie
sevmAAn	sevmɑdn	sevmeen
sejretmA	sejretmd	sejretme
sezgisAl	sezgisdl	sezgisel
sitelArDAn	sitelɑrdɑn	sitelerden
stɑdjumH	stɑdjumɯ	stɑdjumu
tyrlArA	tyrlɑrɑ	tyrlere
teʃebbyslArHHn	teʃebbyslɑriin	teʃebbysleriin
teʃekkyrH	teʃekkyri	teʃekkyry
tebliɰA	tebliɰd	tebliɰe
terʤihA	terʤihɑ	terʤihe
turmHz	turmɯz	turmuz
uʧDA	uʧdɑ	uʧtɑ
ulusmHzHn	ulusmɯzɯn	ulusmuzun
ujumHHn	ujumɯin	ujumuun
vɑdilAr	vɑdilɑr	vɑdiler
verimA	verimi	verime
viryslArDAn	viryslɑrdɑn	viryslerden
viryslArA	viryslɑrɑ	viryslere
vurgulAnmAH	vurgulɑnmdi	vurgulɑnmɑɯ
jyklAmAA	jyklɑmɑɑ	jyklemee
jykseklArA	jykseklɑrd	jykseklere
jyksekDAn	jyksekddn	jyksekten
jyryHp	jyryip	jyryyp
jɑpDHklArmHzH	jɑpdɯklɑrmɯzɯ	jɑptɯklɑrmɯzɯ
jediDAn	jediddn	jediden
jenmA	jenmd	jenme
jerleʃArAk	jerleʃɑrɑk	jerleʃerek
jerjyzynH	jerjyzyni	jerjyzyny
jetiʃmA	jetiʃmɑ	jetiʃme
jolsuzlHklArH	jolsuzlɯklɑrɯ	jolsuzluklɑrɯ
jolsuzlHklArA	jolsuzlɯklɑrɑ	jolsuzluklɑrɑ
zɑferA	zɑferɑ	zɑfere
ʧøplArHn	ʧøplɑrin	ʧøplerin
ʧemberlArH	ʧemberlɑri	ʧemberleri
ʧileDAn	ʧileddn	ʧileden
øɰrenmADA	øɰrenmddɑ	øɰrenmede
øɰretimDAki	øɰretimddki	øɰretimdeki
ødemAlArA	ødemɑlɑrd	ødemelere
ødevlArHn	ødevlɑrin	ødevlerin
ølʧylArHn	ølʧylɑrin	ølʧylerin
ønʤylArH	ønʤylɑri	ønʤyleri
ønemDA	ønemdi	ønemde
ørtylAr	ørtylɑr	ørtyler
ʃɑntijeDA	ʃɑntijedɑ	ʃɑntijede
ylkyH	ylkyi	ylkyy
yretiʤiDAn	yretiʤidɑn	yretiʤiden
yzermHzDA	yzermizdi	yzermizde
ɑfetA	ɑfetɑ	ɑfete
ɑkɑdemisjenlArHn	ɑkɑdemisjenlɑrin	ɑkɑdemisjenlerin
ɑlbymlArH	ɑlbymlɑri	ɑlbymleri
ɑrterDAn	ɑrterdɑn	ɑrterden
ɑskerlHkDAn	ɑskerlikdɑn	ɑskerlikten
bølymmHzA	bølymmizi	bølymmyze
bølgemHzDAki	bølgemizddki	bølgemizdeki
belirtilArA	belirtilɑrd	belirtilere
belirtilArHHn	belirtilɑriin	belirtileriin
benimsemAH	benimsemdi	benimsemei
bejinlArH	bejinlɑri	bejinleri
bileʃimlArH	bileʃimlɑri	bileʃimleri
bilmAnHzH	bilmdnizi	bilmenizi
bilmAArAk	bilmɑɑrɑk	bilmeerek
bulHʃlArH	bulɯʃlɑrɯ	buluʃlɑrɯ
bulHʃlArHn	bulɯʃlɑrɯn	buluʃlɑrɯn
ʤiltDAn	ʤiltddn	ʤiltten
døvizlAr	døvizlɑr	døvizler
dyʃynAbiljor	dyʃyndbiljor	dyʃynebiljor
dyzlemA	dyzlemd	dyzleme
dɑvetlHlArA	dɑvetlilɑrɑ	dɑvetlilere
deɰiʃiklHkDAn	deɰiʃiklikdɑn	deɰiʃiklikten
deklɑnʃørA	deklɑnʃørɑ	deklɑnʃøre
delegelArA	delegelɑrd	delegelere
denetimDA	denetimdi	denetimde
desteklAnArAk	desteklɑnɑrɑk	desteklenerek
dikkɑtHn	dikkɑtɯn	dikkɑtin
dikkɑtsHzlHk	dikkɑtsɯzlɯk	dikkɑtsizlik
dilekʧeDA	dilekʧedi	dilekʧede
dinlArA	dinlɑrɑ	dinlere
direklAr	direklɑr	direkler
direklArH	direklɑri	direkleri
disklArH	disklɑri	diskleri
dizinlArH	dizinlɑri	dizinleri
doɰulH	doɰulɯ	doɰulu
doɰumHn	doɰumɯn	doɰumun
domɑteslArH	domɑteslɑri	domɑtesleri
dujguHn	dujguin	dujguun
eʃgydymH	eʃgydymi	eʃgydymy
eʤzɑneDA	eʤzɑnedɑ	eʤzɑnede
eklemDA	eklemdi	eklemde
ekleAn	ekledn	ekleen
eksiklArHn	eksiklɑrin	eksiklerin
elekDAn	elekddn	elekten
elektriklAr	elektriklɑr	elektrikler
emeklilAr	emeklilɑr	emekliler
endiʃeA	endiʃei	endiʃee
erkekDAn	erkekddn	erkekten
etmAAlHm	etmɑɑlim	etmeelim
etrɑfDAki	etrɑfdɑki	etrɑftɑki
figyrH	figyri	figyry
fiilDAn	fiilddn	fiilden
fikirlArHHn	fikirlɑriin	fikirleriin
filmDAn	filmddn	filmden
formlH	formlɯ	formlu
gøsterilArDA	gøsterilɑrdi	gøsterilerde
gybrelArHn	gybrelɑrin	gybrelerin
gyllHk	gyllik	gyllyk
gɑzɑlH	gɑzɑlɯ	gɑzɑli
geʧirmAAn	geʧirmɑdn	geʧirmeen
gebelHkDAn	gebelikdɑn	gebelikten
gelAbilmA	geldbilmi	gelebilme
gerilimlAr	gerilimlɑr	gerilimler
getirDHkDAn	getirdikdɑn	getirdikten
gezilArDA	gezilɑrdi	gezilerde
gijsilArHn	gijsilɑrin	gijsilerin
golH	golɯ	goly
hɑmilHnA	hɑmilind	hɑmiline
hɑstɑnelArDAn	hɑstɑnelɑrdɑn	hɑstɑnelerden
hɑstɑnelArHHn	hɑstɑnelɑriin	hɑstɑneleriin
hɑstɑnemHzA	hɑstɑnemizd	hɑstɑnemize
hissetmA	hissetmd	hissetme
iʃʧilArDAn	iʃʧilɑrdɑn	iʃʧilerden
iʃlAnmA	iʃlɑnmɑ	iʃlenme
idɑreDAn	idɑredɑn	idɑreden
iliʃkilArmHzDA	iliʃkilɑrmizdi	iliʃkilermizde
ishɑlA	ishɑlɑ	ishɑle
islAnmAH	islɑnmɑi	islenmei
istɑtistiklArHn	istɑtistiklɑrin	istɑtistiklerin
kørH	køri	køry
kyltyrmHzA	kyltyrmizd	kyltyrmyze
kyresAllAʃmAA	kyresdlldʃmɑɑ	kyreselleʃmee
kytyphɑnelArDAn	kytyphɑnelɑrdɑn	kytyphɑnelerden
kɑdemelArA	kɑdemelɑrɑ	kɑdemelere
kɑrbonlH	kɑrbonlɯ	kɑrbonlu
kɑrdeʃlArm	kɑrdeʃlɑrm	kɑrdeʃlerm
kɑtɯlmADAn	kɑtɯlmɑdɑn	kɑtɯlmɑtɑn
kedilAr	kedilɑr	kediler
kesilDHkDAn	kesildikdɑn	kesildikten
kesimDAki	kesimddki	kesimdeki
killArH	killɑri	killeri
killArHn	killɑrin	killerin
klɑvjeDAki	klɑvjeddki	klɑvjedeki
koʃulHHn	koʃulɯɯn	koʃuluun
kolonH	kolonɯ	kolonu
kontrollArHn	kontrollɑrɯn	kontrollerin
konumlH	konumlɯ	konumlu
kulyplArHn	kulyplɑrin	kulyplerin
kuruluʃnHzHn	kuruluʃnɯzɯn	kuruluʃnuzun
lyksH	lyksi	lyksy
lehʧelArH	lehʧelɑri	lehʧeleri
linklArA	linklɑrɑ	linklere
liselHlAr	liselilɑr	liseliler
mydɑhɑlelArH	mydɑhɑlelɑri	mydɑhɑleleri
myteɑhhitlArH	myteɑhhitlɑri	myteɑhhitleri
myttefiklArHn	myttefiklɑrin	myttefiklerin
mɑkroH	mɑkroɯ	mɑkrou
mɑzeretlAr	mɑzeretlɑr	mɑzeretler
mesleklArDA	mesleklɑrdɑ	mesleklerde
modemlArH	modemlɑri	modemleri
mutsuzlHk	mutsuzlɯk	mutsuzluk
nehirlArHn	nehirlɑrin	nehirlerin
nesilDAn	nesilddn	nesilden
normH	normɯ	normu
obʒelArH	obʒelɑri	obʒeleri
ordumHz	ordumɯz	ordumuz
otomobilA	otomobilɑ	otomobile
penʤerelArDA	penʤerelɑrdɑ	penʤerelerde
perspektifDAn	perspektifddn	perspektiften
plɑstikDAn	plɑstikdɑn	plɑstikten
proseslArHn	proseslɑrin	proseslerin
resimlArDAn	resimlɑrdɑn	resimlerden
sɯvɯlAʃmA	sɯvɯldʃmɑ	sɯvɯlɑʃmɑ
søjleʃiDA	søjleʃidi	søjleʃide
søjlemADA	søjlemddɑ	søjlemete
søjlemlArH	søjlemlɑri	søjlemleri
søzlArmA	søzlɑrmɑ	søzlerme
syrylArH	syrylɑri	syryleri
sɑhnelAnAn	sɑhnelɑndn	sɑhnelenen
sɑntrɑllArDA	sɑntrɑllɑrdɑ	sɑntrɑllerde
sektørmHzDA	sektørmizdɑ	sektørmyzde
sembollArHn	sembollɑrɯn	sembollerin
seslenAn	seslendn	seslenen
sesDA	sesdɑ	seste
sevijelAr	sevijelɑr	sevijeler
solunumHn	solunumɯn	solunumun
tɑkiplArH	tɑkiplɑri	tɑkipleri
tɑkipDA	tɑkipdɑ	tɑkipte
tɑnelAr	tɑnelɑr	tɑneler
tɑrihʧilArHn	tɑrihʧilɑrin	tɑrihʧilerin
tehditlArA	tehditlɑrɑ	tehditlere
tepkimAlArH	tepkimɑlɑri	tepkimeleri
tiplArHn	tiplɑrin	tiplerin
tohumHn	tohumɯn	tohumun
toklHk	toklɯk	tokluk
toplulukDA	toplulukdɑ	topluluktɑ
uʧHʃA	uʧiʃɑ	uʧuʃɑ
ulɑʃmADA	ulɑʃmɑdɑ	ulɑʃmɑtɑ
urHn	urɯn	urun
vɑdeDAn	vɑdedɑn	vɑdeden
jyklAArAk	jyklɑɑrɑk	jykleerek
jyzmH	jyzmi	jyzmy
jemeklArA	jemeklɑrd	jemeklere
jerleʃmA	jerleʃmɑ	jerleʃme
zijɑretlArDA	zijɑretlɑrdɑ	zijɑretlerde
ʧøzAn	ʧøzɑn	ʧøzen
ʧøzmAH	ʧøzmɑi	ʧøzmei
ʧiftlAʃmA	ʧiftldʃmɑ	ʧiftleʃme
ølʧeklArDA	ølʧeklɑrdɑ	ølʧeklerde
ølymlH	ølymli	ølymly
ønerilArmHz	ønerilɑrmiz	ønerilermiz
ønermA	ønermd	ønerme
ørgytlAnmAlAr	ørgytlɑnmɑlɑr	ørgytlenmeler
ørgytlAnmAHn	ørgytlɑnmɑin	ørgytlenmein
ørgytlArmHz	ørgytlɑrmiz	ørgytlermiz
øzellikDAki	øzellikddki	øzellikteki
øzgeʧmiʃnHzH	øzgeʧmiʃnɯzi	øzgeʧmiʃnizi
ʃɑrtDA	ʃɑrtdɑ	ʃɑrttɑ
ʃiirlArHn	ʃiirlɑrin	ʃiirlerin
ystlHk	ystlik	ystlyk
yjelArDA	yjelɑrdɑ	yjelerde
yzernHzDA	yzernizdɑ	yzernizde
ɑfetlArHn	ɑfetlɑrin	ɑfetlerin
ɑktivɑsjonH	ɑktivɑsjonɯ	ɑktivɑsjonu
ɑlɯʃveriʃlAr	ɑlɯʃveriʃlɑr	ɑlɯʃveriʃler
ɑnnemA	ɑnnemɑ	ɑnneme
ɑrɑziDAn	ɑrɑzidɑn	ɑrɑziden
ɑrmɑtyrlAr	ɑrmɑtyrlɑr	ɑrmɑtyrler
bytynlAʃmAHn	bytynldʃmɑɯn	bytynleʃmein
byjymAHHn	byjymdiin	byjymeiin
bɑhʧelArHHn	bɑhʧelɑriin	bɑhʧeleriin
bɑkmADA	bɑkmɑdɑ	bɑkmɑtɑ
bɑkterilArA	bɑkterilɑrɑ	bɑkterilere
bɑsDHkDAn	bɑsdɯkdɑn	bɑstɯktɑn
beledijelArDAn	beledijelɑrddn	beledijelerden
bilgilArmHz	bilgilɑrmiz	bilgilermiz
bilimDAn	bilimddn	bilimden
ʤɑmiɑHHn	ʤɑmiɑɯin	ʤɑmiɑɯɯn
ʤerrɑhiDA	ʤerrɑhidɑ	ʤerrɑhide
dyɰynA	dyɰynd	dyɰyne
dyʃynHnʤA	dyʃyninʤd	dyʃynynʤe
deɰerlendirmAlArA	deɰerlendirmɑlɑrd	deɰerlendirmelere
deɰiʃkenA	deɰiʃkend	deɰiʃkene
defterDA	defterdɑ	defterde
delegelArHHn	delegelɑriin	delegeleriin
depremlArA	depremlɑrd	depremlere
dergilArHHn	dergilɑriin	dergileriin
dermA	dermɑ	derme
dertlArH	dertlɑri	dertleri
diDA	didɑ	dide
disknHzDA	disknizdɑ	disknizde
doɰruHn	doɰruɯn	doɰruun
dolgulH	dolgulɯ	dolgulu
durummHz	durummɯz	durummuz
eɰilArAk	eɰilɑrɑk	eɰilerek
eʃnHz	eʃnɯz	eʃniz
eʃlemA	eʃlemi	eʃleme
editørlArH	editørlɑri	editørleri
eklAnmA	eklɑnmɑ	eklenme
ekonomilArHHn	ekonomilɑriin	ekonomileriin
eleʃtirilArnHzH	eleʃtirilɑrnizi	eleʃtirilernizi
ellArDAn	ellɑrdɑn	ellerden
elverHʃsHz	elveriʃsɯz	elveriʃsiz
enzimlArH	enzimlɑri	enzimleri
eriʃAn	eriʃɑn	eriʃen
eskilArDAn	eskilɑrdɑn	eskilerden
etkilAnArAk	etkilɑnɑrɑk	etkilenerek
evrenDAki	evrenddki	evrendeki
ejɑletlAr	ejɑletlɑr	ejɑletler
fɑizA	fɑizɑ	fɑize
fikirlArnHzH	fikirlɑrnizi	fikirlernizi
gønyllHlArHn	gønyllilɑrin	gønyllylerin
gøryntyDA	gøryntydi	gøryntyde
gørmAlArnH	gørmɑlɑrnɯ	gørmelerni
gøstermAmHz	gøstermɑmiz	gøstermemiz
gyʧlAnArAk	gyʧlɑnɑrɑk	gyʧlenerek
gyllArH	gyllɑri	gylleri
gymryklAr	gymryklɑr	gymrykler
gɑrɑntilAr	gɑrɑntilɑr	gɑrɑntiler
gɑjretlAr	gɑjretlɑr	gɑjretler
geleʤeklArH	geleʤeklɑri	geleʤekleri
geliʃmAlArDA	geliʃmɑlɑrdɑ	geliʃmelerde
gelinA	gelind	geline
genʧlArHHn	genʧlɑriin	genʧleriin
geniʃlAArAk	geniʃlɑɑrɑk	geniʃleerek
gerADA	gerɑdi	gerede
gereksinimlArA	gereksinimlɑrd	gereksinimlere
getirmADAn	getirmdddn	getirmeden
getirmAlArnH	getirmɑlɑrni	getirmelerni
gevʃemAH	gevʃemdi	gevʃemei
hykymlHlArA	hykymlilɑrɑ	hykymlylere
hɑkemlArHn	hɑkemlɑrin	hɑkemlerin
hɑlmHz	hɑlmɯz	hɑlmiz
hɑpisDA	hɑpisdɑ	hɑpiste
hɑzɯrlAmADA	hɑzɯrlɑmɑdɑ	hɑzɯrlɑmɑtɑ
hekimnHzA	hekimnizd	hekimnize
hipertɑnsijonHn	hipertɑnsijonɯn	hipertɑnsijonun
hissetmAH	hissetmdi	hissetmei
iʧerikDA	iʧerikdi	iʧerikte
iʧnHzDAn	iʧnizddn	iʧnizden
iʧmAHn	iʧmɑin	iʧmein
iʃmA	iʃmɑ	iʃme
iʃlemʤilArH	iʃlemʤilɑri	iʃlemʤileri
iʃverenDAn	iʃverenddn	iʃverenden
ifɑdeDA	ifɑdedɑ	ifɑdede
inmeA	inmei	inmee
ijilAʃmAA	ijildʃmɑɑ	ijileʃmee
izinlArHHn	izinlɑriin	izinleriin
køprylArHn	køprylɑrin	køprylerin
køpryH	køpryi	køpryy
køjlylArDAn	køjlylɑrdɑn	køjlylerden
køjlArDAki	køjlɑrdɑki	køjlerdeki
kɑleDA	kɑledɑ	kɑlede
kɑpitɑlizmA	kɑpitɑlizmɑ	kɑpitɑlizme
kɑrelArH	kɑrelɑri	kɑreleri
kɑzɑnDHkDAn	kɑzɑndɯkdɑn	kɑzɑndɯktɑn
kɑzɑnmADA	kɑzɑnmɑdɑ	kɑzɑnmɑtɑ
kentlAʃmAHn	kentldʃmɑɯn	kentleʃmein
kesintilArHHn	kesintilɑriin	kesintileriin
kilitlAr	kilitlɑr	kilitler
kimseDA	kimsedɑ	kimsede
koɰuʃDA	koɰuʃdɑ	koɰuʃtɑ
kulelAr	kulelɑr	kuleler
kursijerlArHn	kursijerlɑrin	kursijerlerin
kurHʤHnHn	kurɯʤɯnɯn	kuruʤunun
kurumnHzHn	kurumnɯzɯn	kurumnuzun
lezzetlAr	lezzetlɑr	lezzetler
liberɑllAʃmA	liberɑllɑʃmɑ	liberɑlleʃme
linklArDAn	linklɑrdɑn	linklerden
liselArA	liselɑrd	liselere
mɑkɑlelArA	mɑkɑlelɑrɑ	mɑkɑlelere
mɑkinelArA	mɑkinelɑrɑ	mɑkinelere
mɑrketlAr	mɑrketlɑr	mɑrketler
memleketlArH	memleketlɑri	memleketleri
menylArHn	menylɑrin	menylerin
menyH	menyi	menyy
mesleklArA	mesleklɑrd	mesleklere
mesleklArHn	mesleklɑrin	mesleklerin
mitinglAr	mitinglɑr	mitingler
monitørH	monitøri	monitøry
mutlulHkDAn	mutlulɯkdɑn	mutluluktɑn
nesnelArDAn	nesnelɑrdɑn	nesnelerden
normlH	normlɯ	normlu
numunelArHn	numunelɑrin	numunelerin
okurH	okurɯ	okuru
otoritelArHHn	otoritelɑriin	otoriteleriin
pɑmukDA	pɑmukdɑ	pɑmuktɑ
pɑrtikyllArH	pɑrtikyllɑri	pɑrtikylleri
personellArHn	personellɑrin	personellerin
petrolA	petrolɑ	petrole
pistDA	pistdd	pistte
polisDAn	polisdɑn	polisten
potɑnsijellArHHn	potɑnsijellɑriin	potɑnsijelleriin
profilA	profilɑ	profile
proteinlArH	proteinlɑri	proteinleri
reɑksijonHn	reɑksijonɯn	reɑksijonun
rektørA	rektørɑ	rektøre
syrgynDA	syrgyndd	syrgynde
seʧmADA	seʧmɑdɑ	seʧmete
semptomH	semptomi	semptomu
semtDA	semtdɑ	semtte
serɑmiklArH	serɑmiklɑri	serɑmikleri
servislArmHz	servislɑrmiz	servislermiz
sejirʤilArHn	sejirʤilɑrin	sejirʤilerin
sejretmAA	sejretmɑɑ	sejretmee
siʤilDAn	siʤildɑn	siʤilden
sijɑsetʧHlArHn	sijɑsetʧilɑrin	sijɑsetʧilerin
spektrumlH	spektrumli	spektrumlu
suʧHHn	suʧɯɯn	suʧuun
tykenAn	tykendn	tykenen
tykenmA	tykenmd	tykenme
tyrevlArHHn	tyrevlɑriin	tyrevleriin
tytynDAn	tytynddn	tytynden
tɑksiA	tɑksiɑ	tɑksie
tɑlepDAki	tɑlepdɑki	tɑlepteki
teʃviklArH	teʃviklɑri	teʃvikleri
tekellAʃmA	tekelldʃmɑ	tekelleʃme
temelnDAki	temelnddki	temelndeki
temsilʤilArmHz	temsilʤilɑrmiz	temsilʤilermiz
testlArA	testlɑrɑ	testlere
testDAn	testddn	testten
tezDA	tezdd	tezde
toprɑkDAki	toprɑkdɑki	toprɑktɑki
uʧurumH	uʧurumɯ	uʧurumu
vermAA	vermɑi	vermee
vitɑminlArHn	vitɑminlɑrin	vitɑminlerin
jønetmelikDAki	jønetmelikddki	jønetmelikteki
jyklAHp	jykldip	jykleip
jɑvrulArHn	jɑvrulɑrin	jɑvrulɑrɯn
jemADAn	jemddɑn	jemeden
jeniʧerilAr	jeniʧerilɑr	jeniʧeriler
jenmAH	jenmɑi	jenmei
jetersizlHklAr	jetersizliklɑr	jetersizlikler
ʧɯkAbilAn	ʧɯkɑbilɑn	ʧɯkɑbilen
ʧøzymlAmA	ʧøzymlɑmi	ʧøzymleme
ʧøzmADA	ʧøzmɑdɑ	ʧøzmede
ʧekAbilmA	ʧekɑbilmi	ʧekebilme
ʧetelArHHn	ʧetelɑriin	ʧeteleriin
ʧevremDA	ʧevremdi	ʧevremde
ʧevremDAki	ʧevremddki	ʧevremdeki
ʧevremA	ʧevremd	ʧevreme
ʧevrenHzA	ʧevrenizd	ʧevrenize
ʧiʧeklArA	ʧiʧeklɑrd	ʧiʧeklere
ʧizgilArHHn	ʧizgilɑriin	ʧizgileriin
ølʧysHz	ølʧysiz	ølʧysyz
ønʤeA	ønʤei	ønʤee
øzA	øzɑ	øze
ʃølenA	ʃølend	ʃølene
ʃɑrtnɑmelArDA	ʃɑrtnɑmelɑrdɑ	ʃɑrtnɑmelerde
ʃekilDAn	ʃekilddn	ʃekilden
ʃubeDAn	ʃubedɑn	ʃubeden
ynHn	ynin	ynyn
ystmHzA	ystmizd	ystmyze
ɑɰɑʧDA	ɑɰɑʧdɑ	ɑɰɑʧtɑ
ɑdetlAr	ɑdetlɑr	ɑdetler
ɑdetDAn	ɑdetdɑn	ɑdetten
ɑkitlArHHn	ɑkitlɑriin	ɑkitleriin
ɑktørlArHn	ɑktørlɑrin	ɑktørlerin
ɑnneDA	ɑnnedɑ	ɑnnede
ɑjetlAr	ɑjetlɑr	ɑjetler
bølymlArmHz	bølymlɑrmiz	bølymlermiz
bynjemHzDA	bynjemizdi	bynjemizde
byjytAn	byjytdn	byjyten
bɑroHHn	bɑroɯɯn	bɑrouun
beʤerilArA	beʤerilɑrɑ	beʤerilere
bejɑnnɑmeA	bejɑnnɑmeɑ	bejɑnnɑmee
binArAk	binɑrɑk	binerek
birikimlAr	birikimlɑr	birikimler
birleʃmelArH	birleʃmelɑri	birleʃmeleri
ʤehennemA	ʤehennemi	ʤehenneme
døngylAr	døngylɑr	døngyler
dyɰmelAr	dyɰmelɑr	dyɰmeler
dyzenlemADA	dyzenlemddi	dyzenlemete
deɰerlendirmAmHz	deɰerlendirmɑmiz	deɰerlendirmemiz
deklɑrɑsjonH	deklɑrɑsjonɯ	deklɑrɑsjonu
delillArA	delillɑrɑ	delillere
denemeDA	denemedi	denemede
depoHHn	depoiin	depouun
dergilArDAn	dergilɑrdɑn	dergilerden
diʃlArA	diʃlɑrɑ	diʃlere
dinlAHʤHlArHn	dinldiʤilɑrin	dinleiʤilerin
direktiflArDA	direktiflɑrdɑ	direktiflerde
direnmA	direnmd	direnme
doʧentlAr	doʧentlɑr	doʧentler
doɰDHkDAn	doɰdɯkdɑn	doɰduktɑn
dozHHn	dozɯɯn	dozuun
durmADA	durmɑdɑ	durmɑtɑ
durumnHzH	durumnɯzɯ	durumnuzu
ebɑtDA	ebɑtdɑ	ebɑttɑ
ebevejnlArHn	ebevejnlɑrin	ebevejnlerin
eksenlArH	eksenlɑri	eksenleri
engellArA	engellɑrd	engellere
ertesinDA	ertesindd	ertesinde
esirgemAAn	esirgemɑdn	esirgemeen
etkilAnmADAn	etkilɑnmɑdɑn	etkilenmeden
etkinlHkDAn	etkinlikdɑn	etkinlikten
etmAmAlArH	etmɑmɑlɑri	etmemeleri
evlHlHklArH	evliliklɑri	evlilikleri
evvelDAn	evvelddn	evvelden
fɑɑlijetlArmHzH	fɑɑlijetlɑrmizi	fɑɑlijetlermizi
fɑkyltelArA	fɑkyltelɑrɑ	fɑkyltelere
federɑsjonHHn	federɑsjonɯɯn	federɑsjonuun
festivɑlA	festivɑlɑ	festivɑle
fikirDA	fikirdɑ	fikirde
filtrelArHn	filtrelɑrin	filtrelerin
fijɑtDA	fijɑtdɑ	fijɑttɑ
gøryʃmelArmHz	gøryʃmelɑrmiz	gøryʃmelermiz
gørynymHn	gørynymin	gørynymyn
gørynymlAr	gørynymlɑr	gørynymler
gøryntylArDA	gøryntylɑrdi	gøryntylerde
gøryntyHHn	gøryntyiin	gøryntyyyn
gørmAmHzH	gørmɑmɯzɯ	gørmemizi
gøsterilArA	gøsterilɑrd	gøsterilere
gøzlArmA	gøzlɑrmɑ	gøzlerme
gylymseAn	gylymsedn	gylymseen
gymrykDAn	gymrykddn	gymrykten
gyreʃlArH	gyreʃlɑri	gyreʃleri
gyvenʤelAr	gyvenʤelɑr	gyvenʤeler
gyvenliklArH	gyvenliklɑri	gyvenlikleri
gɑzeteDAki	gɑzeteddki	gɑzetedeki
gɑzilAr	gɑzilɑr	gɑziler
geʧAbilmA	geʧibilmi	geʧebilme
geʧAbilmAH	geʧibilmdi	geʧebilmei
geʤikmAHn	geʤikmɑin	geʤikmein
geleneklArA	geleneklɑrd	geleneklere
gerekAnHn	gerekɑnin	gerekenin
hyʤreDAn	hyʤreddn	hyʤreden
hɑlkDA	hɑlkdɑ	hɑlktɑ
hɑvuzHHn	hɑvuziin	hɑvuzuun
hɑzineDAn	hɑzinedɑn	hɑzineden
hislArH	hislɑri	hisleri
iʧmHzDAn	iʧmizddn	iʧmizden
iʧlAr	iʧlɑr	iʧler
idɑreDA	idɑredɑ	idɑrede
iddiɑHHn	iddiɑɯin	iddiɑɯɯn
ideoloʒiA	ideoloʒii	ideoloʒie
inʤelemAlArA	inʤelemɑlɑrd	inʤelemelere
inʤelemAlArHn	inʤelemɑlɑrin	inʤelemelerin
inmAH	inmdi	inmei
istɑsjonHn	istɑsjonɯn	istɑsjonun
istemlArHn	istemlɑrin	istemlerin
itArAk	itɑrɑk	iterek
itmA	itmɑ	itme
izlAHʤHA	izlɑiʤii	izleiʤie
kɯvrɯmlH	kɯvrɯmli	kɯvrɯmlɯ
kɯjmetlArH	kɯjmetlɑri	kɯjmetleri
køʃelArA	køʃelɑrɑ	køʃelere
køkenlArH	køkenlɑri	køkenleri
kyllAr	kyllɑr	kyller
kyreDA	kyredɑ	kyrede
kɑbullAnmA	kɑbullɑnmɑ	kɑbullenme
kɑlibrɑsjonH	kɑlibrɑsjonɯ	kɑlibrɑsjonu
kɑlitelArHHn	kɑlitelɑriin	kɑliteleriin
kɑlplH	kɑlplɯ	kɑlpli
kɑlpDAn	kɑlpdɑn	kɑlpten
kɑmpDAn	kɑmpdɑn	kɑmptɑn
kɑtegoriDAki	kɑtegoriddki	kɑtegorideki
kɑjbetmAmA	kɑjbetmɑmɑ	kɑjbetmeme
kentmHzDA	kentmizdɑ	kentmizde
kereA	kerei	keree
klɑsørlArH	klɑsørlɑri	klɑsørleri
kolonHn	kolonɯn	kolonun
kongreDAn	kongredɑn	kongreden
kontrollArHHn	kontrollɑrɯɯn	kontrolleriin
korumADA	korumɑdɑ	korumɑtɑ
kriterlArDAn	kriterlɑrdɑn	kriterlerden
lɑfDA	lɑfdɑ	lɑftɑ
lezzetlArH	lezzetlɑri	lezzetleri
liseA	lisei	lisee
mydɑhɑleDAn	mydɑhɑledɑn	mydɑhɑleden
myesseselArDA	myesseselɑrdɑ	myesseselerde
mynɑsebetlAr	mynɑsebetlɑr	mynɑsebetler
myzɑkerelArDA	myzɑkerelɑrdɑ	myzɑkerelerde
myzeA	myzei	myzee
myzisjenlAr	myzisjenlɑr	myzisjenler
meʤlisDAki	meʤlisddki	meʤlisteki
mektuplArHn	mektuplɑrin	mektuplɑrɯn
mevsimlAr	mevsimlɑr	mevsimler
mevsimlArDA	mevsimlɑrdɑ	mevsimlerde
milA	mild	mile
modellArDAn	modellɑrdɑn	modellerden
nɑkillArH	nɑkillɑri	nɑkilleri
odɑkDA	odɑkdɑ	odɑktɑ
onlH	onlɯ	onlu
ovɑHHn	ovɑɯin	ovɑɯɯn
pɑrɑmetrelArDAn	pɑrɑmetrelɑrdɑn	pɑrɑmetrelerden
pillAr	pillɑr	piller
rɑfDA	rɑfdɑ	rɑftɑ
reislArH	reislɑri	reisleri
revizjonH	revizjonɯ	revizjonu
sɯʤɑkDA	sɯʤɑkdɑ	sɯʤɑktɑ
sɯrtDA	sɯrtdɑ	sɯrttɑ
sømyryA	sømyryɑ	sømyrye
søzmH	søzmɯ	søzmy
syrelArA	syrelɑrd	syrelere
sɑhillArH	sɑhillɑri	sɑhilleri
sɑnijeDAn	sɑnijedɑn	sɑnijeden
sekreterA	sekreterd	sekretere
sekteA	sektei	sektee
senɑrjoHn	senɑrjoɯn	senɑrjoun
senɑrjoH	senɑrjoɯ	senɑrjou
sendromHHn	sendromɯin	sendromuun
senetDA	senetdd	senette
sergilAnmAA	sergilɑnmɑɑ	sergilenmee
sevinʧDAn	sevinʧdɑn	sevinʧten
simgelArH	simgelɑri	simgeleri
sorumlHlArHn	sorumlɯlɑrɯn	sorumlulɑrɯn
tɯklADHkDAn	tɯklɑdɯkdɑn	tɯklɑdɯktɑn
tyketmA	tyketmd	tyketme
tɑhminlArA	tɑhminlɑrɑ	tɑhminlere
tekellArHn	tekellɑrin	tekellerin
tekliflArDA	tekliflɑrdɑ	tekliflerde
temellArHn	temellɑrin	temellerin
temizlAHp	temizldip	temizleip
temsilA	temsild	temsile
terimlArHHn	terimlɑriin	terimleriin
tipA	tipɑ	tipe
titreAn	titreɑn	titreen
turistlArA	turistlɑrɑ	turistlere
tutumHHn	tutumɯɯn	tutumuun
uʧHʃlAr	uʧiʃlɑr	uʧuʃlɑr
ujkuHn	ujkuɯn	ujkuun
velilArA	velilɑri	velilere
vergilArHHn	vergilɑriin	vergileriin
jyklArA	jyklɑrɑ	jyklere
jyksekʧA	jyksekʧi	jyksekʧe
jyzArAk	jyzɑrɑk	jyzerek
jyzmeA	jyzmei	jyzmee
jɑkAlAAbilmA	jɑkɑlɑɑbilmɑ	jɑkɑlɑɑbilme
jɑnɯtDA	jɑnɯtdɑ	jɑnɯttɑ
jedeklAr	jedeklɑr	jedekler
jernHzA	jernizd	jernize
jokuʃH	jokuʃɯ	jokuʃu
zeminDAn	zeminddn	zeminden
