uf	pred	sf
fɑrklH	fɑrkli	fɑrklɯ
bɑʃkɑnH	bɑʃkɑni	bɑʃkɑnɯ
ɑdH	ɑdi	ɑdɯ
uluslArɑrɑsɯ	uluslerɑrɑsɯ	uluslɑrɑrɑsɯ
oHn	oin	oun
hɯzlH	hɯzli	hɯzlɯ
sɑjɯH	sɑjɯi	sɑjɯɯ
durumH	durumi	durumu
sɑtHʃ	sɑtiʃ	sɑtɯʃ
kɑrɑrH	kɑrɑri	kɑrɑrɯ
yʧnʤH	yʧnʤi	yʧnʤy
kullɑnɯmH	kullɑnɯmi	kullɑnɯmɯ
ɑrɑH	ɑrɑi	ɑrɑɯ
sɑɰlɯklH	sɑɰlɯkli	sɑɰlɯklɯ
kullAnHʤH	kullɑniʤi	kullɑnɯʤɯ
mydyrH	mydyri	mydyry
ɑlɯnmAH	ɑlɯnmɑi	ɑlɯnmɑɯ
orɑnH	orɑni	orɑnɯ
kurumH	kurumi	kurumu
jɑpɯH	jɑpɯi	jɑpɯɯ
kodH	kodi	kodu
sorumlH	sorumli	sorumlu
gynmHzDA	gynmizde	gynmyzde
sorunH	soruni	sorunu
bɑnkɑH	bɑnkɑi	bɑnkɑɯ
olDHklArH	oldiklɑri	olduklɑrɯ
kɑnunHn	kɑnunin	kɑnunun
dɑlH	dɑli	dɑlɯ
kɑjnɑklArH	kɑjnɑklɑri	kɑjnɑklɑrɯ
sonuʧlArH	sonuʧlɑri	sonuʧlɑrɯ
ʧɑlɯʃmAH	ʧɑlɯʃmɑi	ʧɑlɯʃmɑɯ
hɑlkHn	hɑlkin	hɑlkɯn
kɑrtH	kɑrti	kɑrtɯ
sonH	soni	sonu
toplumHn	toplumin	toplumun
insɑnHn	insɑnin	insɑnɯn
ɑlɑnlArH	ɑlɑnlɑri	ɑlɑnlɑrɯ
odɑH	odɑi	odɑɯ
progrɑmlArH	progrɑmlɑri	progrɑmlɑrɯ
enstityH	enstityi	enstityy
kɑnunH	kɑnuni	kɑnunu
ʧoʤuklArHn	ʧoʤuklɑrin	ʧoʤuklɑrɯn
miktɑrH	miktɑri	miktɑrɯ
ɑrtHʃ	ɑrtiʃ	ɑrtɯʃ
hɑstɑlArHn	hɑstɑlɑrin	hɑstɑlɑrɯn
okulH	okuli	okulu
jɯlHn	jɯlin	jɯlɯn
ɑjH	ɑji	ɑjɯ
bulunmAH	bulunmɑi	bulunmɑɯ
ujgulɑmɑH	ujgulɑmɑi	ujgulɑmɑɯ
tyrH	tyri	tyry
progrɑmHn	progrɑmin	progrɑmɯn
ønmHzDAki	ønmizdeki	ønmyzdeki
ɑmɑʧlH	ɑmɑʧli	ɑmɑʧlɯ
numɑrɑH	numɑrɑi	numɑrɑɯ
hɑllArDA	hɑllɑrdɑ	hɑllerde
kurulHHn	kuruliin	kuruluun
detɑjlH	detɑjli	detɑjlɯ
kuruluʃlArH	kuruluʃlɑri	kuruluʃlɑrɯ
ujɑrHnʤA	ujɑrinʤɑ	ujɑrɯnʤɑ
plɑnH	plɑni	plɑnɯ
sɯnɯrlH	sɯnɯrli	sɯnɯrlɯ
jɑjɯnlArH	jɑjɯnlɑri	jɑjɯnlɑrɯ
kontrolH	kontroli	kontroly
ɑlHp	ɑlip	ɑlɯp
ujumlH	ujumli	ujumlu
ʧɯkHʃ	ʧɯkiʃ	ʧɯkɯʃ
tɑrihDAn	tɑrihden	tɑrihten
sektørH	sektøri	sektøry
dɑnɯʃmɑnlHk	dɑnɯʃmɑnlik	dɑnɯʃmɑnlɯk
hɑlkH	hɑlki	hɑlkɯ
ɑnlɑmlH	ɑnlɑmli	ɑnlɑmlɯ
tɑrɑfDAn	tɑrɑfdɑn	tɑrɑftɑn
sɑvɑʃH	sɑvɑʃi	sɑvɑʃɯ
uzmɑnlHk	uzmɑnlik	uzmɑnlɯk
koʃullArH	koʃullɑri	koʃullɑrɯ
sɑɰlAnmAH	sɑɰlɑnmɑi	sɑɰlɑnmɑɯ
ʤezɑH	ʤezɑi	ʤezɑɯ
ʃɑrtlArH	ʃɑrtlɑri	ʃɑrtlɑrɯ
sɯnɯrlArH	sɯnɯrlɑri	sɯnɯrlɑrɯ
tɑsɑrɯmH	tɑsɑrɯmi	tɑsɑrɯmɯ
søzH	søzi	søzy
konulArH	konulɑri	konulɑrɯ
jɑrɑrlH	jɑrɑrli	jɑrɑrlɯ
zɑmɑnH	zɑmɑni	zɑmɑnɯ
hɑjɑtH	hɑjɑti	hɑjɑtɯ
uzɑkDAn	uzɑkdɑn	uzɑktɑn
hɑstɑlɯklArH	hɑstɑlɯklɑri	hɑstɑlɯklɑrɯ
pɑjH	pɑji	pɑjɯ
yrynH	yryni	yryny
bɑzɯlArH	bɑzɯlɑri	bɑzɯlɑrɯ
hɯzH	hɯzi	hɯzɯ
ortɑmH	ortɑmi	ortɑmɯ
sɯnɑvH	sɯnɑvi	sɯnɑvɯ
koruHʤH	koruiʤi	koruuʤu
firmɑlArHn	firmɑlɑrin	firmɑlɑrɯn
tɑrihDA	tɑrihde	tɑrihte
olmAlArH	olmɑlɑri	olmɑlɑrɯ
bɑʃH	bɑʃi	bɑʃɯ
kɑrʃɯlɯklH	kɑrʃɯlɯkli	kɑrʃɯlɯklɯ
ystH	ysti	ysty
ɑrɑʧlArH	ɑrɑʧlɑri	ɑrɑʧlɑrɯ
insɑnlArH	insɑnlɑri	insɑnlɑrɯ
sektørHn	sektørin	sektøryn
noktɑH	noktɑi	noktɑɯ
kuruluʃlArHn	kuruluʃlɑrin	kuruluʃlɑrɯn
ørgytH	ørgyti	ørgyty
kɑvrɑmH	kɑvrɑmi	kɑvrɑmɯ
rolH	roli	roly
yrynHn	yrynin	yrynyn
gruplArH	gruplɑri	gruplɑrɯ
insɑnH	insɑni	insɑnɯ
kɑrɑrlArH	kɑrɑrlɑri	kɑrɑrlɑrɯ
olmADAn	olmɑdɑn	olmɑtɑn
ɑjɑkDA	ɑjɑkdɑ	ɑjɑktɑ
olmAmAH	olmɑmɑi	olmɑmɑɯ
etDHklArH	etdikleri	ettikleri
esɑslArH	esɑsleri	esɑslɑrɯ
konuHn	konuin	konuun
elemɑnlArH	elemɑnlɑri	elemɑnlɑrɯ
tɑmɑmH	tɑmɑmi	tɑmɑmɯ
jɯllArH	jɯllɑri	jɯllɑrɯ
politikɑH	politikɑi	politikɑɯ
sektørHHn	sektøriin	sektøryyn
kurumlArH	kurumlɑri	kurumlɑrɯ
jɯlHHn	jɯliin	jɯlɯɯn
kɑnunHHn	kɑnuniin	kɑnunuun
ʧoʤuklArH	ʧoʤuklɑri	ʧoʤuklɑrɯ
bɑʃɑrɯsHz	bɑʃɑrɯsiz	bɑʃɑrɯsɯz
sonuʧDA	sonuʧdɑ	sonuʧtɑ
hɑklH	hɑkli	hɑklɯ
kɑpsɑmlH	kɑpsɑmli	kɑpsɑmlɯ
konulH	konuli	konulu
ɑnlɑjɯʃH	ɑnlɑjɯʃi	ɑnlɑjɯʃɯ
kyltyrH	kyltyri	kyltyry
soruHn	soruin	soruun
onɑjH	onɑji	onɑjɯ
ɑɰɯrlɯklH	ɑɰɯrlɯkli	ɑɰɯrlɯklɯ
bɑbɑH	bɑbɑi	bɑbɑɯ
jɑʃlH	jɑʃli	jɑʃlɯ
firmɑHn	firmɑin	firmɑɯn
toplumH	toplumi	toplumu
silɑhlH	silɑhli	silɑhlɯ
geleʤekDA	geleʤekde	geleʤekte
devɑmlH	devɑmli	devɑmlɯ
dɑvrɑnHʃ	dɑvrɑniʃ	dɑvrɑnɯʃ
hɑzɯrlAnmAH	hɑzɯrlɑnmɑi	hɑzɯrlɑnmɑɯ
jɑrdɯmH	jɑrdɯmi	jɑrdɯmɯ
sorunlArHn	sorunlɑrin	sorunlɑrɯn
køjH	køji	køjy
durumHn	durumin	durumun
dolɑrH	dolɑri	dolɑrɯ
numɑrɑlH	numɑrɑli	numɑrɑlɯ
olɑjH	olɑji	olɑjɯ
ɑnlɑmH	ɑnlɑmi	ɑnlɑmɯ
fɑjdɑlH	fɑjdɑli	fɑjdɑlɯ
gøryʃH	gøryʃi	gøryʃy
mimɑrlHk	mimɑrlik	mimɑrlɯk
uzmɑnH	uzmɑni	uzmɑnɯ
sigortɑH	sigortɑi	sigortɑɯ
teʃkilɑtH	teʃkilɑti	teʃkilɑtɯ
kurɑllArH	kurɑllɑri	kurɑllɑrɯ
tɑbɑnlH	tɑbɑnli	tɑbɑnlɯ
ʧɑlɯʃmAHn	ʧɑlɯʃmɑin	ʧɑlɯʃmɑɯn
sɑlonH	sɑloni	sɑlonu
ʧɑlɯʃɑnlArHn	ʧɑlɯʃɑnlɑrin	ʧɑlɯʃɑnlɑrɯn
ʧɑlɯʃmAlArHn	ʧɑlɯʃmɑlɑrin	ʧɑlɯʃmɑlɑrɯn
bɑɰlɑntɯH	bɑɰlɑntɯi	bɑɰlɑntɯɯ
telefonH	telefoni	telefonu
uluslAr	ulusler	uluslɑr
orɑnlArH	orɑnlɑri	orɑnlɑrɯ
jɑpɯmH	jɑpɯmi	jɑpɯmɯ
døkymH	døkymi	døkymy
bɑʃkɑnlHk	bɑʃkɑnlik	bɑʃkɑnlɯk
dønHʃ	døniʃ	dønyʃ
olɑjlArH	olɑjlɑri	olɑjlɑrɯ
sɯʤɑklHk	sɯʤɑklik	sɯʤɑklɯk
sempozjumH	sempozjumi	sempozjumu
olmAHn	olmɑin	olmɑɯn
jɑzɯlɯmH	jɑzɯlɯmi	jɑzɯlɯmɯ
tymH	tymi	tymy
dɑɰɯlɯmH	dɑɰɯlɯmi	dɑɰɯlɯmɯ
zɑrɑrlH	zɑrɑrli	zɑrɑrlɯ
hɑlkHHn	hɑlkiin	hɑlkɯɯn
ɑrtHʃH	ɑrtiʃi	ɑrtɯʃɯ
etmADA	etmede	etmete
jɑsɑH	jɑsɑi	jɑsɑɯ
fijɑtlArH	fijɑtlɑri	fijɑtlɑrɯ
mutlulHk	mutlulik	mutluluk
rɑhɑtsHz	rɑhɑtsiz	rɑhɑtsɯz
sɑɑtlArH	sɑɑtlɑri	sɑɑtleri
tɑrɑfH	tɑrɑfi	tɑrɑfɯ
progrɑmHHn	progrɑmiin	progrɑmɯɯn
usulH	usuli	usuly
sɑjfɑH	sɑjfɑi	sɑjfɑɯ
fijɑtH	fijɑti	fijɑtɯ
ɑʃkHn	ɑʃkin	ɑʃkɯn
ødylH	ødyli	ødyly
ɑɰH	ɑɰi	ɑɰɯ
bojutlH	bojutli	bojutlu
ʧɑlɯʃmAlArHHn	ʧɑlɯʃmɑlɑriin	ʧɑlɯʃmɑlɑrɯɯn
dosjɑlArH	dosjɑlɑri	dosjɑlɑrɯ
jɑʃɑmH	jɑʃɑmi	jɑʃɑmɯ
hukukH	hukuki	hukuku
gynmHzA	gynmize	gynmyze
kɑdɯnlArHn	kɑdɯnlɑrin	kɑdɯnlɑrɯn
rɑporlArH	rɑporlɑri	rɑporlɑrɯ
kurtulHʃ	kurtuliʃ	kurtuluʃ
kurumlArHn	kurumlɑrin	kurumlɑrɯn
hɑjɑtHn	hɑjɑtin	hɑjɑtɯn
notH	noti	notu
mesɑʒH	mesɑʒi	mesɑʒɯ
dosjɑH	dosjɑi	dosjɑɯ
jɑjɯmH	jɑjɯmi	jɑjɯmɯ
dynjɑH	dynjɑi	dynjɑɯ
olmAksHzHn	olmɑksizin	olmɑksɯzɯn
ɑkɯllH	ɑkɯlli	ɑkɯllɯ
sɑvɑʃHn	sɑvɑʃin	sɑvɑʃɯn
jønetmelikDA	jønetmelikde	jønetmelikte
jyzjɯlHn	jyzjɯlin	jyzjɯlɯn
jɑʃɑmHn	jɑʃɑmin	jɑʃɑmɯn
ʧɯkmAH	ʧɯkmɑi	ʧɯkmɑɯ
ɑrɑʃtɯrmAlArH	ɑrɑʃtɯrmɑlɑri	ɑrɑʃtɯrmɑlɑrɯ
hɑftɑlHk	hɑftɑlik	hɑftɑlɯk
nitelikDA	nitelikde	nitelikte
ɑnlɑʃmɑH	ɑnlɑʃmɑi	ɑnlɑʃmɑɯ
ʃɑrtH	ʃɑrti	ʃɑrtɯ
bɑʃlɑngɯʧDA	bɑʃlɑngɯʧdɑ	bɑʃlɑngɯʧtɑ
gynmHz	gynmiz	gynmyz
kɑdɯnHn	kɑdɯnin	kɑdɯnɯn
kɑrɑrHn	kɑrɑrin	kɑrɑrɯn
jɑpɯlArH	jɑpɯlɑri	jɑpɯlɑrɯ
bojutH	bojuti	bojutu
ɑlHʃ	ɑliʃ	ɑlɯʃ
odɑlArH	odɑlɑri	odɑlɑrɯ
sigortɑlH	sigortɑli	sigortɑlɯ
durumlArH	durumlɑri	durumlɑrɯ
kɑpsɑmH	kɑpsɑmi	kɑpsɑmɯ
okulHn	okulin	okulun
mezunH	mezuni	mezunu
sɑtHʃH	sɑtiʃi	sɑtɯʃɯ
binɑHn	binɑin	binɑɯn
insɑnlHk	insɑnlik	insɑnlɯk
sɑjɯlArH	sɑjɯlɑri	sɑjɯlɑrɯ
tɑbɑnH	tɑbɑni	tɑbɑnɯ
ɑvukɑtlHk	ɑvukɑtlik	ɑvukɑtlɯk
nyfusH	nyfusi	nyfusu
politikɑlArH	politikɑlɑri	politikɑlɑrɯ
sɯnɯfH	sɯnɯfi	sɯnɯfɯ
fonH	foni	fonu
kullAnHʤHnHn	kullɑniʤinin	kullɑnɯʤɯnɯn
tɑrɑfDA	tɑrɑfdɑ	tɑrɑftɑ
ihtijɑʧlArH	ihtijɑʧlɑri	ihtijɑʧlɑrɯ
jønlH	jønli	jønly
ɑdɑmH	ɑdɑmi	ɑdɑmɯ
ɑrkɑdɑʃlArH	ɑrkɑdɑʃlɑri	ɑrkɑdɑʃlɑrɯ
kuruluʃlArHHn	kuruluʃlɑriin	kuruluʃlɑrɯɯn
jɯllArHn	jɯllɑrin	jɯllɑrɯn
ʤihɑzH	ʤihɑzi	ʤihɑzɯ
grupDA	grupdɑ	gruptɑ
ɑjHn	ɑjin	ɑjɯn
kɑjnɑklArHn	kɑjnɑklɑrin	kɑjnɑklɑrɯn
sɑnɑtʧH	sɑnɑtʧi	sɑnɑtʧɯ
ɑdɑjlArHn	ɑdɑjlɑrin	ɑdɑjlɑrɯn
firmɑH	firmɑi	firmɑɯ
stɑndɑrtlArH	stɑndɑrtlɑri	stɑndɑrtlɑrɯ
ɑrtmAH	ɑrtmɑi	ɑrtmɑɯ
geʧmiʃDA	geʧmiʃde	geʧmiʃte
geliʃmADA	geliʃmede	geliʃmete
memurH	memuri	memuru
jyzH	jyzi	jyzy
esɑslArA	esɑslere	esɑslɑrɑ
ujgunlHk	ujgunlik	ujgunluk
jønH	jøni	jøny
kurulHn	kurulin	kurulun
ɑɰrɯH	ɑɰrɯi	ɑɰrɯɯ
kitɑplArH	kitɑplɑri	kitɑplɑrɯ
komutH	komuti	komutu
devɑmH	devɑmi	devɑmɯ
fonksijonH	fonksijoni	fonksijonu
hɑjɑtDA	hɑjɑtdɑ	hɑjɑttɑ
bɑʃvuruH	bɑʃvurui	bɑʃvuruu
jɑrɯH	jɑrɯi	jɑrɯɯ
kuruluʃHn	kuruluʃin	kuruluʃun
pɑhɑlH	pɑhɑli	pɑhɑlɯ
pɑrʧɑlArH	pɑrʧɑlɑri	pɑrʧɑlɑrɯ
ʧɑlɯʃmAH	ʧɑlɯʃmɑi	ʧɑlɯʃmɑɯ
elemɑnH	elemɑni	elemɑnɯ
fɑrklHlHk	fɑrklilik	fɑrklɯlɯk
yʧDA	yʧde	yʧte
fonksijonlArH	fonksijonlɑri	fonksijonlɑrɯ
bɑʃbɑkɑnlHk	bɑʃbɑkɑnlik	bɑʃbɑkɑnlɯk
dynjɑH	dynjɑi	dynjɑɯ
tɑkɯmH	tɑkɯmi	tɑkɯmɯ
bɑʃlɯklH	bɑʃlɯkli	bɑʃlɯklɯ
kɑrʃɯmHzA	kɑrʃɯmize	kɑrʃɯmɯzɑ
sɯnɯrsHz	sɯnɯrsiz	sɯnɯrsɯz
iʃDAn	iʃden	iʃten
kolH	koli	kolu
hɑklArHHn	hɑklɑriin	hɑklɑrɯɯn
jɑpHp	jɑpip	jɑpɯp
hesɑplArH	hesɑplɑri	hesɑplɑrɯ
tutɑrH	tutɑri	tutɑrɯ
doɰruH	doɰrui	doɰruu
plɑnlAmAH	plɑnlɑmɑi	plɑnlɑmɑɯ
jɑsɑHn	jɑsɑin	jɑsɑɯn
jɑjɯnH	jɑjɯni	jɑjɯnɯ
ølymH	ølymi	ølymy
ɑdlArH	ɑdlɑri	ɑdlɑrɯ
mɑlH	mɑli	mɑlɯ
progrɑmlArHHn	progrɑmlɑriin	progrɑmlɑrɯɯn
hɑjvɑnlArHn	hɑjvɑnlɑrin	hɑjvɑnlɑrɯn
kɑrtlArH	kɑrtlɑri	kɑrtlɑrɯ
ojunlArH	ojunlɑri	ojunlɑrɯ
ɑmɑʧlArH	ɑmɑʧlɑri	ɑmɑʧlɑrɯ
kuʃkusHz	kuʃkusiz	kuʃkusuz
oluʃumH	oluʃumi	oluʃumu
imɑlɑtH	imɑlɑti	imɑlɑtɯ
olɑjlArHn	olɑjlɑrin	olɑjlɑrɯn
konulArHn	konulɑrin	konulɑrɯn
ʧɑlɯʃɑnlArH	ʧɑlɯʃɑnlɑri	ʧɑlɯʃɑnlɑrɯ
ʤihɑzlArH	ʤihɑzlɑri	ʤihɑzlɑrɯ
kɑtɯlɯmH	kɑtɯlɯmi	kɑtɯlɯmɯ
orduH	ordui	orduu
performɑnsH	performɑnsi	performɑnsɯ
ɑlɑnHn	ɑlɑnin	ɑlɑnɯn
fɑbrikɑH	fɑbrikɑi	fɑbrikɑɯ
jyksekokulH	jyksekokuli	jyksekokulu
gørHnʤA	gørinʤe	gørynʤe
hɑksHz	hɑksiz	hɑksɯz
ruhsɑtH	ruhsɑti	ruhsɑtɯ
jɑpɯlArHn	jɑpɯlɑrin	jɑpɯlɑrɯn
tɑrzH	tɑrzi	tɑrzɯ
tuʃH	tuʃi	tuʃu
kɑtkɯH	kɑtkɯi	kɑtkɯɯ
plɑnlArH	plɑnlɑri	plɑnlɑrɯ
jɑpmADA	jɑpmɑdɑ	jɑpmɑtɑ
jɑtɯrɯmlArH	jɑtɯrɯmlɑri	jɑtɯrɯmlɑrɯ
zɑmɑnHn	zɑmɑnin	zɑmɑnɯn
fɯrsɑtH	fɯrsɑti	fɯrsɑtɯ
bilgisɑjɑrHn	bilgisɑjɑrin	bilgisɑjɑrɯn
burɑH	burɑi	burɑɯ
kɑvrɑmlArH	kɑvrɑmlɑri	kɑvrɑmlɑrɯ
fɑrklHlHklAr	fɑrkliliklɑr	fɑrklɯlɯklɑr
orgɑnlArH	orgɑnlɑri	orgɑnlɑrɯ
tutulmɑH	tutulmɑi	tutulmɑɯ
bɑʃDAn	bɑʃdɑn	bɑʃtɑn
konumH	konumi	konumu
jɑpmAnHz	jɑpmɑniz	jɑpmɑnɯz
bɑʃlH	bɑʃli	bɑʃlɯ
mɑllArHn	mɑllɑrin	mɑllɑrɯn
jɑklɑʃɯmH	jɑklɑʃɯmi	jɑklɑʃɯmɯ
doɰumlH	doɰumli	doɰumlu
dɑvrɑnHʃlArH	dɑvrɑniʃlɑri	dɑvrɑnɯʃlɑrɯ
sɯnɯrH	sɯnɯri	sɯnɯrɯ
ujgulɑmɑHn	ujgulɑmɑin	ujgulɑmɑɯn
ʧoʤuklHk	ʧoʤuklik	ʧoʤukluk
dosjɑH	dosjɑi	dosjɑɯ
sɑjfɑlArH	sɑjfɑlɑri	sɑjfɑlɑrɯ
uʧHʃ	uʧiʃ	uʧuʃ
jolHn	jolin	jolun
ʃɑnsH	ʃɑnsi	ʃɑnsɯ
kɑpɯH	kɑpɯi	kɑpɯɯ
dolɑrlHk	dolɑrlik	dolɑrlɯk
fɑzlɑH	fɑzlɑi	fɑzlɑɯ
ʧɯkHp	ʧɯkip	ʧɯkɯp
ɑlɑnlArHn	ɑlɑnlɑrin	ɑlɑnlɑrɯn
ortɑlɑmɑH	ortɑlɑmɑi	ortɑlɑmɑɯ
bɑkɯmH	bɑkɯmi	bɑkɯmɯ
kɑlmAH	kɑlmɑi	kɑlmɑɯ
numɑrɑlArH	numɑrɑlɑri	numɑrɑlɑrɯ
olmAHHn	olmɑiin	olmɑɯɯn
kɑrɑrlH	kɑrɑrli	kɑrɑrlɯ
bølymHn	bølymin	bølymyn
orɑnHHn	orɑniin	orɑnɯɯn
ɑjɑrlArH	ɑjɑrlɑri	ɑjɑrlɑrɯ
sɑtHʃA	sɑtiʃɑ	sɑtɯʃɑ
ɑlɯmH	ɑlɯmi	ɑlɯmɯ
tɑnɯtɯmH	tɑnɯtɯmi	tɑnɯtɯmɯ
jykH	jyki	jyky
kɑnɑlH	kɑnɑli	kɑnɑlɯ
sorumluH	sorumlui	sorumluu
kɑjnɑklH	kɑjnɑkli	kɑjnɑklɯ
tɑbloH	tɑbloi	tɑblou
progrɑmlArHn	progrɑmlɑrin	progrɑmlɑrɯn
syreʧDA	syreʧde	syreʧte
uzmɑnlArH	uzmɑnlɑri	uzmɑnlɑrɯ
tɑrɑflH	tɑrɑfli	tɑrɑflɯ
orgɑnizɑsjonH	orgɑnizɑsjoni	orgɑnizɑsjonu
bølymHHn	bølymiin	bølymyyn
pijɑsɑH	pijɑsɑi	pijɑsɑɯ
rɑporHn	rɑporin	rɑporun
zɑmɑnlH	zɑmɑnli	zɑmɑnlɯ
plɑnlH	plɑnli	plɑnlɯ
firmɑlArH	firmɑlɑri	firmɑlɑrɯ
pɑzɑrH	pɑzɑri	pɑzɑrɯ
jɑzɯlArH	jɑzɯlɑri	jɑzɯlɑrɯ
pɑrɑH	pɑrɑi	pɑrɑɯ
jyklH	jykli	jykly
ɑlɯnHp	ɑlɯnip	ɑlɯnɯp
bɑʃɑrɯH	bɑʃɑrɯi	bɑʃɑrɯɯ
dolɑjlH	dolɑjli	dolɑjlɯ
bɑɰlɑntɯlH	bɑɰlɑntɯli	bɑɰlɑntɯlɯ
bulunmADA	bulunmɑdɑ	bulunmɑtɑ
hukukHn	hukukin	hukukun
nyfusHn	nyfusin	nyfusun
jɑzɯHn	jɑzɯin	jɑzɯɯn
kɑplH	kɑpli	kɑplɯ
nolH	noli	nolu
sɑklH	sɑkli	sɑklɯ
tɑmɑmlɑnmAH	tɑmɑmlɑnmɑi	tɑmɑmlɑnmɑɯ
ʧoklH	ʧokli	ʧoklu
soruH	sorui	soruu
hɑtlArH	hɑtlɑri	hɑtlɑrɯ
sytH	syti	syty
bɑʃkɑnlArH	bɑʃkɑnlɑri	bɑʃkɑnlɑrɯ
okullArH	okullɑri	okullɑrɯ
olAnH	olɑni	olɑnɯ
ɑjdɯnlHk	ɑjdɯnlik	ɑjdɯnlɯk
bojutlArH	bojutlɑri	bojutlɑrɯ
ɑdɑmlArH	ɑdɑmlɑri	ɑdɑmlɑrɯ
kitɑpDA	kitɑpdɑ	kitɑptɑ
bulgulArH	bulgulɑri	bulgulɑrɯ
toplɑmH	toplɑmi	toplɑmɯ
hɑstɑlɯklArHn	hɑstɑlɯklɑrin	hɑstɑlɯklɑrɯn
bɑɰɯmsɯzlHk	bɑɰɯmsɯzlik	bɑɰɯmsɯzlɯk
jyryHʃ	jyryiʃ	jyryyʃ
bɑnkɑlArHn	bɑnkɑlɑrin	bɑnkɑlɑrɯn
gøzH	gøzi	gøzy
køjHn	køjin	køjyn
ɑkHʃH	ɑkiʃi	ɑkɯʃɯ
sojɑdH	sojɑdi	sojɑdɯ
memurlArH	memurlɑri	memurlɑrɯ
sulArH	sulɑri	sulɑrɯ
fotoɰrɑfH	fotoɰrɑfi	fotoɰrɑfɯ
kɑrɑrHHn	kɑrɑriin	kɑrɑrɯɯn
ujgulɑmɑlArHn	ujgulɑmɑlɑrin	ujgulɑmɑlɑrɯn
dɑvɑHn	dɑvɑin	dɑvɑɯn
kolɑjlHk	kolɑjlik	kolɑjlɯk
kɑbulH	kɑbuli	kɑbuly
kurulmHz	kurulmiz	kurulmuz
ɑlɑnlArHHn	ɑlɑnlɑriin	ɑlɑnlɑrɯɯn
komutɑnH	komutɑni	komutɑnɯ
fuɑrH	fuɑri	fuɑrɯ
sɑhɑH	sɑhɑi	sɑhɑɯ
ɑrɑʧlArHn	ɑrɑʧlɑrin	ɑrɑʧlɑrɯn
kurumlArHHn	kurumlɑriin	kurumlɑrɯɯn
tɑnɯH	tɑnɯi	tɑnɯɯ
bɑnkɑHn	bɑnkɑin	bɑnkɑɯn
dersDA	dersde	derste
kullɑnɯmHHn	kullɑnɯmiin	kullɑnɯmɯɯn
tɑʃɯHʤH	tɑʃɯiʤi	tɑʃɯɯʤɯ
ɑslH	ɑsli	ɑslɯ
gølH	gøli	gøly
gørynymH	gørynymi	gørynymy
ilɑʧlArHn	ilɑʧlɑrin	ilɑʧlɑrɯn
tɑsɑrrufH	tɑsɑrrufi	tɑsɑrrufu
bɑʃlɑmAH	bɑʃlɑmɑi	bɑʃlɑmɑɯ
dynjɑHHn	dynjɑiin	dynjɑɯɯn
pɑrɑH	pɑrɑi	pɑrɑɯ
toplɑnmAH	toplɑnmɑi	toplɑnmɑɯ
kɑrHn	kɑrin	kɑrɯn
tɑrihlArDA	tɑrihlerdɑ	tɑrihlerde
toplɑntɯlArH	toplɑntɯlɑri	toplɑntɯlɑrɯ
dɑnɯʃmɑnH	dɑnɯʃmɑni	dɑnɯʃmɑnɯ
ʧɯkHʃH	ʧɯkiʃi	ʧɯkɯʃɯ
dostlHk	dostlik	dostluk
mɑkinɑlArH	mɑkinɑlɑri	mɑkinɑlɑrɯ
dɑvɑH	dɑvɑi	dɑvɑɯ
sɯnɯfDA	sɯnɯfdɑ	sɯnɯftɑ
kɑdroH	kɑdroi	kɑdrou
kurumHHn	kurumiin	kurumuun
topDAn	topdɑn	toptɑn
olmAHp	olmɑip	olmɑɯp
onɑjlH	onɑjli	onɑjlɯ
jɑzɯlɯmlArH	jɑzɯlɯmlɑri	jɑzɯlɯmlɑrɯ
oluʃmAH	oluʃmɑi	oluʃmɑɯ
bɑʃkɑnHHn	bɑʃkɑniin	bɑʃkɑnɯɯn
elemɑnlArHHn	elemɑnlɑriin	elemɑnlɑrɯɯn
kontrollH	kontrolli	kontrolly
miktɑrHHn	miktɑriin	miktɑrɯɯn
ynvɑnH	ynvɑni	ynvɑnɯ
dosjɑHn	dosjɑin	dosjɑɯn
ɑltDA	ɑltdɑ	ɑlttɑ
mekɑnizmɑH	mekɑnizmɑi	mekɑnizmɑɯ
menyH	menyi	menyy
sigɑrɑH	sigɑrɑi	sigɑrɑɯ
ʧoʤuklArHHn	ʧoʤuklɑriin	ʧoʤuklɑrɯɯn
bɑʃkɑnHn	bɑʃkɑnin	bɑʃkɑnɯn
motorlH	motorli	motorlu
jɑʃDA	jɑʃdɑ	jɑʃtɑ
bɑɰlɑntɯlArH	bɑɰlɑntɯlɑri	bɑɰlɑntɯlɑrɯ
sorunlArHHn	sorunlɑriin	sorunlɑrɯɯn
dujguH	dujgui	dujguu
pɑrɑHn	pɑrɑin	pɑrɑɯn
ɑrɑʃtɯrmAH	ɑrɑʃtɯrmɑi	ɑrɑʃtɯrmɑɯ
ekrɑnH	ekrɑni	ekrɑnɯ
komisjonHn	komisjonin	komisjonun
notlArH	notlɑri	notlɑrɯ
sɯrɑH	sɯrɑi	sɯrɑɯ
hɑftɑH	hɑftɑi	hɑftɑɯ
olmAnHz	olmɑniz	olmɑnɯz
sɯnɑvlArH	sɯnɑvlɑri	sɯnɑvlɑrɯ
kɑtkɯlArH	kɑtkɯlɑri	kɑtkɯlɑrɯ
modylH	modyli	modyly
tɑrɑfHn	tɑrɑfin	tɑrɑfɯn
ɑkɯmH	ɑkɯmi	ɑkɯmɯ
jɑrɯʃmɑH	jɑrɯʃmɑi	jɑrɯʃmɑɯ
ɑdHHn	ɑdiin	ɑdɯɯn
sɑnɑtlArH	sɑnɑtlɑri	sɑnɑtlɑrɯ
bɑbɑHHn	bɑbɑiin	bɑbɑɯɯn
binɑlArHn	binɑlɑrin	binɑlɑrɯn
kollArH	kollɑri	kollɑrɯ
miktɑrlArH	miktɑrlɑri	miktɑrlɑrɯ
sendromH	sendromi	sendromu
unsurH	unsuri	unsuru
durumHHn	durumiin	durumuun
sonuʧlArHHn	sonuʧlɑriin	sonuʧlɑrɯɯn
teminɑtH	teminɑti	teminɑtɯ
ʧɑbɑlArH	ʧɑbɑlɑri	ʧɑbɑlɑrɯ
renkDA	renkde	renkte
jɑʃH	jɑʃi	jɑʃɯ
ɑdɑjHn	ɑdɑjin	ɑdɑjɯn
ɑlmADA	ɑlmɑdɑ	ɑlmɑtɑ
plɑtformH	plɑtformi	plɑtformu
bilgisɑjɑrH	bilgisɑjɑri	bilgisɑjɑrɯ
ʤezɑlArH	ʤezɑlɑri	ʤezɑlɑrɯ
hɑtɑlH	hɑtɑli	hɑtɑlɯ
mɑkinɑH	mɑkinɑi	mɑkinɑɯ
tɑnɯmlArH	tɑnɯmlɑri	tɑnɯmlɑrɯ
olDHkDAn	oldikden	olduktɑn
ɑvɑntɑʒH	ɑvɑntɑʒi	ɑvɑntɑʒɯ
fɑɑlijetDA	fɑɑlijetde	fɑɑlijette
ekrɑnHn	ekrɑnin	ekrɑnɯn
tɑsɑrɯH	tɑsɑrɯi	tɑsɑrɯɯ
ʧɑɰH	ʧɑɰi	ʧɑɰɯ
ɑjHHn	ɑjiin	ɑjɯɯn
bojutDA	bojutdɑ	bojuttɑ
ʧɑlɯʃmAlArmHz	ʧɑlɯʃmɑlɑrmiz	ʧɑlɯʃmɑlɑrmɯz
bɑjɯndɯrlHk	bɑjɯndɯrlik	bɑjɯndɯrlɯk
ørgytHn	ørgytin	ørgytyn
fotoɰrɑfHn	fotoɰrɑfin	fotoɰrɑfɯn
ruhsAl	ruhsel	ruhsɑl
tɑrɑflArHn	tɑrɑflɑrin	tɑrɑflɑrɯn
mensuplArH	mensuplɑri	mensuplɑrɯ
ulɑʃmAH	ulɑʃmɑi	ulɑʃmɑɯ
firmɑmHz	firmɑmiz	firmɑmɯz
jɑrɑrH	jɑrɑri	jɑrɑrɯ
jɑprɑklArH	jɑprɑklɑri	jɑprɑklɑrɯ
kɑrʃɯnHzA	kɑrʃɯnizɑ	kɑrʃɯnɯzɑ
hɑklArHn	hɑklɑrin	hɑklɑrɯn
sɑjfɑHn	sɑjfɑin	sɑjfɑɯn
sigortɑlHHn	sigortɑliin	sigortɑlɯɯn
suʧH	suʧi	suʧu
bulAn	bulen	bulɑn
dɑvrɑnHʃH	dɑvrɑniʃi	dɑvrɑnɯʃɯ
konferɑnsH	konferɑnsi	konferɑnsɯ
krɑlH	krɑli	krɑlɯ
sulH	suli	sulu
kutuH	kutui	kutuu
mɑllArH	mɑllɑri	mɑllɑrɯ
dɑllArH	dɑllɑri	dɑllɑrɯ
kɑrɑrlArHn	kɑrɑrlɑrin	kɑrɑrlɑrɯn
orgɑnH	orgɑni	orgɑnɯ
ojunHn	ojunin	ojunun
sorunHHn	soruniin	sorunuun
topH	topi	topu
ujgulɑmɑlArHHn	ujgulɑmɑlɑriin	ujgulɑmɑlɑrɯɯn
jɑɰlH	jɑɰli	jɑɰlɯ
ɑkHʃ	ɑkiʃ	ɑkɯʃ
hɑlkmHzHn	hɑlkmizin	hɑlkmɯzɯn
mɑrkɑH	mɑrkɑi	mɑrkɑɯ
ɑʧɯH	ɑʧɯi	ɑʧɯɯ
ɑlmAlArH	ɑlmɑlɑri	ɑlmɑlɑrɯ
ɑrkɑdɑʃH	ɑrkɑdɑʃi	ɑrkɑdɑʃɯ
puɑnH	puɑni	puɑnɯ
okullArHn	okullɑrin	okullɑrɯn
jɑzHp	jɑzip	jɑzɯp
fɯkrɑH	fɯkrɑi	fɯkrɑɯ
hɑritɑH	hɑritɑi	hɑritɑɯ
ɑtɯklArHn	ɑtɯklɑrin	ɑtɯklɑrɯn
divɑnH	divɑni	divɑnɯ
federɑsjonH	federɑsjoni	federɑsjonu
dokuH	dokui	dokuu
protokolH	protokoli	protokoly
suretDA	suretde	surette
bɑzlH	bɑzli	bɑzlɯ
dɑɰɯtɯmH	dɑɰɯtɯmi	dɑɰɯtɯmɯ
gørHp	gørip	gøryp
hɑvuzH	hɑvuzi	hɑvuzu
kɑnɑllArH	kɑnɑllɑri	kɑnɑllɑrɯ
olHʃH	oliʃi	oluʃu
sorulArHn	sorulɑrin	sorulɑrɯn
bɑskɯH	bɑskɯi	bɑskɯɯ
geleʤekDAki	geleʤekdeki	geleʤekteki
opsijonH	opsijoni	opsijonu
jɑpmAlArH	jɑpmɑlɑri	jɑpmɑlɑrɯ
bɑʃlɑHp	bɑʃlɑip	bɑʃlɑɯp
kɯʃHn	kɯʃin	kɯʃɯn
kɑnlH	kɑnli	kɑnlɯ
ʧɑlɯʃɑnlArHHn	ʧɑlɯʃɑnlɑriin	ʧɑlɯʃɑnlɑrɯɯn
dønHp	dønip	dønyp
ɑvɑntɑʒlArH	ɑvɑntɑʒlɑri	ɑvɑntɑʒlɑrɯ
bɑsɯlH	bɑsɯli	bɑsɯlɯ
hɑftɑHn	hɑftɑin	hɑftɑɯn
hɑvɑHn	hɑvɑin	hɑvɑɯn
nyfusHHn	nyfusiin	nyfusuun
sɑnɑtDA	sɑnɑtdɑ	sɑnɑttɑ
toprɑklArH	toprɑklɑri	toprɑklɑrɯ
vermADA	vermede	vermete
tɑnɯmlAnmAH	tɑnɯmlɑnmɑi	tɑnɯmlɑnmɑɯ
vɑtɑndɑʃlArHn	vɑtɑndɑʃlɑrin	vɑtɑndɑʃlɑrɯn
ɑdɑmHn	ɑdɑmin	ɑdɑmɯn
pɑrkH	pɑrki	pɑrkɯ
jykymlH	jykymli	jykymly
ɑlDHkDAn	ɑldikdɑn	ɑldɯktɑn
hɑjɑtHHn	hɑjɑtiin	hɑjɑtɯɯn
jɑtɯrɯmlArHn	jɑtɯrɯmlɑrin	jɑtɯrɯmlɑrɯn
zorlHk	zorlik	zorluk
ɑdɑjH	ɑdɑji	ɑdɑjɯ
bɯrɑkHp	bɯrɑkip	bɯrɑkɯp
internetDA	internetde	internette
kɑrʃɯtH	kɑrʃɯti	kɑrʃɯtɯ
uzɑkDA	uzɑkdɑ	uzɑktɑ
inʃɑɑtH	inʃɑɑti	inʃɑɑtɯ
normɑlDA	normɑldɑ	normɑlde
gruplArHn	gruplɑrin	gruplɑrɯn
soruH	sorui	soruu
hesɑplAnAn	hesɑplɑnen	hesɑplɑnɑn
unsurlArH	unsurlɑri	unsurlɑrɯ
joksullHk	joksullik	joksulluk
ɑɰlArH	ɑɰlɑri	ɑɰlɑrɯ
bɑʃlɯklArH	bɑʃlɯklɑri	bɑʃlɯklɑrɯ
ʤihɑzlArHn	ʤihɑzlɑrin	ʤihɑzlɑrɯn
koordinɑsjonH	koordinɑsjoni	koordinɑsjonu
tɑʃɯnmAH	tɑʃɯnmɑi	tɑʃɯnmɑɯ
dostH	dosti	dostu
zɑrɑrH	zɑrɑri	zɑrɑrɯ
dyʃHʃ	dyʃiʃ	dyʃyʃ
ʧɑɰHn	ʧɑɰin	ʧɑɰɯn
ʧokDAn	ʧokdɑn	ʧoktɑn
dersDAn	dersden	dersten
mezunlArH	mezunlɑri	mezunlɑrɯ
ruhH	ruhi	ruhu
vɑtɑndɑʃH	vɑtɑndɑʃi	vɑtɑndɑʃɯ
jɑnɯtH	jɑnɯti	jɑnɯtɯ
ɑjrɯlmɑH	ɑjrɯlmɑi	ɑjrɯlmɑɯ
hɑvɑH	hɑvɑi	hɑvɑɯ
operɑsjonH	operɑsjoni	operɑsjonu
hɑtɑlArH	hɑtɑlɑri	hɑtɑlɑrɯ
uzɑklɯkDA	uzɑklɯkdɑ	uzɑklɯktɑ
ɑrɑʃtɯrmAHn	ɑrɑʃtɯrmɑin	ɑrɑʃtɯrmɑɯn
sonuʧlArHn	sonuʧlɑrin	sonuʧlɑrɯn
jɑpɯHHn	jɑpɯiin	jɑpɯɯɯn
øjkyH	øjkyi	øjkyy
dɑvrɑnHʃlAr	dɑvrɑniʃlɑr	dɑvrɑnɯʃlɑr
istɑsjonH	istɑsjoni	istɑsjonu
sɑvɑʃDA	sɑvɑʃdɑ	sɑvɑʃtɑ
ʧɑplH	ʧɑpli	ʧɑplɯ
gɑzH	gɑzi	gɑzɯ
kɑrlH	kɑrli	kɑrlɯ
kullɑnmAH	kullɑnmɑi	kullɑnmɑɯ
jɑrɑlH	jɑrɑli	jɑrɑlɯ
øzlHk	øzlik	øzlyk
kɑtɯlmAH	kɑtɯlmɑi	kɑtɯlmɑɯ
konuʃmAH	konuʃmɑi	konuʃmɑɯ
mevzuɑtH	mevzuɑti	mevzuɑtɯ
ønʤylHk	ønʤylik	ønʤylyk
ɑlɑʤɑklArH	ɑlɑʤɑklɑri	ɑlɑʤɑklɑrɯ
kyltyrHHn	kyltyriin	kyltyryyn
koʃullArHn	koʃullɑrin	koʃullɑrɯn
doɰɑHn	doɰɑin	doɰɑɯn
hykymlH	hykymli	hykymly
tutɑrlH	tutɑrli	tutɑrlɯ
dɑlHʃ	dɑliʃ	dɑlɯʃ
diplomɑH	diplomɑi	diplomɑɯ
geʧDHkʧA	geʧdikʧe	geʧtikʧe
jɑpDHkDAn	jɑpdikdɑn	jɑptɯktɑn
kɯsɯmlArH	kɯsɯmlɑri	kɯsɯmlɑrɯ
jɑpAʤAklArH	jɑpɑʤɑklɑri	jɑpɑʤɑklɑrɯ
bolH	boli	bolu
sɑɑtlAr	sɑɑtlɑr	sɑɑtler
sokɑkDA	sokɑkdɑ	sokɑktɑ
ʧɑlɯʃmADA	ʧɑlɯʃmɑdɑ	ʧɑlɯʃmɑtɑ
sɑɑtlArDA	sɑɑtlɑrdɑ	sɑɑtlerde
tɯrmɑnHʃ	tɯrmɑniʃ	tɯrmɑnɯʃ
ɑzɑlmAH	ɑzɑlmɑi	ɑzɑlmɑɯ
bɑʃkɑnmHz	bɑʃkɑnmiz	bɑʃkɑnmɯz
dɑɰH	dɑɰi	dɑɰɯ
esɑslH	esɑsli	esɑslɯ
gørDHklArH	gørdikleri	gørdykleri
koʃullArHHn	koʃullɑriin	koʃullɑrɯɯn
okuHʤH	okuiʤi	okuuʤu
kurulumH	kurulumi	kurulumu
sɑɰlɑmAH	sɑɰlɑmɑi	sɑɰlɑmɑɯ
sorunsHz	sorunsiz	sorunsuz
firmɑHHn	firmɑiin	firmɑɯɯn
jɑʃɑDHklArH	jɑʃɑdiklɑri	jɑʃɑdɯklɑrɯ
ɑʧɯklɑmAlArH	ɑʧɯklɑmɑlɑri	ɑʧɯklɑmɑlɑrɯ
bulHp	bulip	bulup
sonrɑlArH	sonrɑlɑri	sonrɑlɑrɯ
ɑrɑʧlArHHn	ɑrɑʧlɑriin	ɑrɑʧlɑrɯɯn
kirɑlHk	kirɑlik	kirɑlɯk
ʧɑlɯʃmAHHn	ʧɑlɯʃmɑiin	ʧɑlɯʃmɑɯɯn
ɑlɯnDHkDAn	ɑlɯndikdɑn	ɑlɯndɯktɑn
kɑrʃɯlAnmAH	kɑrʃɯlɑnmɑi	kɑrʃɯlɑnmɑɯ
olmADHkʧA	olmɑdikʧɑ	olmɑdɯkʧɑ
sunuʤuH	sunuʤui	sunuʤuu
telefonlArH	telefonleri	telefonlɑrɯ
tuzlH	tuzli	tuzlu
ɑrtDHkʧA	ɑrtdikʧɑ	ɑrttɯkʧɑ
olmADA	olmɑdɑ	olmɑtɑ
pɑjlɑʃɯmH	pɑjlɑʃɯmi	pɑjlɑʃɯmɯ
gøryntyH	gøryntyi	gøryntyy
gruplArHHn	gruplɑriin	gruplɑrɯɯn
sɑjɯsHz	sɑjɯsiz	sɑjɯsɯz
ujgulɑmɑHHn	ujgulɑmɑiin	ujgulɑmɑɯɯn
jɑsɑlArH	jɑsɑlɑri	jɑsɑlɑrɯ
jɑtɯrɯmH	jɑtɯrɯmi	jɑtɯrɯmɯ
ʧɑpDA	ʧɑpdɑ	ʧɑptɑ
ɑʃɯH	ɑʃɯi	ɑʃɯɯ
mekɑnizmɑlArH	mekɑnizmɑlɑri	mekɑnizmɑlɑrɯ
mesɑʒlArH	mesɑʒlɑri	mesɑʒlɑrɯ
motorH	motori	motoru
sporlArH	sporlɑri	sporlɑrɯ
bɑʃvurulArH	bɑʃvurulɑri	bɑʃvurulɑrɯ
ʤihɑzHn	ʤihɑzin	ʤihɑzɯn
kuruluʃHHn	kuruluʃiin	kuruluʃuun
kutlH	kutli	kutlu
oturHp	oturip	oturup
hɑrʤɑmAlArH	hɑrʤɑmɑlɑri	hɑrʤɑmɑlɑrɯ
hususDA	hususdɑ	husustɑ
pɑrʧɑlArHn	pɑrʧɑlɑrin	pɑrʧɑlɑrɯn
sulArHn	sulɑrin	sulɑrɯn
duvɑrH	duvɑri	duvɑrɯ
geʧDHkDAn	geʧdikden	geʧtikten
kitɑplArHn	kitɑplɑrin	kitɑplɑrɯn
bɑɰɯʃɯklHk	bɑɰɯʃɯklik	bɑɰɯʃɯklɯk
bɑjrɑmH	bɑjrɑmi	bɑjrɑmɯ
kyltyrHn	kyltyrin	kyltyryn
odɑklH	odɑkli	odɑklɯ
rɑstlAnAn	rɑstlɑnen	rɑstlɑnɑn
tɑmɑmHHn	tɑmɑmiin	tɑmɑmɯɯn
jɑɰHʃ	jɑɰiʃ	jɑɰɯʃ
bugynHn	bugynin	bugynyn
bulAʃHʤH	buleʃiʤi	bulɑʃɯʤɯ
tipDA	tipde	tipte
ɑnɑjɑsɑHn	ɑnɑjɑsɑin	ɑnɑjɑsɑɯn
bulunmAmAH	bulunmɑmɑi	bulunmɑmɑɯ
ujgulɑmɑH	ujgulɑmɑi	ujgulɑmɑɯ
lisɑnsH	lisɑnsi	lisɑnsɯ
odɑHn	odɑin	odɑɯn
odɑmHz	odɑmiz	odɑmɯz
politikɑHHn	politikɑiin	politikɑɯɯn
bɑʃɑrɯH	bɑʃɑrɯi	bɑʃɑrɯɯ
bilgisɑjɑrlArHn	bilgisɑjɑrlɑrin	bilgisɑjɑrlɑrɯn
olguH	olgui	olguu
tɑnɯmlH	tɑnɯmli	tɑnɯmlɯ
ɑɰɑʧlArH	ɑɰɑʧlɑri	ɑɰɑʧlɑrɯ
ɑnlɑjɯʃHHn	ɑnlɑjɯʃiin	ɑnlɑjɯʃɯɯn
gynmHzHn	gynmizin	gynmyzyn
hɑstɑH	hɑstɑi	hɑstɑɯ
ortɑmHn	ortɑmin	ortɑmɯn
ojH	oji	oju
suʧlH	suʧli	suʧlu
tɑzminɑtH	tɑzminɑti	tɑzminɑtɯ
vɑtɑndɑʃHn	vɑtɑndɑʃin	vɑtɑndɑʃɯn
jɑpAlHm	jɑpɑlim	jɑpɑlɯm
ʧɑbɑH	ʧɑbɑi	ʧɑbɑɯ
burɑH	burɑi	burɑɯ
gruplArA	gruplɑre	gruplɑrɑ
kurslArH	kurslɑri	kurslɑrɯ
oʤɑklArH	oʤɑklɑri	oʤɑklɑrɯ
sertifikɑH	sertifikɑi	sertifikɑɯ
tɑbɑkɑH	tɑbɑkɑi	tɑbɑkɑɯ
tɑrɑfsHz	tɑrɑfsiz	tɑrɑfsɯz
øzH	øzi	øzy
bɑʃkɑH	bɑʃkɑi	bɑʃkɑɯ
hɑstɑlArH	hɑstɑlɑri	hɑstɑlɑrɯ
hɑjvɑnlArH	hɑjvɑnlɑri	hɑjvɑnlɑrɯ
kentDA	kentde	kentte
lɑborɑtuvɑrH	lɑborɑtuvɑri	lɑborɑtuvɑrɯ
olɑnɑklH	olɑnɑkli	olɑnɑklɯ
bɑʃɑrɯHn	bɑʃɑrɯin	bɑʃɑrɯɯn
bɑrɯʃH	bɑrɯʃi	bɑrɯʃɯ
bulunHp	bulunip	bulunup
dɑkikɑlHk	dɑkikɑlik	dɑkikɑlɯk
kɑpɯH	kɑpɯi	kɑpɯɯ
kɑvrɑmHHn	kɑvrɑmiin	kɑvrɑmɯɯn
kɑjɯtlArHn	kɑjɯtlɑrin	kɑjɯtlɑrɯn
ortɑklArH	ortɑklɑri	ortɑklɑrɯ
tɑmɑmlAmHʃ	tɑmɑmlɑmiʃ	tɑmɑmlɑmɯʃ
jɑʃHn	jɑʃin	jɑʃɯn
hɑzɯrlɯklArH	hɑzɯrlɯklɑri	hɑzɯrlɯklɑrɯ
hususH	hususi	hususu
huzurlH	huzurli	huzurlu
kodlArH	kodlɑri	kodlɑrɯ
suʧHn	suʧin	suʧun
toplumHHn	toplumiin	toplumuun
tutumH	tutumi	tutumu
dujgulArH	dujgulɑri	dujgulɑrɯ
etmADAn	etmeden	etmeten
firmɑlArHHn	firmɑlɑriin	firmɑlɑrɯɯn
kokuH	kokui	kokuu
stɑtyH	stɑtyi	stɑtyy
turH	turi	turu
usullArH	usullɑri	usulleri
ʧɑjH	ʧɑji	ʧɑjɯ
ɑʧHp	ɑʧip	ɑʧɯp
kojHp	kojip	kojup
ortɑmHHn	ortɑmiin	ortɑmɯɯn
ʧɯkɑrlArH	ʧɯkɑrlɑri	ʧɯkɑrlɑrɯ
ɑdɯmH	ɑdɯmi	ɑdɯmɯ
ɑntlɑʃmɑH	ɑntlɑʃmɑi	ɑntlɑʃmɑɯ
bɑsɯnʧlH	bɑsɯnʧli	bɑsɯnʧlɯ
bilgisɑjɑrnHzA	bilgisɑjɑrnizɑ	bilgisɑjɑrnɯzɑ
lirɑH	lirɑi	lirɑɯ
jyryrlykDA	jyryrlykde	jyryrlykte
jɑʃlArH	jɑʃlɑri	jɑʃlɑrɯ
enflɑsjonHn	enflɑsjonin	enflɑsjonun
ihrɑʤɑtH	ihrɑʤɑti	ihrɑʤɑtɯ
ilɑʧlArH	ilɑʧlɑri	ilɑʧlɑrɯ
rɑporHHn	rɑporiin	rɑporuun
jɑpɯH	jɑpɯi	jɑpɯɯ
jɑtɑklH	jɑtɑkli	jɑtɑklɯ
kɑzɑH	kɑzɑi	kɑzɑɯ
ɑʃɑmɑH	ɑʃɑmɑi	ɑʃɑmɑɯ
ɑrkɑdɑʃmHz	ɑrkɑdɑʃmiz	ɑrkɑdɑʃmɯz
kɑdɯnH	kɑdɯni	kɑdɯnɯ
jyryrlykDAn	jyryrlykden	jyryrlykten
dɑɰlArH	dɑɰlɑri	dɑɰlɑrɯ
orduHHn	orduiin	orduuun
sɯkɯntɯH	sɯkɯntɯi	sɯkɯntɯɯ
ujumH	ujumi	ujumu
jɑʃɑmHHn	jɑʃɑmiin	jɑʃɑmɯɯn
jɑzɯlɯmHn	jɑzɯlɯmin	jɑzɯlɯmɯn
ɑdɑHn	ɑdɑin	ɑdɑɯn
bɑzɯlArHHn	bɑzɯlɑriin	bɑzɯlɑrɯɯn
dujDHklArH	dujdiklɑri	dujduklɑrɯ
kokulH	kokuli	kokulu
okulmHz	okulmiz	okulmuz
tijɑtroH	tijɑtroi	tijɑtrou
ʧɑlɯʃDHklArH	ʧɑlɯʃdiklɑri	ʧɑlɯʃtɯklɑrɯ
ølʧymH	ølʧymi	ølʧymy
bɑɰlAnmAH	bɑɰlɑnmɑi	bɑɰlɑnmɑɯ
bɑʃvurAnHn	bɑʃvurɑnin	bɑʃvurɑnɯn
kɑpɯlArH	kɑpɯlɑri	kɑpɯlɑrɯ
sɑbɑhH	sɑbɑhi	sɑbɑhɯ
sɑjfɑH	sɑjfɑi	sɑjfɑɯ
ujruklH	ujrukli	ujruklu
jɑkɯnlArH	jɑkɯnlɑri	jɑkɯnlɑrɯ
bilgisɑjɑrlH	bilgisɑjɑrli	bilgisɑjɑrlɯ
borʧlH	borʧli	borʧlu
kɯlɑvuzH	kɯlɑvuzi	kɯlɑvuzu
kɑnunlArH	kɑnunlɑri	kɑnunlɑrɯ
kɑpɯHn	kɑpɯin	kɑpɯɯn
kɑtDA	kɑtdɑ	kɑttɑ
kontrollArH	kontrollɑri	kontrolleri
ɑrkɑdɑʃlArHHn	ɑrkɑdɑʃlɑriin	ɑrkɑdɑʃlɑrɯɯn
binɑlArH	binɑlɑri	binɑlɑrɯ
binɑHHn	binɑiin	binɑɯɯn
sɑnɑtʧHHn	sɑnɑtʧiin	sɑnɑtʧɯɯn
vyʤutDA	vyʤutdɑ	vyʤuttɑ
kɑrɑrlArHHn	kɑrɑrlɑriin	kɑrɑrlɑrɯɯn
sɑjgɯlH	sɑjgɯli	sɑjgɯlɯ
jykymlHlHklArH	jykymlilikleri	jykymlylykleri
ʃɑrtlArHn	ʃɑrtlɑrin	ʃɑrtlɑrɯn
sɑnɑtHn	sɑnɑtin	sɑnɑtɯn
koordinɑtørH	koordinɑtøri	koordinɑtøry
orduHn	orduin	orduun
sunumH	sunumi	sunumu
ɑrɑmHzDA	ɑrɑmizde	ɑrɑmɯzdɑ
metodlArH	metodleri	metodlɑrɯ
bɑrɑʒH	bɑrɑʒi	bɑrɑʒɯ
bitDHkDAn	bitdikden	bittikten
etDHkDAn	etdikden	ettikten
hususlArH	hususlɑri	hususlɑrɯ
orɑntɯlH	orɑntɯli	orɑntɯlɯ
tɑlimɑtH	tɑlimɑti	tɑlimɑtɯ
jolHHn	joliin	joluun
ɑnnelAr	ɑnnelɑr	ɑnneler
ɑjɑrH	ɑjɑri	ɑjɑrɯ
noktɑH	noktɑi	noktɑɯ
virysH	virysi	virysy
yʧlH	yʧli	yʧly
byjyklHkDA	byjyklikde	byjyklykte
bɑʃvuruHn	bɑʃvuruin	bɑʃvuruun
enfeksijonH	enfeksijoni	enfeksijonu
ilɑnH	ilɑni	ilɑnɯ
kɑrɯʃɯmH	kɑrɯʃɯmi	kɑrɯʃɯmɯ
komutlArH	komutlɑri	komutlɑrɯ
kusursHz	kusursiz	kusursuz
ʧɑpH	ʧɑpi	ʧɑpɯ
ørtyH	ørtyi	ørtyy
ɑkʃɑmH	ɑkʃɑmi	ɑkʃɑmɯ
ɑjlArH	ɑjlɑri	ɑjlɑrɯ
kɯzHn	kɯzin	kɯzɯn
sɑɰlAHʤH	sɑɰlɑiʤi	sɑɰlɑɯʤɯ
ʧɯkɑrHp	ʧɯkɑrip	ʧɯkɑrɯp
jɑtɯrɯmHn	jɑtɯrɯmin	jɑtɯrɯmɯn
ɑʧɯklɑmAHn	ɑʧɯklɑmɑin	ɑʧɯklɑmɑɯn
sɑɑtA	sɑɑtɑ	sɑɑte
jɑzɑrHn	jɑzɑrin	jɑzɑrɯn
politikɑlArHn	politikɑlɑrin	politikɑlɑrɯn
donɑnɯmH	donɑnɯmi	donɑnɯmɯ
dosjɑlArHn	dosjɑlɑrin	dosjɑlɑrɯn
telefonlAr	telefonler	telefonlɑr
ʧɑlɯʃɑnH	ʧɑlɯʃɑni	ʧɑlɯʃɑnɯ
ɑktɑrɯmH	ɑktɑrɯmi	ɑktɑrɯmɯ
ʤezɑHHn	ʤezɑiin	ʤezɑɯɯn
hɑllAr	hɑllɑr	hɑller
hesɑplAnmAH	hesɑplɑnmɑi	hesɑplɑnmɑɯ
mɑsonlHk	mɑsonlik	mɑsonluk
jɯldɯzlH	jɯldɯzli	jɯldɯzlɯ
ɑlkollH	ɑlkolli	ɑlkolly
rektørH	rektøri	rektøry
ʧɑtɯH	ʧɑtɯi	ʧɑtɯɯ
ɑdɑjlArH	ɑdɑjlɑri	ɑdɑjlɑrɯ
ɑlmAnHz	ɑlmɑniz	ɑlmɑnɯz
dɑɰlHk	dɑɰlik	dɑɰlɯk
insɑnHHn	insɑniin	insɑnɯɯn
lisɑnssHz	lisɑnssiz	lisɑnssɯz
jɑpmADAn	jɑpmɑdɑn	jɑpmɑtɑn
joɰunlHk	joɰunlik	joɰunluk
bytynH	bytyni	bytyny
doɰHʃ	doɰiʃ	doɰuʃ
fonHn	fonin	fonun
montɑʒH	montɑʒi	montɑʒɯ
prɑtikDA	prɑtikde	prɑtikte
syrymH	syrymi	syrymy
toplumlArHn	toplumlɑrin	toplumlɑrɯn
ujgɑrlHk	ujgɑrlik	ujgɑrlɯk
bɑroH	bɑroi	bɑrou
gøzHn	gøzin	gøzyn
sendikɑH	sendikɑi	sendikɑɯ
tesisDA	tesisde	tesiste
bɑkHp	bɑkip	bɑkɯp
rektørlHk	rektørlik	rektørlyk
ʧɑɰrɯH	ʧɑɰrɯi	ʧɑɰrɯɯ
ɑlbymH	ɑlbymi	ɑlbymy
ɑnlɑʃmɑlArH	ɑnlɑʃmɑlɑri	ɑnlɑʃmɑlɑrɯ
doktorH	doktori	doktoru
hɑstɑlɯkDAn	hɑstɑlɯkdɑn	hɑstɑlɯktɑn
jɑnnHzDA	jɑnnizdɑ	jɑnnɯzdɑ
jɑjɯlmɑH	jɑjɯlmɑi	jɑjɯlmɑɯ
ørgytHHn	ørgytiin	ørgytyyn
bɑnkɑlArH	bɑnkɑlɑri	bɑnkɑlɑrɯ
bulmAA	bulmɑe	bulmɑɑ
eʃjɑHn	eʃjɑin	eʃjɑɯn
søzHn	søzin	søzyn
ɑnɑhtɑrH	ɑnɑhtɑri	ɑnɑhtɑrɯ
ɑrkɑdɑʃlArmHzHn	ɑrkɑdɑʃlɑrmizin	ɑrkɑdɑʃlɑrmɯzɯn
duvɑrlArH	duvɑrlɑri	duvɑrlɑrɯ
imzɑH	imzɑi	imzɑɯ
ønH	øni	øny
ɑʃɑmɑlArH	ɑʃɑmɑlɑri	ɑʃɑmɑlɑrɯ
bytynlHk	bytynlik	bytynlyk
bɑʃbɑkɑnH	bɑʃbɑkɑni	bɑʃbɑkɑnɯ
bozuklHk	bozuklik	bozukluk
dujɑrlɯlHk	dujɑrlɯlik	dujɑrlɯlɯk
kɑrʃɯlɯksHz	kɑrʃɯlɯksiz	kɑrʃɯlɯksɯz
kupɑH	kupɑi	kupɑɯ
tɯpDA	tɯpdɑ	tɯptɑ
tɑblolArH	tɑblolɑri	tɑblolɑrɯ
zɑrɑrlArH	zɑrɑrlɑri	zɑrɑrlɑrɯ
ɑʧɯlɯʃH	ɑʧɯlɯʃi	ɑʧɯlɯʃɯ
ɑltɯnʤH	ɑltɯnʤi	ɑltɯnʤɯ
bursH	bursi	bursu
esɑsH	esɑsi	esɑsɯ
gøryntyH	gøryntyi	gøryntyy
nitelikDAki	nitelikdeki	nitelikteki
olmAmHz	olmɑmiz	olmɑmɯz
jɑpmAHn	jɑpmɑin	jɑpmɑɯn
ʧɑntɑH	ʧɑntɑi	ʧɑntɑɯ
ɑrɑʃtɯrmAlArHn	ɑrɑʃtɯrmɑlɑrin	ɑrɑʃtɯrmɑlɑrɯn
ɑrɑʤɯlHk	ɑrɑʤɯlik	ɑrɑʤɯlɯk
finɑnsmɑnH	finɑnsmɑni	finɑnsmɑnɯ
hɯrsɯzlHk	hɯrsɯzlik	hɯrsɯzlɯk
hizmetDAn	hizmetden	hizmetten
kurɑlH	kurɑli	kurɑlɯ
kurɑmH	kurɑmi	kurɑmɯ
mɑkbuzH	mɑkbuzi	mɑkbuzu
orɑHn	orɑin	orɑɯn
jɑprɑklArHn	jɑprɑklɑrin	jɑprɑklɑrɯn
ʃɑrtlArHHn	ʃɑrtlɑriin	ʃɑrtlɑrɯɯn
medjɑHn	medjɑin	medjɑɯn
rɑporlArHn	rɑporlɑrin	rɑporlɑrɯn
tɑbloHn	tɑbloin	tɑbloun
ɑjrɯmH	ɑjrɯmi	ɑjrɯmɯ
jolsuzlHk	jolsuzlik	jolsuzluk
depoH	depoi	depou
hɑstɑnelArDA	hɑstɑnelerdɑ	hɑstɑnelerde
tonH	toni	tonu
jɑzɯlArHn	jɑzɯlɑrin	jɑzɯlɑrɯn
køpryH	køpryi	køpryy
kɑrtHn	kɑrtin	kɑrtɯn
sɑɑtDAn	sɑɑtdɑn	sɑɑtten
versijonH	versijoni	versijonu
ɑtHʃ	ɑtiʃ	ɑtɯʃ
dekɑnH	dekɑni	dekɑnɯ
detɑjlArH	detɑjlɑri	detɑjlɑrɯ
eʃjɑlArH	eʃjɑlɑri	eʃjɑlɑrɯ
kɑrɯH	kɑrɯi	kɑrɯɯ
jɑklɑʃɯmlArH	jɑklɑʃɯmlɑri	jɑklɑʃɯmlɑrɯ
ystDA	ystde	ystte
ɑvɑntɑʒlH	ɑvɑntɑʒli	ɑvɑntɑʒlɯ
bɑbɑHn	bɑbɑin	bɑbɑɯn
fɑrklHlHklArH	fɑrkliliklɑri	fɑrklɯlɯklɑrɯ
istɑsjonlArH	istɑsjonlɑri	istɑsjonlɑrɯ
kɑzɑlArH	kɑzɑlɑri	kɑzɑlɑrɯ
kɑzɑnmAH	kɑzɑnmɑi	kɑzɑnmɑɯ
korkuH	korkui	korkuu
onurlH	onurli	onurlu
ʃɑmpijonɑH	ʃɑmpijonɑi	ʃɑmpijonɑɯ
ɑmelijɑtH	ɑmelijɑti	ɑmelijɑtɯ
ɑrɑlɯksHz	ɑrɑlɯksiz	ɑrɑlɯksɯz
ɑjrɯntɯlArH	ɑjrɯntɯlɑri	ɑjrɯntɯlɑrɯ
bɑslAr	bɑsler	bɑslɑr
elemɑnlArHn	elemɑnlɑrin	elemɑnlɑrɯn
entegrɑsjonH	entegrɑsjoni	entegrɑsjonu
pɑzɑrHn	pɑzɑrin	pɑzɑrɯn
tɑmɑmlADHkDAn	tɑmɑmlɑdikdɑn	tɑmɑmlɑdɯktɑn
tɑrɑfDAki	tɑrɑfdɑki	tɑrɑftɑki
jyryrlykDAki	jyryrlykdeki	jyryrlykteki
dyʃmɑnH	dyʃmɑni	dyʃmɑnɯ
kɑrtHHn	kɑrtiin	kɑrtɯɯn
politikɑlArHHn	politikɑlɑriin	politikɑlɑrɯɯn
sigɑrɑHn	sigɑrɑin	sigɑrɑɯn
jollArHn	jollɑrin	jollɑrɯn
ørnekDA	ørnekde	ørnekte
ɑdɑmlArHHn	ɑdɑmlɑriin	ɑdɑmlɑrɯɯn
ɑʒɑnsH	ɑʒɑnsi	ɑʒɑnsɯ
devletDAn	devletden	devletten
mydyrHn	mydyrin	mydyryn
sonsHzA	sonsize	sonsuzɑ
ømyrlH	ømyrli	ømyrly
borʧlArH	borʧlɑri	borʧlɑrɯ
limɑnH	limɑni	limɑnɯ
mɑrkɑHn	mɑrkɑin	mɑrkɑɯn
unvɑnH	unvɑni	unvɑnɯ
vɑsɯtɑH	vɑsɯtɑi	vɑsɯtɑɯ
ɯsɯH	ɯsɯi	ɯsɯɯ
yʧH	yʧi	yʧy
bɑɰlɑntɯH	bɑɰlɑntɯi	bɑɰlɑntɯɯ
kɑzɑHn	kɑzɑin	kɑzɑɯn
komisjonHHn	komisjoniin	komisjonuun
muhtɑrH	muhtɑri	muhtɑrɯ
nyfusA	nyfuse	nyfusɑ
tɑrtɯʃmAlArH	tɑrtɯʃmɑlɑri	tɑrtɯʃmɑlɑrɯ
vɑrHʃ	vɑriʃ	vɑrɯʃ
hɯzHHn	hɯziin	hɯzɯɯn
hɑlkDAn	hɑlkdɑn	hɑlktɑn
komisjonlArH	komisjonlɑri	komisjonlɑrɯ
mydyrHHn	mydyriin	mydyryyn
jollArHHn	jollɑriin	jollɑrɯɯn
dønyʃymH	dønyʃymi	dønyʃymy
dɑjɑnɯklɯlHk	dɑjɑnɯklɯlik	dɑjɑnɯklɯlɯk
hɑstɑlɯklArHHn	hɑstɑlɯklɑriin	hɑstɑlɯklɑrɯɯn
internetDAn	internetden	internetten
kenɑrlArH	kenɑrlɑri	kenɑrlɑrɯ
sembolH	semboli	semboly
ørgytlH	ørgytli	ørgytly
hesɑplArHn	hesɑplɑrin	hesɑplɑrɯn
orɑnlArHHn	orɑnlɑriin	orɑnlɑrɯɯn
sɑvɑʃDAn	sɑvɑʃdɑn	sɑvɑʃtɑn
vɑkɑlArHn	vɑkɑlɑrin	vɑkɑlɑrɯn
jorgunlHk	jorgunlik	jorgunluk
yjelHkDAn	yjelikden	yjelikten
bozuklHklAr	bozukliklɑr	bozukluklɑr
etɑpDA	etɑpdɑ	etɑptɑ
formylH	formyli	formyly
kylH	kyli	kyly
konuʃmAlArH	konuʃmɑlɑri	konuʃmɑlɑrɯ
mɑsɑH	mɑsɑi	mɑsɑɯ
olɑnɑksHz	olɑnɑksiz	olɑnɑksɯz
ortɑlɑmɑHHn	ortɑlɑmɑiin	ortɑlɑmɑɯɯn
plɑnlAnmAH	plɑnlɑnmɑi	plɑnlɑnmɑɯ
rɑkɑmlArH	rɑkɑmlɑri	rɑkɑmlɑrɯ
tɑʃlArH	tɑʃlɑri	tɑʃlɑrɯ
jɑzɯlɯmlArHn	jɑzɯlɯmlɑrin	jɑzɯlɯmlɑrɯn
ɑnlɑmsHz	ɑnlɑmsiz	ɑnlɑmsɯz
fotoɰrɑflArHn	fotoɰrɑflɑrin	fotoɰrɑflɑrɯn
iktidɑrH	iktidɑri	iktidɑrɯ
plɑnlArHHn	plɑnlɑriin	plɑnlɑrɯɯn
sonlH	sonli	sonlu
tɑrɑmɑH	tɑrɑmɑi	tɑrɑmɑɯ
dɑmɑrlArH	dɑmɑrlɑri	dɑmɑrlɑrɯ
kullɑnmAH	kullɑnmɑi	kullɑnmɑɯ
okulmHzDA	okulmizde	okulmuzdɑ
reformH	reformi	reformu
zorlHklAr	zorliklɑr	zorluklɑr
bɑrɯʃHn	bɑrɯʃin	bɑrɯʃɯn
kurullArHHn	kurullɑriin	kurullɑrɯɯn
sɑnɑtHHn	sɑnɑtiin	sɑnɑtɯɯn
sɑvɑʃlArH	sɑvɑʃlɑri	sɑvɑʃlɑrɯ
sɑjɯHn	sɑjɯin	sɑjɯɯn
silɑhlArHn	silɑhlɑrin	silɑhlɑrɯn
soruʃturmAHn	soruʃturmɑin	soruʃturmɑɯn
ulusHn	ulusin	ulusun
ʧɑlɯʃmɑmHzDA	ʧɑlɯʃmɑmizdɑ	ʧɑlɯʃmɑmɯzdɑ
ølʧekDA	ølʧekde	ølʧekte
bɑɰɯmlɯlHk	bɑɰɯmlɯlik	bɑɰɯmlɯlɯk
dyʃynHp	dyʃynip	dyʃynyp
fɑjdɑH	fɑjdɑi	fɑjdɑɯ
pɑjHHn	pɑjiin	pɑjɯɯn
pɑjlArH	pɑjlɑri	pɑjlɑrɯ
pɑzɑrHHn	pɑzɑriin	pɑzɑrɯɯn
sɑnɑtʧHlAr	sɑnɑtʧilɑr	sɑnɑtʧɯlɑr
tymHHn	tymiin	tymyyn
jɑsɑlArHn	jɑsɑlɑrin	jɑsɑlɑrɯn
jɑjɯnlArHn	jɑjɯnlɑrin	jɑjɯnlɑrɯn
ɑʧɯklAnmAH	ɑʧɯklɑnmɑi	ɑʧɯklɑnmɑɯ
ɑvukɑtHn	ɑvukɑtin	ɑvukɑtɯn
bɑɰlAHʤH	bɑɰlɑiʤi	bɑɰlɑɯʤɯ
etrɑfH	etrɑfi	etrɑfɯ
formHn	formin	formun
kɑlDHklArH	kɑldiklɑri	kɑldɯklɑrɯ
sɑrɑjH	sɑrɑji	sɑrɑjɯ
ɑdɯmlArH	ɑdɯmlɑri	ɑdɯmlɑrɯ
bɑsDA	bɑsdɑ	bɑstɑ
gynmHzDAki	gynmizdeki	gynmyzdeki
kɑdɯnlArH	kɑdɯnlɑri	kɑdɯnlɑrɯ
orgɑnlArHHn	orgɑnlɑriin	orgɑnlɑrɯɯn
sɑhɑlArH	sɑhɑlɑri	sɑhɑlɑrɯ
sɑnɑtʧHH	sɑnɑtʧii	sɑnɑtʧɯɯ
sɑvʤɯH	sɑvʤɯi	sɑvʤɯɯ
uʧlArH	uʧlɑri	uʧlɑrɯ
jɑpɯlArHHn	jɑpɯlɑriin	jɑpɯlɑrɯɯn
jɑsɑHHn	jɑsɑiin	jɑsɑɯɯn
ɑvukɑtH	ɑvukɑti	ɑvukɑtɯ
dizɑjnH	dizɑjni	dizɑjnɯ
hejeʤɑnlH	hejeʤɑnli	hejeʤɑnlɯ
pɑtlAHʤH	pɑtlɑiʤi	pɑtlɑɯʤɯ
suʧlArH	suʧlɑri	suʧlɑrɯ
jɑrɯʃH	jɑrɯʃi	jɑrɯʃɯ
jɑrdɯmlArH	jɑrdɯmlɑri	jɑrdɯmlɑrɯ
fijɑtlArHHn	fijɑtlɑriin	fijɑtlɑrɯɯn
hɯzlArH	hɯzlɑri	hɯzlɑrɯ
ihtijɑʧlArHHn	ihtijɑʧlɑriin	ihtijɑʧlɑrɯɯn
olgulArHn	olgulɑrin	olgulɑrɯn
sɑnɑjiDA	sɑnɑjidɑ	sɑnɑjide
ɑʃkH	ɑʃki	ɑʃkɯ
ɑrɑjyzH	ɑrɑjyzi	ɑrɑjyzy
bojlH	bojli	bojlu
fɑbrikɑlArH	fɑbrikɑlɑri	fɑbrikɑlɑrɯ
formHHn	formiin	formuun
hizmetDA	hizmetde	hizmette
kɑblolH	kɑbloli	kɑblolu
kɑnHn	kɑnin	kɑnɯn
konferɑnsDA	konferɑnsdɑ	konferɑnstɑ
tɑsɑrɯHn	tɑsɑrɯin	tɑsɑrɯɯn
ʧoʤuklArmHz	ʧoʤuklɑrmiz	ʧoʤuklɑrmɯz
yʧnʤHH	yʧnʤii	yʧnʤyy
ʤyzdɑnH	ʤyzdɑni	ʤyzdɑnɯ
formɑtH	formɑti	formɑtɯ
geʧmiʃDAn	geʧmiʃden	geʧmiʃten
hɑlkmHz	hɑlkmiz	hɑlkmɯz
hɑzɯrlAmHʃ	hɑzɯrlɑmiʃ	hɑzɯrlɑmɯʃ
kɑtsɑjɯH	kɑtsɑjɯi	kɑtsɑjɯɯ
kulɑkDA	kulɑkdɑ	kulɑktɑ
mɑsrɑfH	mɑsrɑfi	mɑsrɑfɯ
nyshɑH	nyshɑi	nyshɑɯ
sporH	spori	sporu
ʧoʤukDA	ʧoʤukdɑ	ʧoʤuktɑ
ørtylH	ørtyli	ørtyly
ɑdɑH	ɑdɑi	ɑdɑɯ
kɑrɑrlHlHk	kɑrɑrlilik	kɑrɑrlɯlɯk
meslekDA	meslekde	meslekte
sɑnɑjilAʃmA	sɑnɑjilɑʃme	sɑnɑjileʃme
tɑmɑmlɑnDHkDAn	tɑmɑmlɑndikdɑn	tɑmɑmlɑndɯktɑn
telgrɑfH	telgrɑfi	telgrɑfɯ
jɑrɯjɯlHn	jɑrɯjɯlin	jɑrɯjɯlɯn
ʧoʤuklArmHzHn	ʧoʤuklɑrmizin	ʧoʤuklɑrmɯzɯn
bɑsɯnHn	bɑsɯnin	bɑsɯnɯn
ʤɑnlHlArHn	ʤɑnlilɑrin	ʤɑnlɯlɑrɯn
hɑzɯrlɯklH	hɑzɯrlɯkli	hɑzɯrlɯklɯ
temɑsH	temɑsi	temɑsɯ
tuzH	tuzi	tuzu
jyzlH	jyzli	jyzly
jɑpmAmHz	jɑpmɑmiz	jɑpmɑmɯz
jɑzɯmH	jɑzɯmi	jɑzɯmɯ
dɑlgɑlArH	dɑlgɑlɑri	dɑlgɑlɑrɯ
kullAnHʤHH	kullɑniʤii	kullɑnɯʤɯɯ
stɑndɑrtlArHn	stɑndɑrtlɑrin	stɑndɑrtlɑrɯn
ɑltDAki	ɑltdɑki	ɑlttɑki
bɑɰH	bɑɰi	bɑɰɯ
donɑnɯmlH	donɑnɯmli	donɑnɯmlɯ
dozH	dozi	dozu
iddiɑlH	iddiɑli	iddiɑlɯ
kɑjnɑkDAn	kɑjnɑkdɑn	kɑjnɑktɑn
misjonH	misjoni	misjonu
tɑʃɯmAH	tɑʃɯmɑi	tɑʃɯmɑɯ
vɑtɑndɑʃlHk	vɑtɑndɑʃlik	vɑtɑndɑʃlɯk
ɑɰrɯlH	ɑɰrɯli	ɑɰrɯlɯ
bordroH	bordroi	bordrou
itirɑzH	itirɑzi	itirɑzɯ
kɑdɑrH	kɑdɑri	kɑdɑrɯ
memleketDA	memleketde	memlekette
sɯkɯntɯlArH	sɯkɯntɯlɑri	sɯkɯntɯlɑrɯ
sɯnɯfHn	sɯnɯfin	sɯnɯfɯn
sɯnɑvHn	sɯnɑvin	sɯnɑvɯn
ɑvukɑtlArHn	ɑvukɑtlɑrin	ɑvukɑtlɑrɯn
dørtDA	dørtde	dørtte
kɑmpysH	kɑmpysi	kɑmpysy
mekɑnH	mekɑni	mekɑnɯ
ortɑmlArH	ortɑmlɑri	ortɑmlɑrɯ
sɯkɯntɯlH	sɯkɯntɯli	sɯkɯntɯlɯ
sɑtHʃlArH	sɑtiʃlɑri	sɑtɯʃlɑrɯ
tɑlepDA	tɑlepde	tɑlepte
tɑrɑHʤH	tɑrɑiʤi	tɑrɑɯʤɯ
tiʤɑretDA	tiʤɑretde	tiʤɑrette
jorumH	jorumi	jorumu
kɑrtlArHHn	kɑrtlɑriin	kɑrtlɑrɯɯn
sunHʃ	suniʃ	sunuʃ
usullAr	usullɑr	usuller
jɑʃɑmAH	jɑʃɑmɑi	jɑʃɑmɑɯ
jɑnsɯmAH	jɑnsɯmɑi	jɑnsɯmɑɯ
jɑrɯʃmɑHn	jɑrɯʃmɑin	jɑrɯʃmɑɯn
jɑrɑrlArH	jɑrɑrlɑri	jɑrɑrlɑrɯ
ɑnlɑʃmɑlH	ɑnlɑʃmɑli	ɑnlɑʃmɑlɯ
ɑrɑlɯklH	ɑrɑlɯkli	ɑrɑlɯklɯ
ʤezɑHn	ʤezɑin	ʤezɑɯn
ʤezɑH	ʤezɑi	ʤezɑɯ
doɰHʃDAn	doɰiʃdɑn	doɰuʃtɑn
fɯrsɑtDA	fɯrsɑtdɑ	fɯrsɑttɑ
girDHkDAn	girdikden	girdikten
kusurlH	kusurli	kusurlu
miktɑrHn	miktɑrin	miktɑrɯn
sɑklAnmAH	sɑklɑnmɑi	sɑklɑnmɑɯ
tozH	tozi	tozu
ulɑʃɯmH	ulɑʃɯmi	ulɑʃɯmɯ
jyrekDAn	jyrekden	jyrekten
bilgisɑjɑrlArH	bilgisɑjɑrlɑri	bilgisɑjɑrlɑrɯ
enflɑsjonH	enflɑsjoni	enflɑsjonu
fotoɰrɑfʧH	fotoɰrɑfʧi	fotoɰrɑfʧɯ
hɑvɑH	hɑvɑi	hɑvɑɯ
hejeʤɑnH	hejeʤɑni	hejeʤɑnɯ
konuʃmAH	konuʃmɑi	konuʃmɑɯ
noktɑHn	noktɑin	noktɑɯn
onɑjlAnmAH	onɑjlɑnmɑi	onɑjlɑnmɑɯ
sebepDAn	sebepden	sebepten
teʃkilɑtHHn	teʃkilɑtiin	teʃkilɑtɯɯn
jɑklɑʃɯmHn	jɑklɑʃɯmin	jɑklɑʃɯmɯn
ʧɑlɯʃHp	ʧɑlɯʃip	ʧɑlɯʃɯp
ʧoʤuklArmHzA	ʧoʤuklɑrmize	ʧoʤuklɑrmɯzɑ
yzHʤH	yziʤi	yzyʤy
ɑlH	ɑli	ɑlɯ
ɑsɯlH	ɑsɯli	ɑsɯlɯ
bɑʃɑrɯlArH	bɑʃɑrɯlɑri	bɑʃɑrɯlɑrɯ
borsɑH	borsɑi	borsɑɯ
hɑtɑH	hɑtɑi	hɑtɑɯ
iddiɑH	iddiɑi	iddiɑɯ
kɑrʃɯlɑʃDHklArH	kɑrʃɯlɑʃdiklɑri	kɑrʃɯlɑʃtɯklɑrɯ
kɑrɑnlɯkDA	kɑrɑnlɯkdɑ	kɑrɑnlɯktɑ
kɑjɯtlArHHn	kɑjɯtlɑriin	kɑjɯtlɑrɯɯn
mektuplArH	mektuplɑri	mektuplɑrɯ
normɑlA	normɑlɑ	normɑle
ojlArHn	ojlɑrin	ojlɑrɯn
sɯʤɑklɯkDA	sɯʤɑklɯkdɑ	sɯʤɑklɯktɑ
sunmAH	sunmɑi	sunmɑɯ
zɑrH	zɑri	zɑrɯ
ɑkɯmlArH	ɑkɯmlɑri	ɑkɯmlɑrɯ
ɑteʃDA	ɑteʃde	ɑteʃte
ɑjɯrHʤH	ɑjɯriʤi	ɑjɯrɯʤɯ
bilgisɑjɑrnHzHn	bilgisɑjɑrnizin	bilgisɑjɑrnɯzɯn
gelDHkDAn	geldikden	geldikten
kurmɑjH	kurmɑji	kurmɑjɯ
lisɑnslH	lisɑnsli	lisɑnslɯ
pɑrɑlArH	pɑrɑlɑri	pɑrɑlɑrɯ
plɑnHn	plɑnin	plɑnɯn
televizjonDA	televizjonde	televizjondɑ
vɑtɑndɑʃlArmHzHn	vɑtɑndɑʃlɑrmizin	vɑtɑndɑʃlɑrmɯzɯn
ɑrkɑH	ɑrkɑi	ɑrkɑɯ
bulvɑrH	bulvɑri	bulvɑrɯ
gøryntyHn	gøryntyin	gøryntyyn
konmAH	konmɑi	konmɑɯ
konsɑntrɑsjonH	konsɑntrɑsjoni	konsɑntrɑsjonu
operɑtørH	operɑtøri	operɑtøry
søzHHn	søziin	søzyyn
tyrHHn	tyriin	tyryyn
tɑmɑmlAHʤH	tɑmɑmlɑiʤi	tɑmɑmlɑɯʤɯ
jɑprɑklH	jɑprɑkli	jɑprɑklɯ
bilgisɑjɑrnHzDA	bilgisɑjɑrnizdɑ	bilgisɑjɑrnɯzdɑ
bojɑlH	bojɑli	bojɑlɯ
bulHʃ	buliʃ	buluʃ
bulunmAlArH	bulunmɑlɑri	bulunmɑlɑrɯ
butonH	butoni	butonu
doɰrulHk	doɰrulik	doɰruluk
kɑlkHp	kɑlkip	kɑlkɯp
myrɑʤɑɑtH	myrɑʤɑɑti	myrɑʤɑɑtɯ
mesɑʒHn	mesɑʒin	mesɑʒɯn
okuHp	okuip	okuup
pozisjonH	pozisjoni	pozisjonu
rɑporlArHHn	rɑporlɑriin	rɑporlɑrɯɯn
sɯrɑlH	sɯrɑli	sɯrɑlɯ
syrHp	syrip	syryp
sɑkɯnʤɑlH	sɑkɯnʤɑli	sɑkɯnʤɑlɯ
tɑrɯmH	tɑrɯmi	tɑrɯmɯ
tɑsɑrɯmlArH	tɑsɑrɯmlɑri	tɑsɑrɯmlɑrɯ
tutɑrHHn	tutɑriin	tutɑrɯɯn
jemekDAn	jemekden	jemekten
ɑnlɑjɯʃHn	ɑnlɑjɯʃin	ɑnlɑjɯʃɯn
doktorHn	doktorin	doktorun
fɑrklArH	fɑrklɑri	fɑrklɑrɯ
kɑmpH	kɑmpi	kɑmpɯ
kurHp	kurip	kurup
onɑrɯmH	onɑrɯmi	onɑrɯmɯ
susHz	susiz	susuz
tɑkɯmHn	tɑkɯmin	tɑkɯmɯn
jyryHʃH	jyryiʃi	jyryyʃy
jɑɰHʃlH	jɑɰiʃli	jɑɰɯʃlɯ
jɑsɑH	jɑsɑi	jɑsɑɯ
jɑjɯnHn	jɑjɯnin	jɑjɯnɯn
ɑnlɑʃmɑHn	ɑnlɑʃmɑin	ɑnlɑʃmɑɯn
fijɑtlArHn	fijɑtlɑrin	fijɑtlɑrɯn
formɑtDA	formɑtdɑ	formɑttɑ
mensuplArHHn	mensuplɑriin	mensuplɑrɯɯn
mejdɑnH	mejdɑni	mejdɑnɯ
tɑʃɯmɑʤɯlHk	tɑʃɯmɑʤɯlik	tɑʃɯmɑʤɯlɯk
telefonDAn	telefonden	telefondɑn
jurtDA	jurtdɑ	jurttɑ
ʃɑhHn	ʃɑhin	ʃɑhɯn
gelmADA	gelmede	gelmete
grupDAn	grupdɑn	gruptɑn
hususlArHn	hususlɑrin	hususlɑrɯn
kullɑnmADA	kullɑnmɑdɑ	kullɑnmɑtɑ
motorlArH	motorlɑri	motorlɑrɯ
sɑɰlɑmAH	sɑɰlɑmɑi	sɑɰlɑmɑɯ
ølʧyH	ølʧyi	ølʧyy
ɑlɑkɑlH	ɑlɑkɑli	ɑlɑkɑlɯ
bɑʃlɑDHkDAn	bɑʃlɑdikdɑn	bɑʃlɑdɯktɑn
bɑʃlɑHnʤA	bɑʃlɑinʤɑ	bɑʃlɑɯnʤɑ
dosjɑHHn	dosjɑiin	dosjɑɯɯn
gøryntylH	gøryntyli	gøryntyly
hɑjvɑnHn	hɑjvɑnin	hɑjvɑnɯn
hesɑplArA	hesɑplɑre	hesɑplɑrɑ
mevzuɑtHn	mevzuɑtin	mevzuɑtɯn
okumAH	okumɑi	okumɑɯ
orgɑnizɑsjonHn	orgɑnizɑsjonin	orgɑnizɑsjonun
sɯnɑvlArHn	sɯnɑvlɑrin	sɯnɑvlɑrɯn
sɑnɯklArHn	sɑnɯklɑrin	sɑnɯklɑrɯn
jɑkɯnH	jɑkɯni	jɑkɯnɯ
bɑslAAn	bɑsleen	bɑslɑɑn
proʒeksijonH	proʒeksijoni	proʒeksijonu
rɑhɑtlHk	rɑhɑtlik	rɑhɑtlɯk
vɑrlɯklArH	vɑrlɯklɑri	vɑrlɯklɑrɯ
vizjonH	vizjoni	vizjonu
ʃɑnslH	ʃɑnsli	ʃɑnslɯ
fɑturɑH	fɑturɑi	fɑturɑɯ
hɑzɯrlAHp	hɑzɯrlɑip	hɑzɯrlɑɯp
kollHk	kollik	kolluk
okulmHzHn	okulmizin	okulmuzun
ryzgɑrHn	ryzgɑrin	ryzgɑrɯn
sɑnɑtʧHlArHn	sɑnɑtʧilɑrin	sɑnɑtʧɯlɑrɯn
tɑsɑrɯmHn	tɑsɑrɯmin	tɑsɑrɯmɯn
ɑdɑjlArHHn	ɑdɑjlɑriin	ɑdɑjlɑrɯɯn
ʤɑnlɯlHk	ʤɑnlɯlik	ʤɑnlɯlɯk
dɑvɑlArH	dɑvɑlɑri	dɑvɑlɑrɯ
fonksijonlArHn	fonksijonlɑrin	fonksijonlɑrɯn
ihrɑʤɑtʧH	ihrɑʤɑtʧi	ihrɑʤɑtʧɯ
kɑlɯntɯlArH	kɑlɯntɯlɑri	kɑlɯntɯlɑrɯ
kɑjmɑkɑmH	kɑjmɑkɑmi	kɑjmɑkɑmɯ
puɑnlArH	puɑnlɑri	puɑnlɑrɯ
tɑrɑfHHn	tɑrɑfiin	tɑrɑfɯɯn
jɑkɯnlArHHn	jɑkɯnlɑriin	jɑkɯnlɑrɯɯn
øzellikDA	øzellikde	øzellikte
øzgyrlHklAr	øzgyrlikler	øzgyrlykler
ɑʃɑmɑlH	ɑʃɑmɑli	ɑʃɑmɑlɯ
bɑɰlArH	bɑɰlɑri	bɑɰlɑrɯ
bulmAH	bulmɑi	bulmɑɯ
dɑvrɑnHʃlArHn	dɑvrɑniʃlɑrin	dɑvrɑnɯʃlɑrɯn
dolɑʃɯmH	dolɑʃɯmi	dolɑʃɯmɯ
hɑrflArH	hɑrflɑri	hɑrfleri
kɑmuHn	kɑmuin	kɑmuun
kurDHklArH	kurdiklɑri	kurduklɑrɯ
mɑntɯklH	mɑntɯkli	mɑntɯklɯ
syslH	sysli	sysly
sulArHHn	sulɑriin	sulɑrɯɯn
telefonA	telefone	telefonɑ
toprɑklArHn	toprɑklɑrin	toprɑklɑrɯn
tutuklulArHn	tutuklulɑrin	tutuklulɑrɯn
ɯʃɯklH	ɯʃɯkli	ɯʃɯklɯ
ʃirketDA	ʃirketde	ʃirkette
bɑʃkɑHHn	bɑʃkɑiin	bɑʃkɑɯɯn
bejɑnH	bejɑni	bejɑnɯ
ʤɑmH	ʤɑmi	ʤɑmɯ
fonlArH	fonlɑri	fonlɑrɯ
gøstermADA	gøstermede	gøstermete
herkesDAn	herkesden	herkesten
kɑrlHlHk	kɑrlilik	kɑrlɯlɯk
pijɑsɑHn	pijɑsɑin	pijɑsɑɯn
silɑhlArH	silɑhlɑri	silɑhlɑrɯ
tesisɑtH	tesisɑti	tesisɑtɯ
jɑnlɯH	jɑnlɯi	jɑnlɯɯ
jɑzɑrlArHn	jɑzɑrlɑrin	jɑzɑrlɑrɯn
ɑlɑlHm	ɑlɑlim	ɑlɑlɯm
burslH	bursli	burslu
doktornHz	doktorniz	doktornuz
fedɑkɑrlHk	fedɑkɑrlik	fedɑkɑrlɯk
kolɑjlHklAr	kolɑjliklɑr	kolɑjlɯklɑr
mysteʃɑrlHk	mysteʃɑrlik	mysteʃɑrlɯk
syrHʃ	syriʃ	syryʃ
sytHn	sytin	sytyn
tuʃlArH	tuʃlɑri	tuʃlɑrɯ
ulɑʃmAH	ulɑʃmɑi	ulɑʃmɑɯ
jɑʃlHlAr	jɑʃlilɑr	jɑʃlɯlɑr
jɑjgɯnlAʃmAH	jɑjgɯnlɑʃmɑi	jɑjgɯnlɑʃmɑɯ
ʧøzynyrlykDA	ʧøzynyrlykde	ʧøzynyrlykte
ɑlɯʤɯHn	ɑlɯʤɯin	ɑlɯʤɯɯn
bugynH	bugyni	bugyny
direktørH	direktøri	direktøry
gøryʃHn	gøryʃin	gøryʃyn
hoʤɑH	hoʤɑi	hoʤɑɯ
iktidɑrHn	iktidɑrin	iktidɑrɯn
kɑpɑnHʃ	kɑpɑniʃ	kɑpɑnɯʃ
konforlH	konforli	konforlu
kullɑnmAnHz	kullɑnmɑniz	kullɑnmɑnɯz
otomɑsjonH	otomɑsjoni	otomɑsjonu
tɑʃɯnmɑzHn	tɑʃɯnmɑzin	tɑʃɯnmɑzɯn
tɑbloH	tɑbloi	tɑblou
tɑkɯmlArH	tɑkɯmlɑri	tɑkɯmlɑrɯ
telefonHn	telefonin	telefonun
toprɑkDA	toprɑkdɑ	toprɑktɑ
uzmɑnlArHn	uzmɑnlɑrin	uzmɑnlɑrɯn
ʧɯkHnʤA	ʧɯkinʤɑ	ʧɯkɯnʤɑ
ʃemɑH	ʃemɑi	ʃemɑɯ
ʤevɑplArH	ʤevɑplɑri	ʤevɑplɑrɯ
dyʃmɑnHn	dyʃmɑnin	dyʃmɑnɯn
dɑmɑrlArHn	dɑmɑrlɑrin	dɑmɑrlɑrɯn
esnɑfH	esnɑfi	esnɑfɯ
girHʃDA	giriʃde	giriʃte
hɑmɑmH	hɑmɑmi	hɑmɑmɯ
itibɑrH	itibɑri	itibɑrɯ
kɑlkmAH	kɑlkmɑi	kɑlkmɑɯ
motorHn	motorin	motorun
olmADHklArH	olmɑdiklɑri	olmɑdɯklɑrɯ
ruhHn	ruhin	ruhun
sɑjɯmH	sɑjɯmi	sɑjɯmɯ
topHn	topin	topun
jɑzɑrlArH	jɑzɑrlɑri	jɑzɑrlɑrɯ
byjyklHk	byjyklik	byjyklyk
bojlArH	bojlɑri	bojlɑrɯ
burɑHn	burɑin	burɑɯn
fɯrsɑtlArH	fɯrsɑtlɑri	fɯrsɑtlɑrɯ
hɑstɑH	hɑstɑi	hɑstɑɯ
ithɑlɑtH	ithɑlɑti	ithɑlɑtɯ
lirɑlHk	lirɑlik	lirɑlɯk
mɑterjɑllAr	mɑterjɑllɑr	mɑterjɑller
mekɑnHn	mekɑnin	mekɑnɯn
noktɑlArHn	noktɑlɑrin	noktɑlɑrɯn
sɯrɑH	sɯrɑi	sɯrɑɯ
sigortɑlArH	sigortɑlɑri	sigortɑlɑrɯ
tonlHk	tonlik	tonluk
topluluklArH	topluluklɑri	topluluklɑrɯ
jɑbɑnʤɯlArHn	jɑbɑnʤɯlɑrin	jɑbɑnʤɯlɑrɯn
jɑnHʤH	jɑniʤi	jɑnɯʤɯ
ʧɑbɑH	ʧɑbɑi	ʧɑbɑɯ
øzgyrlHklArH	øzgyrlikleri	øzgyrlykleri
ɑrtHʃlAr	ɑrtiʃlɑr	ɑrtɯʃlɑr
ɑrtmADA	ɑrtmɑdɑ	ɑrtmɑtɑ
boruH	borui	boruu
dɑlHHn	dɑliin	dɑlɯɯn
dosjɑlArHHn	dosjɑlɑriin	dosjɑlɑrɯɯn
durHp	durip	durup
grupDAki	grupdɑki	gruptɑki
tekrɑrH	tekrɑri	tekrɑrɯ
topʧH	topʧi	topʧu
ølymHn	ølymin	ølymyn
doɰɑH	doɰɑi	doɰɑɯ
esnɑfHn	esnɑfin	esnɑfɯn
frekɑnsH	frekɑnsi	frekɑnsɯ
gyryltylH	gyryltyli	gyryltyly
hɑksHzlHk	hɑksizlik	hɑksɯzlɯk
hɑrflAr	hɑrflɑr	hɑrfler
hɑstɑlɯklH	hɑstɑlɯkli	hɑstɑlɯklɯ
imzɑlH	imzɑli	imzɑlɯ
kenɑrH	kenɑri	kenɑrɯ
konuʃmAHn	konuʃmɑin	konuʃmɑɯn
lyzumlH	lyzumli	lyzumlu
odɑlArHn	odɑlɑrin	odɑlɑrɯn
olɑnɑklArHHn	olɑnɑklɑriin	olɑnɑklɑrɯɯn
operɑsjonHn	operɑsjonin	operɑsjonun
orgɑnlArHn	orgɑnlɑrin	orgɑnlɑrɯn
sorunlH	sorunli	sorunlu
tɑrtɯʃmAlArHn	tɑrtɯʃmɑlɑrin	tɑrtɯʃmɑlɑrɯn
unsurlArHn	unsurlɑrin	unsurlɑrɯn
ønmHzA	ønmize	ønmyze
bɑʃlAnmAH	bɑʃlɑnmɑi	bɑʃlɑnmɑɯ
ʤoɰrɑfjɑH	ʤoɰrɑfjɑi	ʤoɰrɑfjɑɯ
koʤɑH	koʤɑi	koʤɑɯ
konferɑnsHn	konferɑnsin	konferɑnsɯn
kullɑnmAHn	kullɑnmɑin	kullɑnmɑɯn
modH	modi	modu
sɑɰlɑmADA	sɑɰlɑmɑdɑ	sɑɰlɑmɑtɑ
sɑkɑtlHk	sɑkɑtlik	sɑkɑtlɯk
tɑrɑflArH	tɑrɑflɑri	tɑrɑflɑrɯ
terørHn	terørin	terøryn
tutulumH	tutulumi	tutulumu
zorlHklArH	zorliklɑri	zorluklɑrɯ
ɑvukɑtlArH	ɑvukɑtlɑri	ɑvukɑtlɑrɯ
ɑjkɯrɯlHk	ɑjkɯrɯlik	ɑjkɯrɯlɯk
dɑɰHn	dɑɰin	dɑɰɯn
dɑlgɑlH	dɑlgɑli	dɑlgɑlɯ
doɰɑH	doɰɑi	doɰɑɯ
gølHn	gølin	gølyn
hɑrʤɑmAlArHn	hɑrʤɑmɑlɑrin	hɑrʤɑmɑlɑrɯn
hɑtlArHHn	hɑtlɑriin	hɑtlɑrɯɯn
kurullArHn	kurullɑrin	kurullɑrɯn
numɑrɑnHzH	numɑrɑnizi	numɑrɑnɯzɯ
pɑrʧɑlH	pɑrʧɑli	pɑrʧɑlɯ
pɑrlɑmentoH	pɑrlɑmentoi	pɑrlɑmentou
stɑʒH	stɑʒi	stɑʒɯ
toplɑntɯlArHn	toplɑntɯlɑrin	toplɑntɯlɑrɯn
verDHkDAn	verdikden	verdikten
vermADAn	vermeden	vermeten
ʧɑlɯʃmAlArmHzH	ʧɑlɯʃmɑlɑrmizi	ʧɑlɯʃmɑlɑrmɯzɯ
bɑkHnʤA	bɑkinʤɑ	bɑkɯnʤɑ
dɑvɑH	dɑvɑi	dɑvɑɯ
depɑrtmɑnH	depɑrtmɑni	depɑrtmɑnɯ
edebijɑtHHn	edebijɑtiin	edebijɑtɯɯn
fɑbrikɑHn	fɑbrikɑin	fɑbrikɑɯn
istikrɑrH	istikrɑri	istikrɑrɯ
køprylH	køpryli	køpryly
odɑlArHHn	odɑlɑriin	odɑlɑrɯɯn
telefonDA	telefonde	telefondɑ
toprɑklArHHn	toprɑklɑriin	toprɑklɑrɯɯn
jɑʃɑmAH	jɑʃɑmɑi	jɑʃɑmɑɯ
zɑrɑrHn	zɑrɑrin	zɑrɑrɯn
bɑnkɑmHz	bɑnkɑmiz	bɑnkɑmɯz
enfeksijonlArH	enfeksijonleri	enfeksijonlɑrɯ
gørynymlH	gørynymli	gørynymly
kɑdrolArH	kɑdrolɑri	kɑdrolɑrɯ
okullArHHn	okullɑriin	okullɑrɯɯn
sɑldɯrɯH	sɑldɯrɯi	sɑldɯrɯɯ
sporHn	sporin	sporun
tɑrihDAki	tɑrihdeki	tɑrihteki
jykymlHlHk	jykymlilik	jykymlylyk
jɑlɯtɯmH	jɑlɯtɯmi	jɑlɯtɯmɯ
jɑzmAH	jɑzmɑi	jɑzmɑɯ
ɑʧɯlArH	ɑʧɯlɑri	ɑʧɯlɑrɯ
ɑtHp	ɑtip	ɑtɯp
distribytørH	distribytøri	distribytøry
durumlArHHn	durumlɑriin	durumlɑrɯɯn
enstityHn	enstityin	enstityyn
hɑʧlH	hɑʧli	hɑʧlɯ
hɑnH	hɑni	hɑnɯ
kuruluʃDA	kuruluʃdɑ	kuruluʃtɑ
petrolHn	petrolin	petrolyn
sɑntrɑlH	sɑntrɑli	sɑntrɑlɯ
sɑjfɑHHn	sɑjfɑiin	sɑjfɑɯɯn
unH	uni	unu
jɑʃlHlHk	jɑʃlilik	jɑʃlɯlɯk
ʧøzymHn	ʧøzymin	ʧøzymyn
ʃɑhɯslArHn	ʃɑhɯslɑrin	ʃɑhɯslɑrɯn
ystynlHk	ystynlik	ystynlyk
ɑkʃɑmlArH	ɑkʃɑmlɑri	ɑkʃɑmlɑrɯ
ɑnnelArHn	ɑnnelɑrin	ɑnnelerin
dujuruH	dujurui	dujuruu
ekipmɑnlArH	ekipmɑnlɑri	ekipmɑnlɑrɯ
gønyllHlArH	gønyllileri	gønyllyleri
hɑlkmHzA	hɑlkmize	hɑlkmɯzɑ
hɑstɑlArHHn	hɑstɑlɑriin	hɑstɑlɑrɯɯn
kɑhrɑmɑnlHk	kɑhrɑmɑnlik	kɑhrɑmɑnlɯk
kɑpɑtHp	kɑpɑtip	kɑpɑtɯp
kɑtɯlɯmHn	kɑtɯlɯmin	kɑtɯlɯmɯn
kopjɑH	kopjɑi	kopjɑɯ
lezjonlAr	lezjonler	lezjonlɑr
meʤlisDA	meʤlisde	meʤliste
tɑɑhhytlH	tɑɑhhytli	tɑɑhhytly
tɑrɑfmHzDAn	tɑrɑfmizden	tɑrɑfmɯzdɑn
uzɑkDAki	uzɑkdɑki	uzɑktɑki
jɑrgɯHn	jɑrgɯin	jɑrgɯɯn
jɑjɯnlAnmAH	jɑjɯnlɑnmɑi	jɑjɯnlɑnmɑɯ
ɑɰrɯlArH	ɑɰrɯlɑri	ɑɰrɯlɑrɯ
bɑʃɑrɯsHzlHk	bɑʃɑrɯsizlik	bɑʃɑrɯsɯzlɯk
dokuHn	dokuin	dokuun
eʃjɑH	eʃjɑi	eʃjɑɯ
gørynHʃ	gøryniʃ	gørynyʃ
kɯrHʤH	kɯriʤi	kɯrɯʤɯ
kumH	kumi	kumu
kurɑllArHn	kurɑllɑrin	kurɑllɑrɯn
kurultɑjH	kurultɑji	kurultɑjɯ
syryʤyH	syryʤyi	syryʤyy
sɑtHʃlAr	sɑtiʃlɑr	sɑtɯʃlɑr
sɑvunmAH	sɑvunmɑi	sɑvunmɑɯ
senɑtoH	senɑtoi	senɑtou
slogɑnH	slogɑni	slogɑnɯ
soruʃturmAH	soruʃturmɑi	soruʃturmɑɯ
sorumlHlArH	sorumlilɑri	sorumlulɑrɯ
tɑkɯmmHz	tɑkɯmmiz	tɑkɯmmɯz
vɑrlɯklArHn	vɑrlɯklɑrin	vɑrlɯklɑrɯn
jɑrɯjɯlH	jɑrɯjɯli	jɑrɯjɯlɯ
jɑtɑklArH	jɑtɑklɑri	jɑtɑklɑrɯ
ystDAki	ystdeki	ystteki
ɑʧɯkDA	ɑʧɯkdɑ	ɑʧɯktɑ
ɑʧɯlH	ɑʧɯli	ɑʧɯlɯ
bɑnkɑHHn	bɑnkɑiin	bɑnkɑɯɯn
burslAr	bursler	burslɑr
ʤɑnH	ʤɑni	ʤɑnɯ
dɑvrɑnHʃlArHHn	dɑvrɑniʃlɑriin	dɑvrɑnɯʃlɑrɯɯn
kɑnunlArHn	kɑnunlɑrin	kɑnunlɑrɯn
kullɑnɯmlArH	kullɑnɯmlɑri	kullɑnɯmlɑrɯ
kusurH	kusuri	kusuru
mɑʧH	mɑʧi	mɑʧɯ
mɑtbɑɑH	mɑtbɑɑi	mɑtbɑɑɯ
olAlHm	olɑlim	olɑlɯm
opsijonlArH	opsijonlɑri	opsijonlɑrɯ
ovɑH	ovɑi	ovɑɯ
sɯnɯrlArHHn	sɯnɯrlɑriin	sɯnɯrlɑrɯɯn
ɑʧmAH	ɑʧmɑi	ɑʧmɑɯ
ɑɰHHn	ɑɰiin	ɑɰɯɯn
ɑlɑjH	ɑlɑji	ɑlɑjɯ
dostlArH	dostlɑri	dostlɑrɯ
hykymlHlArHn	hykymlilerin	hykymlylerin
hukukHHn	hukukiin	hukukuun
ihrɑʤɑtHn	ihrɑʤɑtin	ihrɑʤɑtɯn
rɑkɑmH	rɑkɑmi	rɑkɑmɯ
sɑjfɑlHk	sɑjfɑlik	sɑjfɑlɯk
tutɑrlArH	tutɑrlɑri	tutɑrlɑrɯ
ustɑH	ustɑi	ustɑɯ
ɑrtHʃHn	ɑrtiʃin	ɑrtɯʃɯn
bɑlɯklArH	bɑlɯklɑri	bɑlɯklɑrɯ
durumlArHn	durumlɑrin	durumlɑrɯn
kullɑnmAlArH	kullɑnmɑlɑri	kullɑnmɑlɑrɯ
nyfuslH	nyfusli	nyfuslu
olɑjlArHHn	olɑjlɑriin	olɑjlɑrɯɯn
typH	typi	typy
tyzykDA	tyzykde	tyzykte
tɑʃHn	tɑʃin	tɑʃɯn
toplɑnHp	toplɑnip	toplɑnɯp
jɑʃDAki	jɑʃdɑki	jɑʃtɑki
jɑrdɯmHn	jɑrdɯmin	jɑrdɯmɯn
ɑtɯlmAH	ɑtɯlmɑi	ɑtɯlmɑɯ
bɑʃkɑnlArHHn	bɑʃkɑnlɑriin	bɑʃkɑnlɑrɯɯn
bɑʃvuruH	bɑʃvurui	bɑʃvuruu
ʤezɑlArHn	ʤezɑlɑrin	ʤezɑlɑrɯn
doktorlArHn	doktorlɑrin	doktorlɑrɯn
fɯkrɑHHn	fɯkrɑiin	fɯkrɑɯɯn
hɑritɑlArH	hɑritɑlɑri	hɑritɑlɑrɯ
hɑsɑrlH	hɑsɑrli	hɑsɑrlɯ
kɑnɯtH	kɑnɯti	kɑnɯtɯ
meslektɑʃlArmHzHn	meslektɑʃlɑrmizin	meslektɑʃlɑrmɯzɯn
sɑɰlɯksHz	sɑɰlɯksiz	sɑɰlɯksɯz
ɑlHnʤA	ɑlinʤɑ	ɑlɯnʤɑ
bɑʃvurmAH	bɑʃvurmɑi	bɑʃvurmɑɯ
dɑɰɯlɯmlArH	dɑɰɯlɯmlɑri	dɑɰɯlɯmlɑrɯ
dɑnɯʃmɑnHn	dɑnɯʃmɑnin	dɑnɯʃmɑnɯn
dɑvɑlH	dɑvɑli	dɑvɑlɯ
durulmAH	durulmɑi	durulmɑɯ
etydH	etydi	etydy
kɑbloH	kɑbloi	kɑblou
kɑslArH	kɑsleri	kɑslɑrɯ
kumlH	kumli	kumlu
odɑHHn	odɑiin	odɑɯɯn
ormɑnlHk	ormɑnlik	ormɑnlɯk
ormɑnlArH	ormɑnlɑri	ormɑnlɑrɯ
ortɑklArHn	ortɑklɑrin	ortɑklɑrɯn
romɑnH	romɑni	romɑnɯ
sɯnɯfDAn	sɯnɯfdɑn	sɯnɯftɑn
jorHʤH	joriʤi	joruʤu
ɑhlɑkH	ɑhlɑki	ɑhlɑkɯ
ɑlɯʃkɑnlɯklArH	ɑlɯʃkɑnlɯklɑri	ɑlɯʃkɑnlɯklɑrɯ
doɰHʃH	doɰiʃi	doɰuʃu
dokuHHn	dokuiin	dokuuun
kurɑllArHHn	kurɑllɑriin	kurɑllɑrɯɯn
pijɑsɑlArH	pijɑsɑlɑri	pijɑsɑlɑrɯ
usulA	usulɑ	usule
vɑtɑndɑʃlArH	vɑtɑndɑʃlɑri	vɑtɑndɑʃlɑrɯ
jɑʃɑmAHn	jɑʃɑmɑin	jɑʃɑmɑɯn
ɑnɑjɑsɑH	ɑnɑjɑsɑi	ɑnɑjɑsɑɯ
ʤoʃkulH	ʤoʃkuli	ʤoʃkulu
geʧmiʃDAki	geʧmiʃdeki	geʧmiʃteki
hɑjɑtmHzHn	hɑjɑtmizin	hɑjɑtmɯzɯn
mɑsɑHn	mɑsɑin	mɑsɑɯn
memurHn	memurin	memurun
ormɑnH	ormɑni	ormɑnɯ
rɯzɑH	rɯzɑi	rɯzɑɯ
rɑjlH	rɑjli	rɑjlɯ
rollAr	rollɑr	roller
søzʤyH	søzʤyi	søzʤyy
syryʤyHn	syryʤyin	syryʤyyn
sɑldɯrɯlArH	sɑldɯrɯlɑri	sɑldɯrɯlɑrɯ
sigortɑHn	sigortɑin	sigortɑɯn
tyrHn	tyrin	tyryn
toplɑHp	toplɑip	toplɑɯp
jykseklHkDA	jykseklikde	jykseklikte
jɑkɯnlHk	jɑkɯnlik	jɑkɯnlɯk
ɑɰrɯHn	ɑɰrɯin	ɑɰrɯɯn
ɑlmAHn	ɑlmɑin	ɑlmɑɯn
ɑjrɯlHp	ɑjrɯlip	ɑjrɯlɯp
bɑsɯnH	bɑsɯni	bɑsɯnɯ
dyrystlHk	dyrystlik	dyrystlyk
fuɑrHn	fuɑrin	fuɑrɯn
gyneʃDAn	gyneʃden	gyneʃten
kimjɑH	kimjɑi	kimjɑɯ
konuʃmAHHn	konuʃmɑiin	konuʃmɑɯɯn
kurslArA	kurslɑre	kurslɑrɑ
metotlArH	metotlɑri	metotlɑrɯ
okuHʤHA	okuiʤiɑ	okuuʤuɑ
semptomlArH	semptomlɑri	semptomlɑrɯ
tɑʃDAn	tɑʃdɑn	tɑʃtɑn
tutmAH	tutmɑi	tutmɑɯ
zɑmɑnlArH	zɑmɑnlɑri	zɑmɑnlɑrɯ
ʧɑrʃɯH	ʧɑrʃɯi	ʧɑrʃɯɯ
ʧorlH	ʧorli	ʧorlu
ɑrɑbɑHn	ɑrɑbɑin	ɑrɑbɑɯn
bɑlɯklArHn	bɑlɯklɑrin	bɑlɯklɑrɯn
dumɑnH	dumɑni	dumɑnɯ
iddiɑlArH	iddiɑlɑri	iddiɑlɑrɯ
kɑnɑtlH	kɑnɑtli	kɑnɑtlɯ
kɑslArHn	kɑslerin	kɑslɑrɯn
konulArHHn	konulɑriin	konulɑrɯɯn
lɑborɑtuɑrH	lɑborɑtuɑri	lɑborɑtuɑrɯ
myslymɑnlArHn	myslymɑnlɑrin	myslymɑnlɑrɯn
olɑjHHn	olɑjiin	olɑjɯɯn
politikɑHn	politikɑin	politikɑɯn
sɯnɯflArH	sɯnɯflɑri	sɯnɯflɑrɯ
sɯnɯrHHn	sɯnɯriin	sɯnɯrɯɯn
sigortɑlHA	sigortɑliɑ	sigortɑlɯɑ
tytynH	tytyni	tytyny
uzɑntɯH	uzɑntɯi	uzɑntɯɯ
jykHHn	jykiin	jykyyn
ʧɯkDHkDAn	ʧɯkdikdɑn	ʧɯktɯktɑn
ønmHzDA	ønmizde	ønmyzde
ʃifɑlH	ʃifɑli	ʃifɑlɯ
ɑkɯntɯH	ɑkɯntɯi	ɑkɯntɯɯ
ɑrzuH	ɑrzui	ɑrzuu
bilgisɑjɑrnHzH	bilgisɑjɑrnizi	bilgisɑjɑrnɯzɯ
ʤɑmlArH	ʤɑmlɑri	ʤɑmlɑrɯ
devletDA	devletde	devlette
ekDA	ekde	ekte
fɑzlɑHHn	fɑzlɑiin	fɑzlɑɯɯn
fotoɰrɑfDA	fotoɰrɑfdɑ	fotoɰrɑftɑ
kɑdrolH	kɑdroli	kɑdrolu
kɑrtlArHn	kɑrtlɑrin	kɑrtlɑrɯn
kontrollAr	kontrollɑr	kontroller
minerɑllArH	minerɑllɑri	minerɑlleri
pɑrʧɑHn	pɑrʧɑin	pɑrʧɑɯn
sɑtɯrlArH	sɑtɯrlɑri	sɑtɯrlɑrɯ
unutmAAlHm	unutmɑɑlim	unutmɑɑlɯm
vɑtɑndɑʃlArmHz	vɑtɑndɑʃlɑrmiz	vɑtɑndɑʃlɑrmɯz
ɑdlArHHn	ɑdlɑriin	ɑdlɑrɯɯn
ɑmɑʧlArHHn	ɑmɑʧlɑriin	ɑmɑʧlɑrɯɯn
bølymmHz	bølymmiz	bølymmyz
bɑʃHn	bɑʃin	bɑʃɯn
borʧlArHn	borʧlɑrin	borʧlɑrɯn
doɰruH	doɰrui	doɰruu
dojurHʤH	dojuriʤi	dojuruʤu
enfeksijonlAr	enfeksijonler	enfeksijonlɑr
gɯdɑlArHn	gɯdɑlɑrin	gɯdɑlɑrɯn
gørynHʃH	gøryniʃi	gørynyʃy
hɑvzɑH	hɑvzɑi	hɑvzɑɯ
kɑhrɑmɑnH	kɑhrɑmɑni	kɑhrɑmɑnɯ
kɑtɯlmAlArH	kɑtɯlmɑlɑri	kɑtɯlmɑlɑrɯ
mysteʃɑrH	mysteʃɑri	mysteʃɑrɯ
minerɑllAr	minerɑllɑr	minerɑller
sɑbɑhHn	sɑbɑhin	sɑbɑhɯn
sɑhɑHn	sɑhɑin	sɑhɑɯn
sɑvɑʃHHn	sɑvɑʃiin	sɑvɑʃɯɯn
turnuvɑH	turnuvɑi	turnuvɑɯ
ujmAH	ujmɑi	ujmɑɯ
vyʤutDAki	vyʤutdɑki	vyʤuttɑki
jyznʤH	jyznʤi	jyznʤy
zɑmɑnHHn	zɑmɑniin	zɑmɑnɯɯn
ʧɑrʃɯHn	ʧɑrʃɯin	ʧɑrʃɯɯn
bɑkHʃH	bɑkiʃi	bɑkɯʃɯ
døkymHHn	døkymiin	døkymyyn
doluH	dolui	doluu
fɑjdɑlArH	fɑjdɑlɑri	fɑjdɑlɑrɯ
hɑllArH	hɑllɑri	hɑlleri
hɑrʤɑmAlArHHn	hɑrʤɑmɑlɑriin	hɑrʤɑmɑlɑrɯɯn
huzursHzlHk	huzursizlik	huzursuzluk
ihrɑʤɑtDA	ihrɑʤɑtdɑ	ihrɑʤɑttɑ
istihdɑmH	istihdɑmi	istihdɑmɯ
kɯrɯklArH	kɯrɯklɑri	kɯrɯklɑrɯ
kɑfɑH	kɑfɑi	kɑfɑɯ
kɑldɯrHp	kɑldɯrip	kɑldɯrɯp
kɑlmAH	kɑlmɑi	kɑlmɑɯ
onnʤH	onnʤi	onnʤu
zijɑretDA	zijɑretde	zijɑrette
ʧɑlɯʃɑnHn	ʧɑlɯʃɑnin	ʧɑlɯʃɑnɯn
ønʤyH	ønʤyi	ønʤyy
ʃɑmpijonH	ʃɑmpijoni	ʃɑmpijonu
boɰɑzH	boɰɑzi	boɰɑzɯ
bulArAk	bulerek	bulɑrɑk
dɑɰlArHn	dɑɰlɑrin	dɑɰlɑrɯn
fɑturɑlArH	fɑturɑlɑri	fɑturɑlɑrɯ
ithɑlɑtʧH	ithɑlɑtʧi	ithɑlɑtʧɯ
kɑlmAksHzHn	kɑlmɑksizin	kɑlmɑksɯzɯn
kɑlmAHp	kɑlmɑip	kɑlmɑɯp
olgunlHk	olgunlik	olgunluk
rɑkɑmHn	rɑkɑmin	rɑkɑmɯn
syrmADA	syrmede	syrmete
sɑnɑtʧHlArH	sɑnɑtʧilɑri	sɑnɑtʧɯlɑrɯ
sɑjmHzDA	sɑjmizde	sɑjmɯzdɑ
sijɑsetDA	sijɑsetde	sijɑsette
toplɑmHHn	toplɑmiin	toplɑmɯɯn
toplummHzHn	toplummizin	toplummuzun
jɯldɯzH	jɯldɯzi	jɯldɯzɯ
ʧɯkmADA	ʧɯkmɑdɑ	ʧɯkmɑtɑ
ɯʃɯnlArH	ɯʃɯnlɑri	ɯʃɯnlɑrɯ
ɑrɑnmAH	ɑrɑnmɑi	ɑrɑnmɑɯ
ɑrtHʃA	ɑrtiʃɑ	ɑrtɯʃɑ
bɑʃvurulArHn	bɑʃvurulɑrin	bɑʃvurulɑrɯn
bɑkɑnHn	bɑkɑnin	bɑkɑnɯn
bɑtɯHn	bɑtɯin	bɑtɯɯn
bulgulArHn	bulgulɑrin	bulgulɑrɯn
kɯzlArHn	kɯzlɑrin	kɯzlɑrɯn
kɑplɑmɑlArH	kɑplɑmɑlɑri	kɑplɑmɑlɑrɯ
kɑrtnHzHn	kɑrtnizin	kɑrtnɯzɯn
kɑzɑnʧlH	kɑzɑnʧli	kɑzɑnʧlɯ
mydyrmHz	mydyrmiz	mydyrmyz
memurlArHHn	memurlɑriin	memurlɑrɯɯn
mesɑʒlArHn	mesɑʒlɑrin	mesɑʒlɑrɯn
sɑlonlArH	sɑlonlɑri	sɑlonlɑrɯ
sɑtɯrH	sɑtɯri	sɑtɯrɯ
tohumlArH	tohumlɑri	tohumlɑrɯ
ulɑʃmAHn	ulɑʃmɑin	ulɑʃmɑɯn
jɑrɑlAnmAH	jɑrɑlɑnmɑi	jɑrɑlɑnmɑɯ
ʃɑrtlH	ʃɑrtli	ʃɑrtlɯ
ɑrɑHp	ɑrɑip	ɑrɑɯp
bɑskɯlH	bɑskɯli	bɑskɯlɯ
bilgisɑjɑrnHz	bilgisɑjɑrniz	bilgisɑjɑrnɯz
ʤivɑrH	ʤivɑri	ʤivɑrɯ
dønDHkDAn	døndikden	døndykten
døvHʃ	døviʃ	døvyʃ
dokulArH	dokulɑri	dokulɑrɯ
dolɑrHn	dolɑrin	dolɑrɯn
formɑsjonH	formɑsjoni	formɑsjonu
gøzlH	gøzli	gøzly
hykymetDAn	hykymetden	hykymetten
hɑtɑsHz	hɑtɑsiz	hɑtɑsɯz
insɑnlArHHn	insɑnlɑriin	insɑnlɑrɯɯn
kɑrtnHz	kɑrtniz	kɑrtnɯz
kɑrtlH	kɑrtli	kɑrtlɯ
kullɑnHp	kullɑnip	kullɑnɯp
mɑkɑmlArH	mɑkɑmlɑri	mɑkɑmlɑrɯ
mekɑnlArH	mekɑnlɑri	mekɑnlɑrɯ
meslekDAn	meslekden	meslekten
sɯnɑvHHn	sɯnɑviin	sɯnɑvɯɯn
sɑnɑjinDA	sɑnɑjindɑ	sɑnɑjinde
ɑɰɯrlɯklArH	ɑɰɯrlɯklɑri	ɑɰɯrlɯklɑrɯ
ɑlmADAn	ɑlmɑdɑn	ɑlmɑtɑn
hɑkimlAr	hɑkimlɑr	hɑkimler
kɯʃlHk	kɯʃlik	kɯʃlɯk
kɑrʃɯlɯklArH	kɑrʃɯlɯklɑri	kɑrʃɯlɯklɑrɯ
kɑrtnHzH	kɑrtnizi	kɑrtnɯzɯ
kɑslAr	kɑsler	kɑslɑr
mɑnzɑrɑlH	mɑnzɑrɑli	mɑnzɑrɑlɯ
mezɑrH	mezɑri	mezɑrɯ
mezunlArHHn	mezunlɑriin	mezunlɑrɯɯn
numɑrɑHHn	numɑrɑiin	numɑrɑɯɯn
operɑsjonlArH	operɑsjonlɑri	operɑsjonlɑrɯ
oturumH	oturumi	oturumu
rɑkɑmlArHn	rɑkɑmlɑrin	rɑkɑmlɑrɯn
jɯldɯzlArH	jɯldɯzlɑri	jɯldɯzlɑrɯ
ɯslɑhH	ɯslɑhi	ɯslɑhɯ
ɑidɑtH	ɑidɑti	ɑidɑtɯ
ɑrtHʃHHn	ɑrtiʃiin	ɑrtɯʃɯɯn
byrolArH	byrolɑri	byrolɑrɯ
byjyDHkʧA	byjydikʧe	byjydykʧe
dɑvrɑnHʃlArDA	dɑvrɑniʃlɑrdɑ	dɑvrɑnɯʃlɑrdɑ
gørmADA	gørmede	gørmete
kutulArH	kutulɑri	kutulɑrɯ
literɑtyrDA	literɑtyrdɑ	literɑtyrde
noktɑlArHHn	noktɑlɑriin	noktɑlɑrɯɯn
noktɑHHn	noktɑiin	noktɑɯɯn
normɑlDAn	normɑldɑn	normɑlden
pɑdiʃɑhHn	pɑdiʃɑhin	pɑdiʃɑhɯn
sɯfɑtH	sɯfɑti	sɯfɑtɯ
sembollAr	sembollɑr	semboller
soruHHn	soruiin	soruuun
uluslH	ulusli	uluslu
ulusH	ulusi	ulusu
virysHn	virysin	virysyn
jɑpɯʃtɯrɯʤɯHn	jɑpɯʃtɯrɯʤɯin	jɑpɯʃtɯrɯʤɯɯn
jɑpɯlAnmAH	jɑpɯlɑnmɑi	jɑpɯlɑnmɑɯ
bɑkɑnlArH	bɑkɑnlɑri	bɑkɑnlɑrɯ
bɑrɯʃʧH	bɑrɯʃʧi	bɑrɯʃʧɯ
bɑsHp	bɑsip	bɑsɯp
bɑskɯlArH	bɑskɯlɑri	bɑskɯlɑrɯ
fonksijonlArHHn	fonksijonlɑriin	fonksijonlɑrɯɯn
fonlArHn	fonlɑrin	fonlɑrɯn
hykymlHlAr	hykymliler	hykymlyler
imɑʒH	imɑʒi	imɑʒɯ
kombinɑsjonH	kombinɑsjoni	kombinɑsjonu
kullɑnmADAn	kullɑnmɑdɑn	kullɑnmɑtɑn
sigɑrɑlArHn	sigɑrɑlɑrin	sigɑrɑlɑrɯn
sinjɑllArH	sinjɑllɑri	sinjɑlleri
jykHn	jykin	jykyn
jɑnHp	jɑnip	jɑnɯp
ɑrɑzilArH	ɑrɑzilɑri	ɑrɑzileri
bɑɰlɑntɯHn	bɑɰlɑntɯin	bɑɰlɑntɯɯn
boʃluklArH	boʃluklɑri	boʃluklɑrɯ
dɑjɑnɯmH	dɑjɑnɯmi	dɑjɑnɯmɯ
durmAH	durmɑi	durmɑɯ
fijɑtHHn	fijɑtiin	fijɑtɯɯn
forumH	forumi	forumu
hɑtɑlArHn	hɑtɑlɑrin	hɑtɑlɑrɯn
køkH	køki	køky
olHʃ	oliʃ	oluʃ
orgɑnizɑsjonlArH	orgɑnizɑsjonlɑri	orgɑnizɑsjonlɑrɯ
pijɑsɑlArHn	pijɑsɑlɑrin	pijɑsɑlɑrɯn
sɯnɯrlArHn	sɯnɯrlɑrin	sɯnɯrlɑrɯn
sɑtɯrHn	sɑtɯrin	sɑtɯrɯn
sertifikɑlH	sertifikɑli	sertifikɑlɯ
tɑbɑnlArH	tɑbɑnlɑri	tɑbɑnlɑrɯ
ujumlHlHk	ujumlilik	ujumluluk
jɑpmAnHzH	jɑpmɑnizi	jɑpmɑnɯzɯ
ʧɑɰmHzDA	ʧɑɰmizde	ʧɑɰmɯzdɑ
øzgyrlHklArHn	øzgyrliklerin	øzgyrlyklerin
ʃɑrkɯlArH	ʃɑrkɯlɑri	ʃɑrkɯlɑrɯ
ɑrɑHʃH	ɑrɑiʃi	ɑrɑɯʃɯ
ɑsistɑnH	ɑsistɑni	ɑsistɑnɯ
bølymmHzDA	bølymmizde	bølymmyzde
bɑbɑmHn	bɑbɑmin	bɑbɑmɯn
bɑnkɑlArHHn	bɑnkɑlɑriin	bɑnkɑlɑrɯɯn
dɯʃDAn	dɯʃdɑn	dɯʃtɑn
dyʃmɑnlHk	dyʃmɑnlik	dyʃmɑnlɯk
dɑlgɑH	dɑlgɑi	dɑlgɑɯ
dokymɑnlArH	dokymɑnlɑri	dokymɑnlɑrɯ
hɑjɑtDAn	hɑjɑtdɑn	hɑjɑttɑn
kɑlkɯnmAHn	kɑlkɯnmɑin	kɑlkɯnmɑɯn
kɑnɑllH	kɑnɑlli	kɑnɑllɯ
kodlH	kodli	kodlu
komisjonlArHn	komisjonlɑrin	komisjonlɑrɯn
kontrolA	kontrolɑ	kontrole
merɑklH	merɑkli	merɑklɯ
numɑrɑH	numɑrɑi	numɑrɑɯ
pɑmuklH	pɑmukli	pɑmuklu
sɯklHkDA	sɯklikdɑ	sɯklɯktɑ
sɯnɯfHHn	sɯnɯfiin	sɯnɯfɯɯn
sɑbɯrlH	sɑbɯrli	sɑbɯrlɯ
jɑrɯʃmɑlArH	jɑrɯʃmɑlɑri	jɑrɯʃmɑlɑrɯ
jɑzlArH	jɑzlɑri	jɑzlɑrɯ
ɑkHp	ɑkip	ɑkɯp
dujgulArHn	dujgulɑrin	dujgulɑrɯn
gebelHkDA	gebelikde	gebelikte
impɑrɑtorlHk	impɑrɑtorlik	impɑrɑtorluk
køjlHlArHn	køjlilerin	køjlylerin
kɑmpɑnjɑHn	kɑmpɑnjɑin	kɑmpɑnjɑɯn
kɑtmɑnH	kɑtmɑni	kɑtmɑnɯ
kɑvrɑmHn	kɑvrɑmin	kɑvrɑmɯn
mɑhijetDA	mɑhijetde	mɑhijette
mɑkinɑHn	mɑkinɑin	mɑkinɑɯn
reɑksijonH	reɑksijoni	reɑksijonu
rollArH	rollɑri	rolleri
sɑnɑjiA	sɑnɑjiɑ	sɑnɑjie
tɑrtɯʃmAH	tɑrtɯʃmɑi	tɑrtɯʃmɑɯ
jɑnlɯʃlHk	jɑnlɯʃlik	jɑnlɯʃlɯk
jɑprɑklArHHn	jɑprɑklɑriin	jɑprɑklɑrɯɯn
ysH	ysi	ysy
ɑʤɯlArH	ɑʤɯlɑri	ɑʤɯlɑrɯ
ɑkHʃHHn	ɑkiʃiin	ɑkɯʃɯɯn
ɑltjɑpɯHHn	ɑltjɑpɯiin	ɑltjɑpɯɯɯn
bozHʤH	boziʤi	bozuʤu
durgunlHk	durgunlik	durgunluk
dujHnʤA	dujinʤɑ	dujunʤɑ
dujurulArH	dujurulɑri	dujurulɑrɯ
eʃjɑlArHn	eʃjɑlɑrin	eʃjɑlɑrɯn
firmɑnHzHn	firmɑnizin	firmɑnɯzɯn
hesɑplAnArAk	hesɑplɑnerek	hesɑplɑnɑrɑk
hukukʧH	hukukʧi	hukukʧu
kɑdrolArHn	kɑdrolɑrin	kɑdrolɑrɯn
kɑpɯHHn	kɑpɯiin	kɑpɯɯɯn
kɑtɯlHp	kɑtɯlip	kɑtɯlɯp
kitɑpDAn	kitɑpdɑn	kitɑptɑn
kontrolnA	kontrolnɑ	kontrolne
konumHz	konumiz	konumuz
mɑkinɑlArHHn	mɑkinɑlɑriin	mɑkinɑlɑrɯɯn
nɑzɯrH	nɑzɯri	nɑzɯrɯ
pɑnoH	pɑnoi	pɑnou
pɑtlɑmAH	pɑtlɑmɑi	pɑtlɑmɑɯ
sɑtɯmH	sɑtɯmi	sɑtɯmɯ
sigortɑʤɯHn	sigortɑʤɯin	sigortɑʤɯɯn
toplummHzDA	toplummizde	toplummuzdɑ
ɯʃɯklArH	ɯʃɯklɑri	ɯʃɯklɑrɯ
ɑdɑlArH	ɑdɑlɑri	ɑdɑlɑrɯ
ɑrɑbɑH	ɑrɑbɑi	ɑrɑbɑɯ
ɑrkɑdɑʃlArHn	ɑrkɑdɑʃlɑrin	ɑrkɑdɑʃlɑrɯn
ɑtɑmAlArH	ɑtɑmɑlɑri	ɑtɑmɑlɑrɯ
ɑvH	ɑvi	ɑvɯ
ɑjrɯʤɑlɯklH	ɑjrɯʤɑlɯkli	ɑjrɯʤɑlɯklɯ
bɑʃnHzA	bɑʃnize	bɑʃnɯzɑ
bɑbɑlArHn	bɑbɑlɑrin	bɑbɑlɑrɯn
dɑvɑlArHn	dɑvɑlɑrin	dɑvɑlɑrɯn
dekɑnlHk	dekɑnlik	dekɑnlɯk
depolAnmAH	depolenmei	depolɑnmɑɯ
doktornHzA	doktornize	doktornuzɑ
kɑlɑnH	kɑlɑni	kɑlɑnɯ
kɑmpDA	kɑmpdɑ	kɑmptɑ
kɑjgɯH	kɑjgɯi	kɑjgɯɯ
mɑhɑllinDA	mɑhɑllindɑ	mɑhɑllinde
mektupDA	mektupdɑ	mektuptɑ
metɑllAr	metɑllɑr	metɑller
oɰullArH	oɰullɑri	oɰullɑrɯ
ormɑnlArHn	ormɑnlɑrin	ormɑnlɑrɯn
sɑpH	sɑpi	sɑpɯ
tɑnɯmlAHʤH	tɑnɯmlɑiʤi	tɑnɯmlɑɯʤɯ
televizjonH	televizjoni	televizjonu
jorumlAnmAH	jorumlɑnmɑi	jorumlɑnmɑɯ
ʧɯkHʃlArH	ʧɯkiʃlɑri	ʧɯkɯʃlɑrɯ
ʧɯktɯH	ʧɯktɯi	ʧɯktɯɯ
ɯsrɑrlH	ɯsrɑrli	ɯsrɑrlɯ
ɑlɯnmADA	ɑlɯnmɑdɑ	ɑlɯnmɑtɑ
ɑlmAnHzH	ɑlmɑnizi	ɑlmɑnɯzɯ
ɑnlɑmlArH	ɑnlɑmlɑri	ɑnlɑmlɑrɯ
ɑnlɑtɯmH	ɑnlɑtɯmi	ɑnlɑtɯmɯ
ɑtH	ɑti	ɑtɯ
dɑllArHHn	dɑllɑriin	dɑllɑrɯɯn
istikrɑrHn	istikrɑrin	istikrɑrɯn
kɯzlArH	kɯzlɑri	kɯzlɑrɯ
kɑtɯlɯmʤɯlArH	kɑtɯlɯmʤɯlɑri	kɑtɯlɯmʤɯlɑrɯ
kitɑplArHHn	kitɑplɑriin	kitɑplɑrɯɯn
konuʃmAlArHn	konuʃmɑlɑrin	konuʃmɑlɑrɯn
konutlArHn	konutlɑrin	konutlɑrɯn
mɑrkɑlH	mɑrkɑli	mɑrkɑlɯ
mɑrkɑlArH	mɑrkɑlɑri	mɑrkɑlɑrɯ
muhɑfɑzɑH	muhɑfɑzɑi	muhɑfɑzɑɯ
okulHHn	okuliin	okuluun
sɑʧlArH	sɑʧlɑri	sɑʧlɑrɯ
sɑjfɑmHzDA	sɑjfɑmizde	sɑjfɑmɯzdɑ
sendikɑlArH	sendikɑlɑri	sendikɑlɑrɯ
tɑnɯklHk	tɑnɯklik	tɑnɯklɯk
tɑnrɯH	tɑnrɯi	tɑnrɯɯ
tɑrɯmHn	tɑrɯmin	tɑrɯmɯn
uzmɑnlArHHn	uzmɑnlɑriin	uzmɑnlɑrɯɯn
jɑrɑlAnmAlArH	jɑrɑlɑnmɑlɑri	jɑrɑlɑnmɑlɑrɯ
ʧøzHʤH	ʧøziʤi	ʧøzyʤy
ʃɑrtsHz	ʃɑrtsiz	ʃɑrtsɯz
ystDAn	ystden	ystten
ɑkɯmHn	ɑkɯmin	ɑkɯmɯn
ɑrkɑdɑʃmHzHn	ɑrkɑdɑʃmizin	ɑrkɑdɑʃmɯzɯn
bɑʃɑrɯlArHHn	bɑʃɑrɯlɑriin	bɑʃɑrɯlɑrɯɯn
ʤɑmHn	ʤɑmin	ʤɑmɯn
fotoɰrɑfʧHlHk	fotoɰrɑfʧilik	fotoɰrɑfʧɯlɯk
fotoɰrɑfʧHlAr	fotoɰrɑfʧilɑr	fotoɰrɑfʧɯlɑr
hyzynlH	hyzynli	hyzynly
hɑjɑtmHzDA	hɑjɑtmizde	hɑjɑtmɯzdɑ
insɑnmHzHn	insɑnmizin	insɑnmɯzɯn
kɑpɑnmAH	kɑpɑnmɑi	kɑpɑnmɑɯ
metodlAr	metodler	metodlɑr
pɑrɑsHz	pɑrɑsiz	pɑrɑsɯz
reɑksijonlArH	reɑksijonlɑri	reɑksijonlɑrɯ
sytʧH	sytʧi	sytʧy
sɑjɯlArHHn	sɑjɯlɑriin	sɑjɯlɑrɯɯn
sɑjfɑmHz	sɑjfɑmiz	sɑjfɑmɯz
toplɑntɯHHn	toplɑntɯiin	toplɑntɯɯɯn
ødyllH	ødylli	ødylly
ʃiʃmɑnlHk	ʃiʃmɑnlik	ʃiʃmɑnlɯk
ʃurɑH	ʃurɑi	ʃurɑɯ
ɑɰɯzlArH	ɑɰɯzlɑri	ɑɰɯzlɑrɯ
ɑksesuɑrlArH	ɑksesuɑrlɑri	ɑksesuɑrlɑrɯ
ɑmelijɑtDAn	ɑmelijɑtdɑn	ɑmelijɑttɑn
ɑrɑbɑH	ɑrɑbɑi	ɑrɑbɑɯ
ɑsɯllH	ɑsɯlli	ɑsɯllɯ
bloklArH	bloklɑri	bloklɑrɯ
bulmADA	bulmɑde	bulmɑtɑ
dikkɑtlArH	dikkɑtlɑri	dikkɑtleri
gyʧDA	gyʧde	gyʧte
kɑnɑtlArH	kɑnɑtlɑri	kɑnɑtlɑrɯ
kɑplɑmɑlH	kɑplɑmɑli	kɑplɑmɑlɯ
kuruluH	kurului	kuruluu
levhɑlArH	levhɑlɑri	levhɑlɑrɯ
mɑterjɑllArH	mɑterjɑllɑri	mɑterjɑlleri
meslektɑʃlArmHz	meslektɑʃlɑrmiz	meslektɑʃlɑrmɯz
nɑzlH	nɑzli	nɑzlɯ
olArAkDA	olɑrɑkdɑ	olɑrɑktɑ
plɑnlArHn	plɑnlɑrin	plɑnlɑrɯn
protokollAr	protokollɑr	protokoller
ruhsɑtlH	ruhsɑtli	ruhsɑtlɯ
sɑjɯlArHn	sɑjɯlɑrin	sɑjɯlɑrɯn
sendikɑlArHn	sendikɑlɑrin	sendikɑlɑrɯn
suʧlArHn	suʧlɑrin	suʧlɑrɯn
tɑlimɑtlArH	tɑlimɑtlɑri	tɑlimɑtlɑrɯ
tɑnkH	tɑnki	tɑnkɯ
jɯldɯzlArHn	jɯldɯzlɑrin	jɯldɯzlɑrɯn
jɑɰlArH	jɑɰlɑri	jɑɰlɑrɯ
jɑpmAlArnH	jɑpmɑlɑrni	jɑpmɑlɑrnɯ
zɑbɯtɑH	zɑbɯtɑi	zɑbɯtɑɯ
ʃeffɑflHk	ʃeffɑflik	ʃeffɑflɯk
ɑʤɯH	ɑʤɯi	ɑʤɯɯ
ɑlgɯlAnmAH	ɑlgɯlɑnmɑi	ɑlgɯlɑnmɑɯ
bɑʃHHn	bɑʃiin	bɑʃɯɯn
bulguH	bulgui	bulguu
depolArH	depoleri	depolɑrɯ
dokuznʤH	dokuznʤi	dokuznʤu
donɑnɯmlArH	donɑnɯmlɑri	donɑnɯmlɑrɯ
dumɑnHn	dumɑnin	dumɑnɯn
fɑturɑHn	fɑturɑin	fɑturɑɯn
kɑplɑmɑH	kɑplɑmɑi	kɑplɑmɑɯ
konsoloslHk	konsoloslik	konsolosluk
korumAH	korumɑi	korumɑɯ
mysteʃɑrlHkʧA	mysteʃɑrlikʧɑ	mysteʃɑrlɯkʧɑ
ryzgɑrH	ryzgɑri	ryzgɑrɯ
rektørHn	rektørin	rektøryn
ruhsɑtsHz	ruhsɑtsiz	ruhsɑtsɯz
sɑʧlH	sɑʧli	sɑʧlɯ
silɑhHn	silɑhin	silɑhɯn
sinemɑH	sinemɑi	sinemɑɯ
telefonnHzHn	telefonnizin	telefonnuzun
televizjonlArDA	televizjonlerde	televizjonlɑrdɑ
zɑmɑnlArHn	zɑmɑnlɑrin	zɑmɑnlɑrɯn
ʧɯrɑklHk	ʧɯrɑklik	ʧɯrɑklɯk
ʧoʤukDAn	ʧoʤukdɑn	ʧoʤuktɑn
ɑdnHz	ɑdniz	ɑdnɯz
ɑkɯmHHn	ɑkɯmiin	ɑkɯmɯɯn
ɑltɯnHn	ɑltɯnin	ɑltɯnɯn
bɑʃɑrɯHHn	bɑʃɑrɯiin	bɑʃɑrɯɯɯn
betonHn	betonin	betonun
ʤihɑzHHn	ʤihɑziin	ʤihɑzɯɯn
dɑjɑnɯʃmɑH	dɑjɑnɯʃmɑi	dɑjɑnɯʃmɑɯ
editørH	editøri	editøry
fɑrkHn	fɑrkin	fɑrkɯn
gynHHn	gyniin	gynyyn
kømyrH	kømyri	kømyry
kɑmpɑnjɑlArH	kɑmpɑnjɑlɑri	kɑmpɑnjɑlɑrɯ
kɑtɯlDHklArH	kɑtɯldiklɑri	kɑtɯldɯklɑrɯ
kurbɑnH	kurbɑni	kurbɑnɯ
mɑkinɑlArHn	mɑkinɑlɑrin	mɑkinɑlɑrɯn
menfɑɑtlArH	menfɑɑtlɑri	menfɑɑtleri
olmAHʃH	olmɑiʃi	olmɑɯʃɯ
olumsuzlHklAr	olumsuzliklɑr	olumsuzluklɑr
pɑjHn	pɑjin	pɑjɯn
sɑjgɯlArmH	sɑjgɯlɑrmi	sɑjgɯlɑrmɯ
sorulArnHzH	sorulɑrnizi	sorulɑrnɯzɯ
telefonnHzA	telefonnize	telefonnuzɑ
jɑʃDAn	jɑʃdɑn	jɑʃtɑn
zɑmɑnkinDAn	zɑmɑnkindɑn	zɑmɑnkinden
ɑdnHzH	ɑdnizi	ɑdnɯzɯ
ɑrʃivlArH	ɑrʃivlɑri	ɑrʃivleri
ɑjɯrɯmH	ɑjɯrɯmi	ɑjɯrɯmɯ
buhɑrH	buhɑri	buhɑrɯ
gyʧsHz	gyʧsiz	gyʧsyz
hɑrʤɑmAH	hɑrʤɑmɑi	hɑrʤɑmɑɯ
itirɑzlArH	itirɑzlɑri	itirɑzlɑrɯ
kɯjɯlArH	kɯjɯlɑri	kɯjɯlɑrɯ
kullAnHʤHlH	kullɑniʤili	kullɑnɯʤɯlɯ
mekɑnlArHn	mekɑnlɑrin	mekɑnlɑrɯn
metɑllArHn	metɑllɑrin	metɑllerin
oluʃmADA	oluʃmɑdɑ	oluʃmɑtɑ
olHnʤAA	olinʤɑɑ	olunʤɑɑ
pyryzsHz	pyryzsiz	pyryzsyz
rekɑbetDA	rekɑbetde	rekɑbette
sɑldɯrɯHn	sɑldɯrɯin	sɑldɯrɯɯn
sɑjɯH	sɑjɯi	sɑjɯɯ
sipɑriʃlAr	sipɑriʃlɑr	sipɑriʃler
terørH	terøri	terøry
tozlH	tozli	tozlu
jɑpmAnHzA	jɑpmɑnize	jɑpmɑnɯzɑ
jɑrɯʃlArH	jɑrɯʃlɑri	jɑrɯʃlɑrɯ
jɑzɯlɯmlArHHn	jɑzɯlɯmlɑriin	jɑzɯlɯmlɑrɯɯn
juvɑH	juvɑi	juvɑɯ
ʧɯkHʃlH	ʧɯkiʃli	ʧɯkɯʃlɯ
ʧɑɰHHn	ʧɑɰiin	ʧɑɰɯɯn
ʧɑlɯʃɑnlArmHzHn	ʧɑlɯʃɑnlɑrmizin	ʧɑlɯʃɑnlɑrmɯzɯn
ʧɑlɯʃmAlArmHzDA	ʧɑlɯʃmɑlɑrmizde	ʧɑlɯʃmɑlɑrmɯzdɑ
ɑʧɯkDAn	ɑʧɯkdɑn	ɑʧɯktɑn
ɑdHn	ɑdin	ɑdɯn
bɑʃmHzA	bɑʃmize	bɑʃmɯzɑ
bɑkɑnlɯkDAn	bɑkɑnlɯkdɑn	bɑkɑnlɯktɑn
buluʃH	buluʃi	buluʃu
buzlH	buzli	buzlu
dønHʃDA	døniʃde	dønyʃte
dɑnɯʃmɑnHHn	dɑnɯʃmɑniin	dɑnɯʃmɑnɯɯn
enfeksijonHn	enfeksijonin	enfeksijonun
frekɑnslH	frekɑnsli	frekɑnslɯ
kɑdroHn	kɑdroin	kɑdroun
kɑrʃɯmHzDA	kɑrʃɯmizde	kɑrʃɯmɯzdɑ
kɑjbolmAH	kɑjbolmɑi	kɑjbolmɑɯ
koʃulsHz	koʃulsiz	koʃulsuz
kutlɑmAlArH	kutlɑmɑlɑri	kutlɑmɑlɑrɯ
mutfɑkDA	mutfɑkdɑ	mutfɑktɑ
sɑɰlɑDHklArH	sɑɰlɑdiklɑri	sɑɰlɑdɯklɑrɯ
sɑtɯʤɯHn	sɑtɯʤɯin	sɑtɯʤɯɯn
sɑjɯmHz	sɑjɯmiz	sɑjɯmɯz
sihirbɑzH	sihirbɑzi	sihirbɑzɯ
tɯklAHp	tɯklɑip	tɯklɑɯp
tɑrtɯʃmAH	tɑrtɯʃmɑi	tɑrtɯʃmɑɯ
tijɑtroHn	tijɑtroin	tijɑtroun
uɰrɑmAH	uɰrɑmɑi	uɰrɑmɑɯ
vɑtɑnHn	vɑtɑnin	vɑtɑnɯn
jɑɰlArHn	jɑɰlɑrin	jɑɰlɑrɯn
ʧɑlɯʃDHkDAn	ʧɑlɯʃdikdɑn	ʧɑlɯʃtɯktɑn
ʧɑrpmAH	ʧɑrpmɑi	ʧɑrpmɑɯ
ɑʃɯHn	ɑʃɯin	ɑʃɯɯn
ɑdnHzA	ɑdnize	ɑdnɯzɑ
ɑnɯtH	ɑnɯti	ɑnɯtɯ
ɑrɑʤɯnHzHn	ɑrɑʤɯnizin	ɑrɑʤɯnɯzɯn
byjyklHklArH	byjyklikleri	byjyklykleri
byjyklHkDAki	byjyklikdeki	byjyklykteki
beʃDA	beʃde	beʃte
borʧlArHHn	borʧlɑriin	borʧlɑrɯɯn
borʧlHHn	borʧliin	borʧluun
dɑɰɯlɯmHHn	dɑɰɯlɯmiin	dɑɰɯlɯmɯɯn
destɑnH	destɑni	destɑnɯ
gørDHkDAn	gørdikden	gørdykten
girmADA	girmede	girmete
kɯʃlArH	kɯʃlɑri	kɯʃlɑrɯ
kɑlɯplArH	kɑlɯplɑri	kɑlɯplɑrɯ
kɑnɑllArHHn	kɑnɑllɑriin	kɑnɑllɑrɯɯn
kuʃlArHn	kuʃlɑrin	kuʃlɑrɯn
lezjonHn	lezjonin	lezjonun
mɑmullArH	mɑmullɑri	mɑmulleri
mimɑrH	mimɑri	mimɑrɯ
ojunlArHn	ojunlɑrin	ojunlɑrɯn
pɑrʧɑlArHHn	pɑrʧɑlɑriin	pɑrʧɑlɑrɯɯn
prosedyrH	prosedyri	prosedyry
sinjɑllAr	sinjɑllɑr	sinjɑller
tɑkɯmHHn	tɑkɯmiin	tɑkɯmɯɯn
vɑtɑnH	vɑtɑni	vɑtɑnɯ
jykymlHlHklAr	jykymlilikler	jykymlylykler
ʧɑlɯʃmAmHz	ʧɑlɯʃmɑmiz	ʧɑlɯʃmɑmɯz
ʧoɰunlukDA	ʧoɰunlukdɑ	ʧoɰunluktɑ
ynH	yni	yny
ɑlɯnmAHHn	ɑlɯnmɑiin	ɑlɯnmɑɯɯn
ɑlɑʤɑklH	ɑlɑʤɑkli	ɑlɑʤɑklɯ
ɑjɑrlH	ɑjɑrli	ɑjɑrlɯ
bɑlɯkʧɯlHk	bɑlɯkʧɯlik	bɑlɯkʧɯlɯk
etkinlHkDA	etkinlikde	etkinlikte
gøʧH	gøʧi	gøʧy
gørmADAn	gørmeden	gørmeten
hesɑplArHHn	hesɑplɑriin	hesɑplɑrɯɯn
kɑlɯnlHk	kɑlɯnlik	kɑlɯnlɯk
kɑnɑlHn	kɑnɑlin	kɑnɑlɯn
kɑvrɑmlArHHn	kɑvrɑmlɑriin	kɑvrɑmlɑrɯɯn
komplikɑsjonlArH	komplikɑsjonlɑri	komplikɑsjonlɑrɯ
metɑbolizmɑH	metɑbolizmɑi	metɑbolizmɑɯ
muhtevɑH	muhtevɑi	muhtevɑɯ
odɑlH	odɑli	odɑlɯ
odɑmHzA	odɑmize	odɑmɯzɑ
ordulArH	ordulɑri	ordulɑrɯ
pɑrlɑklHk	pɑrlɑklik	pɑrlɑklɯk
propɑgɑndɑH	propɑgɑndɑi	propɑgɑndɑɯ
ryjɑH	ryjɑi	ryjɑɯ
tɑnɯmlAmAH	tɑnɯmlɑmɑi	tɑnɯmlɑmɑɯ
telefonnHzH	telefonnizi	telefonnuzu
teminɑtlArH	teminɑtlɑri	teminɑtlɑrɯ
usullArA	usullɑrɑ	usullere
vɑkɑH	vɑkɑi	vɑkɑɯ
jɑnsɯmAlArH	jɑnsɯmɑlɑri	jɑnsɯmɑlɑrɯ
ʧɑbɑlArHn	ʧɑbɑlɑrin	ʧɑbɑlɑrɯn
ʧɑlɯʃmADAn	ʧɑlɯʃmɑdɑn	ʧɑlɯʃmɑtɑn
ʃɑnlH	ʃɑnli	ʃɑnlɯ
ɑnɯlArH	ɑnɯlɑri	ɑnɯlɑrɯ
ɑrɑzilAr	ɑrɑzilɑr	ɑrɑziler
ɑrkɑdɑʃlArmHzA	ɑrkɑdɑʃlɑrmize	ɑrkɑdɑʃlɑrmɯzɑ
bɑɰlɑntɯHHn	bɑɰlɑntɯiin	bɑɰlɑntɯɯɯn
bɑrɑʒHn	bɑrɑʒin	bɑrɑʒɯn
køjHHn	køjiin	køjyyn
kɑnɑmAH	kɑnɑmɑi	kɑnɑmɑɯ
kɑtɯlɯmʤɯHn	kɑtɯlɯmʤɯin	kɑtɯlɯmʤɯɯn
memurHHn	memuriin	memuruun
pijɑsɑHHn	pijɑsɑiin	pijɑsɑɯɯn
progrɑmlH	progrɑmli	progrɑmlɯ
rɑdjoH	rɑdjoi	rɑdjou
tɯrmɑnHʃH	tɯrmɑniʃi	tɯrmɑnɯʃɯ
tɑʃlArHn	tɑʃlɑrin	tɑʃlɑrɯn
tɑkɯlH	tɑkɯli	tɑkɯlɯ
teminɑtHn	teminɑtin	teminɑtɯn
terminɑllArH	terminɑllɑri	terminɑlleri
uɰurlH	uɰurli	uɰurlu
ujɑrɯH	ujɑrɯi	ujɑrɯɯ
jɑnmHzDA	jɑnmizde	jɑnmɯzdɑ
zɑrɑrsHz	zɑrɑrsiz	zɑrɑrsɯz
zorlAHʤH	zorlɑiʤi	zorlɑɯʤɯ
ʧɑbɑlArHHn	ʧɑbɑlɑriin	ʧɑbɑlɑrɯɯn
ʧɑlɯʃmɑlArnHzDA	ʧɑlɯʃmɑlɑrnizde	ʧɑlɯʃmɑlɑrnɯzdɑ
ɑɰlArHHn	ɑɰlɑriin	ɑɰlɑrɯɯn
ɑrɑlɯklArH	ɑrɑlɯklɑri	ɑrɑlɯklɑrɯ
dykkɑnlArHn	dykkɑnlɑrin	dykkɑnlɑrɯn
dokulArHn	dokulɑrin	dokulɑrɯn
fɑbrikɑlArHn	fɑbrikɑlɑrin	fɑbrikɑlɑrɯn
gɑzlArH	gɑzlɑri	gɑzlɑrɯ
geʧHʃDA	geʧiʃde	geʧiʃte
geʧmADA	geʧmede	geʧmete
ihtijɑʧlArHn	ihtijɑʧlɑrin	ihtijɑʧlɑrɯn
insɑnlArmHzHn	insɑnlɑrmizin	insɑnlɑrmɯzɯn
istɑsjonlArHHn	istɑsjonlɑriin	istɑsjonlɑrɯɯn
mɑrʃH	mɑrʃi	mɑrʃɯ
mikroorgɑnizmɑlArHn	mikroorgɑnizmɑlɑrin	mikroorgɑnizmɑlɑrɯn
ortɑklArHHn	ortɑklɑriin	ortɑklɑrɯɯn
ortɑH	ortɑi	ortɑɯ
portføjH	portføji	portføjy
rolA	rolɑ	role
sɯnɯrlɑmɑH	sɯnɯrlɑmɑi	sɯnɯrlɑmɑɯ
sonlArH	sonlɑri	sonlɑrɯ
tɑrɑmɑlArH	tɑrɑmɑlɑri	tɑrɑmɑlɑrɯ
teʃkilɑtHn	teʃkilɑtin	teʃkilɑtɯn
vɑtɑndɑʃlArHHn	vɑtɑndɑʃlɑriin	vɑtɑndɑʃlɑrɯɯn
jɑɰHn	jɑɰin	jɑɰɯn
jɑrɯHHn	jɑrɯiin	jɑrɯɯɯn
jɑrɑrlAnmAH	jɑrɑrlɑnmɑi	jɑrɑrlɑnmɑɯ
jemekDA	jemekde	jemekte
ʧɯkmAH	ʧɯkmɑi	ʧɯkmɑɯ
ɑnlɑʃmɑH	ɑnlɑʃmɑi	ɑnlɑʃmɑɯ
ɑrkɑdɑʃlHk	ɑrkɑdɑʃlik	ɑrkɑdɑʃlɯk
dɑlgɑlArHn	dɑlgɑlɑrin	dɑlgɑlɑrɯn
dɑnɯʃmɑnlArH	dɑnɯʃmɑnlɑri	dɑnɯʃmɑnlɑrɯ
fɑɑlijetDAn	fɑɑlijetden	fɑɑlijetten
fotoɰrɑflArHHn	fotoɰrɑflɑriin	fotoɰrɑflɑrɯɯn
gøtyrHp	gøtyrip	gøtyryp
hɑtɑH	hɑtɑi	hɑtɑɯ
inɑnHn	inɑnin	inɑnɯn
kɑsɯtlH	kɑsɯtli	kɑsɯtlɯ
kɑzɑnDHklArH	kɑzɑndiklɑri	kɑzɑndɯklɑrɯ
kitɑplHk	kitɑplik	kitɑplɯk
kodHHn	kodiin	koduun
korumɑHn	korumɑin	korumɑɯn
mɑnzɑrɑH	mɑnzɑrɑi	mɑnzɑrɑɯ
pɑrʧɑHHn	pɑrʧɑiin	pɑrʧɑɯɯn
sɑɰlɑmAHn	sɑɰlɑmɑin	sɑɰlɑmɑɯn
sɑhɑHHn	sɑhɑiin	sɑhɑɯɯn
sunuʤulArH	sunuʤulɑri	sunuʤulɑrɯ
tymørHn	tymørin	tymøryn
tɑrzHHn	tɑrziin	tɑrzɯɯn
telefonlArHHn	telefonleriin	telefonlɑrɯɯn
toplɑntɯlArHHn	toplɑntɯlɑriin	toplɑntɯlɑrɯɯn
uʧlH	uʧli	uʧlu
uzɑklɯkDAki	uzɑklɯkdɑki	uzɑklɯktɑki
jɑtɑkDA	jɑtɑkdɑ	jɑtɑktɑ
jɑzɯlɯmHHn	jɑzɯlɯmiin	jɑzɯlɯmɯɯn
ɑrɑʃtɯrmAH	ɑrɑʃtɯrmɑi	ɑrɑʃtɯrmɑɯ
ɑrzH	ɑrzi	ɑrzɯ
ɑtɑklArH	ɑtɑklɑri	ɑtɑklɑrɯ
dokymɑnH	dokymɑni	dokymɑnɯ
hykymdɑrH	hykymdɑri	hykymdɑrɯ
kɯzHHn	kɯziin	kɯzɯɯn
kɑrʃɯH	kɑrʃɯi	kɑrʃɯɯ
kɑjmɑkɑmlHk	kɑjmɑkɑmlik	kɑjmɑkɑmlɯk
kolɑjlɯklArH	kolɑjlɯklɑri	kolɑjlɯklɑrɯ
koordinɑtlArH	koordinɑtlɑri	koordinɑtlɑrɯ
kuruluʃDAn	kuruluʃdɑn	kuruluʃtɑn
kurummHz	kurummiz	kurummuz
lɑborɑtuvɑrlArH	lɑborɑtuvɑrlɑri	lɑborɑtuvɑrlɑrɯ
mɑrkɑlArHn	mɑrkɑlɑrin	mɑrkɑlɑrɯn
odɑmHzHn	odɑmizin	odɑmɯzɯn
olguHn	olguin	olguun
orkestrɑH	orkestrɑi	orkestrɑɯ
ortɑlɑmɑlArH	ortɑlɑmɑlɑri	ortɑlɑmɑlɑrɯ
pɑrkHn	pɑrkin	pɑrkɯn
sɯkɯntɯlArHn	sɯkɯntɯlɑrin	sɯkɯntɯlɑrɯn
sɯnɯflArHn	sɯnɯflɑrin	sɯnɯflɑrɯn
sɯnɑvlArHHn	sɯnɑvlɑriin	sɯnɑvlɑrɯɯn
sɯvɯHn	sɯvɯin	sɯvɯɯn
sɑrɯH	sɑrɯi	sɑrɯɯ
sɑjfɑlArHn	sɑjfɑlɑrin	sɑjfɑlɑrɯn
silɑhsHzlAnmA	silɑhsizlenme	silɑhsɯzlɑnmɑ
skorH	skori	skoru
sonuʧsHz	sonuʧsiz	sonuʧsuz
tɑhtɑH	tɑhtɑi	tɑhtɑɯ
telefonnHz	telefonniz	telefonnuz
tutɑnɑklArH	tutɑnɑklɑri	tutɑnɑklɑrɯ
unsurlArHHn	unsurlɑriin	unsurlɑrɯɯn
viʤdɑnH	viʤdɑni	viʤdɑnɯ
jɑnɯtlArH	jɑnɯtlɑri	jɑnɯtlɑrɯ
ʧɯkɑrmɑH	ʧɯkɑrmɑi	ʧɯkɑrmɑɯ
ʧorbɑH	ʧorbɑi	ʧorbɑɯ
ɑlmAmHz	ɑlmɑmiz	ɑlmɑmɯz
ɑltDAn	ɑltdɑn	ɑlttɑn
ɑltjɑpɯHn	ɑltjɑpɯin	ɑltjɑpɯɯn
ɑjɑklH	ɑjɑkli	ɑjɑklɯ
bɑʃlɑngɯʧDAn	bɑʃlɑngɯʧdɑn	bɑʃlɑngɯʧtɑn
bɑsɑmɑklH	bɑsɑmɑkli	bɑsɑmɑklɯ
birkɑʧH	birkɑʧi	birkɑʧɯ
dynH	dyni	dyny
diskDA	diskde	diskte
getirmADA	getirmede	getirmete
gitDHklArH	gitdikleri	gittikleri
hɑjɑtmHzH	hɑjɑtmizi	hɑjɑtmɯzɯ
ihrɑʤɑtHHn	ihrɑʤɑtiin	ihrɑʤɑtɯɯn
kɯzɑrɯklHk	kɯzɑrɯklik	kɯzɑrɯklɯk
mevzuɑtHHn	mevzuɑtiin	mevzuɑtɯɯn
sɯvɯH	sɯvɯi	sɯvɯɯ
sɑɑtlArHHn	sɑɑtlɑriin	sɑɑtleriin
sultɑnH	sultɑni	sultɑnɯ
tɑkɯlmAH	tɑkɯlmɑi	tɑkɯlmɑɯ
tɑrtɯʃmAHn	tɑrtɯʃmɑin	tɑrtɯʃmɑɯn
tutmAH	tutmɑi	tutmɑɯ
vɑrlɯklArHHn	vɑrlɯklɑriin	vɑrlɯklɑrɯɯn
jɑkɯnmAlArH	jɑkɯnmɑlɑri	jɑkɯnmɑlɑrɯ
jɑnmAH	jɑnmɑi	jɑnmɑɯ
ʧɯkɑrHn	ʧɯkɑrin	ʧɯkɑrɯn
ʧɑlɯʃmAlArmHzA	ʧɑlɯʃmɑlɑrmize	ʧɑlɯʃmɑlɑrmɯzɑ
ʧoʤuklArmHzH	ʧoʤuklɑrmizi	ʧoʤuklɑrmɯzɯ
ɑbɑrtɯlH	ɑbɑrtɯli	ɑbɑrtɯlɯ
ɑlɯnmAmAH	ɑlɯnmɑmɑi	ɑlɯnmɑmɑɯ
ɑlbymHn	ɑlbymin	ɑlbymyn
ɑrɑʧDA	ɑrɑʧdɑ	ɑrɑʧtɑ
ɑteʃDAn	ɑteʃden	ɑteʃten
bɑsɯmH	bɑsɯmi	bɑsɯmɯ
duvɑrlArHn	duvɑrlɑrin	duvɑrlɑrɯn
gøʧHn	gøʧin	gøʧyn
inʃɑH	inʃɑi	inʃɑɯ
kɑlmADA	kɑlmɑdɑ	kɑlmɑtɑ
kɑlmAmAH	kɑlmɑmɑi	kɑlmɑmɑɯ
kɑnsHzlHk	kɑnsizlik	kɑnsɯzlɯk
kɑtlArH	kɑtlɑri	kɑtlɑrɯ
kullɑnɯmlH	kullɑnɯmli	kullɑnɯmlɯ
kurɑklHk	kurɑklik	kurɑklɯk
kurtɑrHʤH	kurtɑriʤi	kurtɑrɯʤɯ
kutuplH	kutupli	kutuplu
myrɑʤɑɑtlArH	myrɑʤɑɑtlɑri	myrɑʤɑɑtlɑrɯ
mevzuɑtDA	mevzuɑtdɑ	mevzuɑttɑ
onurH	onuri	onuru
performɑnsHn	performɑnsin	performɑnsɯn
sɯnɯrHn	sɯnɯrin	sɯnɯrɯn
sɑlonHn	sɑlonin	sɑlonun
sezonH	sezoni	sezonu
tɑbɑnHHn	tɑbɑniin	tɑbɑnɯɯn
tɑblolArHn	tɑblolɑrin	tɑblolɑrɯn
toplumlArH	toplumlɑri	toplumlɑrɯ
ujkusHzlHk	ujkusizlik	ujkusuzluk
jɑʃlHlArHn	jɑʃlilɑrin	jɑʃlɯlɑrɯn
jɑpɯtlArH	jɑpɯtlɑri	jɑpɯtlɑrɯ
jɑrɯHn	jɑrɯin	jɑrɯɯn
jɑzɯHHn	jɑzɯiin	jɑzɯɯɯn
zejtinjɑɰɯHn	zejtinjɑɰɯin	zejtinjɑɰɯɯn
ɑdɑmHHn	ɑdɑmiin	ɑdɑmɯɯn
ɑrkɑdɑʃlArmHn	ɑrkɑdɑʃlɑrmin	ɑrkɑdɑʃlɑrmɯn
bɑʃkɑnlHklArH	bɑʃkɑnliklɑri	bɑʃkɑnlɯklɑrɯ
dɑvrɑnHʃHn	dɑvrɑniʃin	dɑvrɑnɯʃɯn
durHʃ	duriʃ	duruʃ
fɑrklɯlHklArHn	fɑrklɯliklɑrin	fɑrklɯlɯklɑrɯn
fɑturɑlArHn	fɑturɑlɑrin	fɑturɑlɑrɯn
fɑzlH	fɑzli	fɑzlɯ
firmɑmHzHn	firmɑmizin	firmɑmɯzɯn
formlArHn	formlɑrin	formlɑrɯn
hoʤɑmHz	hoʤɑmiz	hoʤɑmɯz
imzɑlAnmAH	imzɑlɑnmɑi	imzɑlɑnmɑɯ
kɑjɑlHk	kɑjɑlik	kɑjɑlɯk
komʃulHk	komʃulik	komʃuluk
mɑterjɑllArHn	mɑterjɑllɑrin	mɑterjɑllerin
mekɑnizmɑHHn	mekɑnizmɑiin	mekɑnizmɑɯɯn
pɑrɑlH	pɑrɑli	pɑrɑlɯ
pompɑH	pompɑi	pompɑɯ
ryzgɑrlArH	ryzgɑrlɑri	ryzgɑrlɑrɯ
sɑtHʃlArDA	sɑtiʃlɑrdɑ	sɑtɯʃlɑrdɑ
sokɑkDAki	sokɑkdɑki	sokɑktɑki
sunmADA	sunmɑdɑ	sunmɑtɑ
tɑnrɯHn	tɑnrɯin	tɑnrɯɯn
tutumlArH	tutumlɑri	tutumlɑrɯ
uʧDAn	uʧdɑn	uʧtɑn
jyzHn	jyzin	jyzyn
jɑʃɑmnHzDA	jɑʃɑmnizdɑ	jɑʃɑmnɯzdɑ
jɑrɯʃmɑH	jɑrɯʃmɑi	jɑrɯʃmɑɯ
ʧɑmurHn	ʧɑmurin	ʧɑmurun
ʧoɰumHz	ʧoɰumiz	ʧoɰumuz
ɯlɯmlH	ɯlɯmli	ɯlɯmlɯ
ʃɑblonH	ʃɑbloni	ʃɑblonu
ʃirketDAn	ʃirketden	ʃirketten
ɑɰHn	ɑɰin	ɑɰɯn
ɑʤentɑH	ɑʤentɑi	ɑʤentɑɯ
ɑrtɯklArH	ɑrtɯklɑri	ɑrtɯklɑrɯ
bɑkɯmlH	bɑkɯmli	bɑkɯmlɯ
bulunmAH	bulunmɑi	bulunmɑɯ
dykkɑnH	dykkɑni	dykkɑnɯ
duvɑrHn	duvɑrin	duvɑrɯn
fɑturɑlH	fɑturɑli	fɑturɑlɯ
fonksijonHn	fonksijonin	fonksijonun
gɑjrimenkullArHn	gɑjrimenkullɑrin	gɑjrimenkullerin
hɑlklArHn	hɑlklɑrin	hɑlklɑrɯn
hɑstɑnelArA	hɑstɑnelerɑ	hɑstɑnelere
imzɑlArH	imzɑlɑri	imzɑlɑrɯ
kyltyrlH	kyltyrli	kyltyrly
kɑzɑlArHHn	kɑzɑlɑriin	kɑzɑlɑrɯɯn
koleksijonH	koleksijoni	koleksijonu
konferɑnslArH	konferɑnslɑri	konferɑnslɑrɯ
lɑmbɑH	lɑmbɑi	lɑmbɑɯ
levhɑH	levhɑi	levhɑɯ
mɑkbuzHn	mɑkbuzin	mɑkbuzun
mirɑsH	mirɑsi	mirɑsɯ
okuDHkDAn	okudikdɑn	okuduktɑn
olumsuzlHklArH	olumsuzliklɑri	olumsuzluklɑrɯ
ortɑokulH	ortɑokuli	ortɑokulu
sɑjfɑlArHHn	sɑjfɑlɑriin	sɑjfɑlɑrɯɯn
sosH	sosi	sosu
suʧDAn	suʧdɑn	suʧtɑn
tɑʃɯDHklArH	tɑʃɯdiklɑri	tɑʃɯdɯklɑrɯ
tɑkHp	tɑkip	tɑkɯp
tɑsɑrɯHHn	tɑsɑrɯiin	tɑsɑrɯɯɯn
temɑsDA	temɑsdɑ	temɑstɑ
tohumlHk	tohumlik	tohumluk
ujɑrɯlArH	ujɑrɯlɑri	ujɑrɯlɑrɯ
jyksekokullArH	jyksekokullɑri	jyksekokullɑrɯ
jɑnlArH	jɑnlɑri	jɑnlɑrɯ
ølʧylH	ølʧyli	ølʧyly
ʃɑʃkɯnlHk	ʃɑʃkɯnlik	ʃɑʃkɯnlɯk
ʃuurH	ʃuuri	ʃuuru
yrynHHn	yryniin	yrynyyn
ɑlɯʤɯH	ɑlɯʤɯi	ɑlɯʤɯɯ
ɑlɯmlArH	ɑlɯmlɑri	ɑlɯmlɑrɯ
ɑlɑnlH	ɑlɑnli	ɑlɑnlɯ
ɑtlH	ɑtli	ɑtlɯ
ɑjɑkDAn	ɑjɑkdɑn	ɑjɑktɑn
bɑʃvuruHHn	bɑʃvuruiin	bɑʃvuruuun
bulAbilmA	bulebilme	bulɑbilme
fɑjHn	fɑjin	fɑjɯn
hɑjɑtmHzA	hɑjɑtmize	hɑjɑtmɯzɑ
hususHn	hususin	hususun
huzursHz	huzursiz	huzursuz
ilɑnlArH	ilɑnlɑri	ilɑnlɑrɯ
kɑjmAH	kɑjmɑi	kɑjmɑɯ
kɑzɑlArHn	kɑzɑlɑrin	kɑzɑlɑrɯn
kokulArH	kokulɑri	kokulɑrɯ
kontrolsHz	kontrolsiz	kontrolsyz
lɑmbɑlArH	lɑmbɑlɑri	lɑmbɑlɑrɯ
pɑhɑlHA	pɑhɑliɑ	pɑhɑlɯɑ
pɑrɑlArHn	pɑrɑlɑrin	pɑrɑlɑrɯn
seʧDHklArH	seʧdikleri	seʧtikleri
sokɑklArH	sokɑklɑri	sokɑklɑrɯ
solunumH	solunumi	solunumu
teʧhizɑtHn	teʧhizɑtin	teʧhizɑtɯn
tutɑrHn	tutɑrin	tutɑrɯn
unlH	unli	unlu
ujduH	ujdui	ujduu
vyʤutDAn	vyʤutdɑn	vyʤuttɑn
jɑʃHHn	jɑʃiin	jɑʃɯɯn
jurttɑʃlArHn	jurttɑʃlɑrin	jurttɑʃlɑrɯn
zorlHklArA	zorliklɑrɑ	zorluklɑrɑ
ɑʃmAH	ɑʃmɑi	ɑʃmɑɯ
ɑlmAlH	ɑlmɑli	ɑlmɑlɯ
ɑrmɑɰɑnH	ɑrmɑɰɑni	ɑrmɑɰɑnɯ
bɑɰɯʃH	bɑɰɯʃi	bɑɰɯʃɯ
borulArH	borulɑri	borulɑrɯ
ʤezɑlArHHn	ʤezɑlɑriin	ʤezɑlɑrɯɯn
ʤiltDA	ʤiltde	ʤiltte
devɑmsHzlHk	devɑmsizlik	devɑmsɯzlɯk
dezɑvɑntɑʒlArH	dezɑvɑntɑʒlɑri	dezɑvɑntɑʒlɑrɯ
dujguH	dujgui	dujguu
enʒeksijonH	enʒeksijoni	enʒeksijonu
firmɑH	firmɑi	firmɑɯ
hɑkDAn	hɑkdɑn	hɑktɑn
hɑlklArH	hɑlklɑri	hɑlklɑrɯ
hɑrikɑH	hɑrikɑi	hɑrikɑɯ
hɑritɑlArHn	hɑritɑlɑrin	hɑritɑlɑrɯn
hɑjɑtnHzH	hɑjɑtnizi	hɑjɑtnɯzɯ
hesɑpDA	hesɑpdɑ	hesɑptɑ
istihdɑmHn	istihdɑmin	istihdɑmɯn
kɑlɑnlArHn	kɑlɑnlɑrin	kɑlɑnlɑrɯn
kɑnɯtlAmHʃ	kɑnɯtlɑmiʃ	kɑnɯtlɑmɯʃ
kɑtɯlmAH	kɑtɯlmɑi	kɑtɯlmɑɯ
kɑtliɑmH	kɑtliɑmi	kɑtliɑmɯ
kɑvuʃmAH	kɑvuʃmɑi	kɑvuʃmɑɯ
konuʃHp	konuʃip	konuʃup
kutuHHn	kutuiin	kutuuun
lezjonlArH	lezjonleri	lezjonlɑrɯ
nɑmɑzH	nɑmɑzi	nɑmɑzɯ
pɑnolArH	pɑnolɑri	pɑnolɑrɯ
reklɑmH	reklɑmi	reklɑmɯ
sɯrtH	sɯrti	sɯrtɯ
sɑtɯʤɯH	sɑtɯʤɯi	sɑtɯʤɯɯ
tɑnsijonH	tɑnsijoni	tɑnsijonu
telefonlArA	telefonlere	telefonlɑrɑ
uluslArHn	uluslerin	uluslɑrɯn
uzmɑnHHn	uzmɑniin	uzmɑnɯɯn
vɑkɑlArHHn	vɑkɑlɑriin	vɑkɑlɑrɯɯn
vɑtɑndɑʃlArmHzA	vɑtɑndɑʃlɑrmize	vɑtɑndɑʃlɑrmɯzɑ
jɑʃlHlArDA	jɑʃlilɑrdɑ	jɑʃlɯlɑrdɑ
ʧelikDAn	ʧelikden	ʧelikten
ølʧytH	ølʧyti	ølʧyty
ɑrɯzɑlH	ɑrɯzɑli	ɑrɯzɑlɯ
ɑrɑmHzDAn	ɑrɑmizden	ɑrɑmɯzdɑn
bɑɰlAnHp	bɑɰlɑnip	bɑɰlɑnɯp
bɑkɯmlArH	bɑkɯmlɑri	bɑkɯmlɑrɯ
bɑskɯHn	bɑskɯin	bɑskɯɯn
dønyʃymlH	dønyʃymli	dønyʃymly
dɑɰlArHHn	dɑɰlɑriin	dɑɰlɑrɯɯn
depolAr	depoler	depolɑr
doɰumH	doɰumi	doɰumu
hɑlkɑH	hɑlkɑi	hɑlkɑɯ
hɑmurH	hɑmuri	hɑmuru
ibrɑzH	ibrɑzi	ibrɑzɯ
isjɑnH	isjɑni	isjɑnɯ
kɯsɯtlAHʤH	kɯsɯtlɑiʤi	kɯsɯtlɑɯʤɯ
kømyrHn	kømyrin	kømyryn
kɑblolArH	kɑblolɑri	kɑblolɑrɯ
kɑlHnʤA	kɑlinʤɑ	kɑlɯnʤɑ
kɑlmAHn	kɑlmɑin	kɑlmɑɯn
kɑtDAn	kɑtdɑn	kɑttɑn
kɑjɯplArHn	kɑjɯplɑrin	kɑjɯplɑrɯn
kulɑkDAn	kulɑkdɑn	kulɑktɑn
kurɑmlArH	kurɑmlɑri	kurɑmlɑrɯ
mɑkɑmH	mɑkɑmi	mɑkɑmɯ
mutlulHklAr	mutluliklɑr	mutluluklɑr
odɑH	odɑi	odɑɯ
olmAnHzH	olmɑnizi	olmɑnɯzɯ
pilotH	piloti	pilotu
ryjɑH	ryjɑi	ryjɑɯ
sytHHn	sytiin	sytyyn
sɑldɯrɯH	sɑldɯrɯi	sɑldɯrɯɯ
sɑvʤɯHn	sɑvʤɯin	sɑvʤɯɯn
stɑtyDA	stɑtydɑ	stɑtyde
tɑmsɑjɯHHn	tɑmsɑjɯiin	tɑmsɑjɯɯɯn
tɑzminɑtHn	tɑzminɑtin	tɑzminɑtɯn
jyryHʃA	jyryiʃe	jyryyʃe
jɑjɯlHʃH	jɑjɯliʃi	jɑjɯlɯʃɯ
ɑrɑmHzA	ɑrɑmize	ɑrɑmɯzɑ
ɑsistɑnlHk	ɑsistɑnlik	ɑsistɑnlɯk
ɑjɑrlAnmAH	ɑjɑrlɑnmɑi	ɑjɑrlɑnmɑɯ
byjylH	byjyli	byjyly
bɑʃvurDHklArH	bɑʃvurdiklɑri	bɑʃvurduklɑrɯ
bɑʃvurmAnHz	bɑʃvurmɑniz	bɑʃvurmɑnɯz
dønymlHk	dønymlik	dønymlyk
dynjɑmHzDA	dynjɑmizde	dynjɑmɯzdɑ
etrɑfDA	etrɑfdɑ	etrɑftɑ
evrɑklArH	evrɑklɑri	evrɑklɑrɯ
fɑzH	fɑzi	fɑzɯ
fonksijonHHn	fonksijoniin	fonksijonuun
gøryʃlH	gøryʃli	gøryʃly
gɑzlH	gɑzli	gɑzlɯ
hɑnɯmH	hɑnɯmi	hɑnɯmɯ
hɑjvɑnH	hɑjvɑni	hɑjvɑnɯ
køjlyHn	køjlyin	køjlyyn
kɑbuklH	kɑbukli	kɑbuklu
kɑlkɯnmAH	kɑlkɯnmɑi	kɑlkɯnmɑɯ
kɑsH	kɑsi	kɑsɯ
kɑtɯlɯmlH	kɑtɯlɯmli	kɑtɯlɯmlɯ
kolHHn	koliin	koluun
kumɑʃDAn	kumɑʃdɑn	kumɑʃtɑn
mɑllArHHn	mɑllɑriin	mɑllɑrɯɯn
mɑnɑsH	mɑnɑsi	mɑnɑsɯ
oʤɑkDAn	oʤɑkdɑn	oʤɑktɑn
olguHHn	olguiin	olguuun
pɑjlɑʃmAH	pɑjlɑʃmɑi	pɑjlɑʃmɑɯ
profesørH	profesøri	profesøry
romɑnHn	romɑnin	romɑnɯn
sɯrɑlAmAH	sɯrɑlɑmɑi	sɯrɑlɑmɑɯ
sɑvɑʃlArHn	sɑvɑʃlɑrin	sɑvɑʃlɑrɯn
ujgulɑDHklArH	ujgulɑdiklɑri	ujgulɑdɯklɑrɯ
uzmɑnHn	uzmɑnin	uzmɑnɯn
jɑlnɯzlHk	jɑlnɯzlik	jɑlnɯzlɯk
jɑjɯmlAnmAH	jɑjɯmlɑnmɑi	jɑjɯmlɑnmɑɯ
jɑjlH	jɑjli	jɑjlɯ
jɑzDHklArH	jɑzdiklɑri	jɑzdɯklɑrɯ
jerjyzyHn	jerjyzyin	jerjyzyyn
ʧɑɰmHzHn	ʧɑɰmizin	ʧɑɰmɯzɯn
ɑdɑjlHk	ɑdɑjlik	ɑdɑjlɯk
ɑkɑlHn	ɑkɑlin	ɑkɑlɯn
ɑlkolHn	ɑlkolin	ɑlkolyn
ɑnɑH	ɑnɑi	ɑnɑɯ
bɑkɑnmHz	bɑkɑnmiz	bɑkɑnmɯz
boʃɑlmAH	boʃɑlmɑi	boʃɑlmɑɯ
burslArH	bursleri	burslɑrɯ
dyʃHp	dyʃip	dyʃyp
dynjɑmHzHn	dynjɑmizin	dynjɑmɯzɯn
doɰurgɑnlHk	doɰurgɑnlik	doɰurgɑnlɯk
dolɑʃHp	dolɑʃip	dolɑʃɯp
duvɑrHHn	duvɑriin	duvɑrɯɯn
formylA	formylɑ	formyle
hɑrʧlArH	hɑrʧlɑri	hɑrʧlɑrɯ
imɑlɑtʧH	imɑlɑtʧi	imɑlɑtʧɯ
kɯsɯmlArHHn	kɯsɯmlɑriin	kɯsɯmlɑrɯɯn
kɑʧnʤH	kɑʧnʤi	kɑʧnʤɯ
kɑsɑbɑH	kɑsɑbɑi	kɑsɑbɑɯ
kɑjɯplArHHn	kɑjɯplɑriin	kɑjɯplɑrɯɯn
konumlArH	konumlɑri	konumlɑrɯ
kullAnHʤHH	kullɑniʤii	kullɑnɯʤɯɯ
kurlArH	kurlɑri	kurlɑrɯ
numɑrɑlArHHn	numɑrɑlɑriin	numɑrɑlɑrɯɯn
orɑnlH	orɑnli	orɑnlɯ
orduH	ordui	orduu
pɑʃɑHn	pɑʃɑin	pɑʃɑɯn
pɑjlArHHn	pɑjlɑriin	pɑjlɑrɯɯn
performɑnslArH	performɑnslɑri	performɑnslɑrɯ
sɑntrɑllArH	sɑntrɑllɑri	sɑntrɑllɑrɯ
semptomlArHn	semptomlɑrin	semptomlɑrɯn
servisDAn	servisden	servisten
soluklH	solukli	soluklu
tɑʃɯmADA	tɑʃɯmɑdɑ	tɑʃɯmɑtɑ
televizjonlAr	televizjonler	televizjonlɑr
vɑkɑlArH	vɑkɑlɑri	vɑkɑlɑrɯ
jɑʃɑHp	jɑʃɑip	jɑʃɑɯp
jɑkɯnmAH	jɑkɯnmɑi	jɑkɯnmɑɯ
jorumlArH	jorumlɑri	jorumlɑrɯ
ʧɑlɯʃAlHm	ʧɑlɯʃɑlim	ʧɑlɯʃɑlɯm
ɑʧHʃ	ɑʧiʃ	ɑʧɯʃ
ɑdɯmlArHn	ɑdɯmlɑrin	ɑdɯmlɑrɯn
ɑlɑkɑH	ɑlɑkɑi	ɑlɑkɑɯ
ɑnlɑmADA	ɑnlɑmɑdɑ	ɑnlɑmɑtɑ
ɑnlɑjɯʃlArH	ɑnlɑjɯʃlɑri	ɑnlɑjɯʃlɑrɯ
bɑslAArAk	bɑsleerek	bɑslɑɑrɑk
bebekDA	bebekde	bebekte
blokDA	blokdɑ	bloktɑ
bojutHHn	bojutiin	bojutuun
bulDHklArH	buldikleri	bulduklɑrɯ
døkymɑnlArH	døkymɑnlɑri	døkymɑnlɑrɯ
dɑvɑHHn	dɑvɑiin	dɑvɑɯɯn
fonksijonlH	fonksijonli	fonksijonlu
hususDAki	hususdɑki	husustɑki
iʧermADA	iʧermede	iʧermete
kɯsɯtlAmAH	kɯsɯtlɑmɑi	kɯsɯtlɑmɑɯ
køtyH	køtyi	køtyy
konforH	konfori	konforu
kutuHn	kutuin	kutuun
mevduɑtH	mevduɑti	mevduɑtɯ
orɑH	orɑi	orɑɯ
reformlArH	reformlɑri	reformlɑrɯ
sytunH	sytuni	sytunu
sɑɰlAHʤHH	sɑɰlɑiʤii	sɑɰlɑɯʤɯɯ
sɑntrɑllArHn	sɑntrɑllɑrin	sɑntrɑllɑrɯn
sɑtɯʤɯlArH	sɑtɯʤɯlɑri	sɑtɯʤɯlɑrɯ
sonuʧlAnmAH	sonuʧlɑnmɑi	sonuʧlɑnmɑɯ
soruʃturmAH	soruʃturmɑi	soruʃturmɑɯ
sunmAH	sunmɑi	sunmɑɯ
typHn	typin	typyn
tɑmɑmlAHp	tɑmɑmlɑip	tɑmɑmlɑɯp
tɑrtɯʃmAsHz	tɑrtɯʃmɑsiz	tɑrtɯʃmɑsɯz
topʧHlAr	topʧilɑr	topʧulɑr
toplɑmlArH	toplɑmlɑri	toplɑmlɑrɯ
ulɑʃHp	ulɑʃip	ulɑʃɯp
ulusHHn	ulusiin	ulusuun
vɑsɯtɑlArH	vɑsɯtɑlɑri	vɑsɯtɑlɑrɯ
jønHHn	jøniin	jønyyn
jɑɰmurlH	jɑɰmurli	jɑɰmurlu
jɑkɑH	jɑkɑi	jɑkɑɯ
joɰunlHklH	joɰunlikli	joɰunluklu
jolʤulArHn	jolʤulɑrin	jolʤulɑrɯn
ʧoʤuklArnHzHn	ʧoʤuklɑrnizin	ʧoʤuklɑrnɯzɯn
ʧoʤuklH	ʧoʤukli	ʧoʤuklu
ʃiddetDA	ʃiddetde	ʃiddette
ɑlgoritmɑlArH	ɑlgoritmɑlɑri	ɑlgoritmɑlɑrɯ
ɑrɑʧDAn	ɑrɑʧdɑn	ɑrɑʧtɑn
ɑrɑmɑlArH	ɑrɑmɑlɑri	ɑrɑmɑlɑrɯ
bojutDAki	bojutdɑki	bojuttɑki
buhɑrlH	buhɑrli	buhɑrlɯ
dynjɑmHz	dynjɑmiz	dynjɑmɯz
dɑvrɑnHʃDA	dɑvrɑniʃdɑ	dɑvrɑnɯʃtɑ
dujguHHn	dujguiin	dujguuun
fɑbrikɑHHn	fɑbrikɑiin	fɑbrikɑɯɯn
gøryʃHHn	gøryʃiin	gøryʃyyn
gɑjrimenkulHn	gɑjrimenkulin	gɑjrimenkulyn
hɑjɑtDAki	hɑjɑtdɑki	hɑjɑttɑki
insɑnlArmHz	insɑnlɑrmiz	insɑnlɑrmɯz
kɑlmAlArH	kɑlmɑlɑri	kɑlmɑlɑrɯ
kɑtmɑnlH	kɑtmɑnli	kɑtmɑnlɯ
kollH	kolli	kollu
kotH	koti	kotu
kutuH	kutui	kutuu
okuHʤHnHn	okuiʤinin	okuuʤunun
olgulArH	olgulɑri	olgulɑrɯ
rɑhɑtsHzlHklAr	rɑhɑtsizlikler	rɑhɑtsɯzlɯklɑr
reformlArHn	reformlɑrin	reformlɑrɯn
sɑjgɯH	sɑjgɯi	sɑjgɯɯ
soɰukDAn	soɰukdɑn	soɰuktɑn
turlArH	turlɑri	turlɑrɯ
ujkusHz	ujkusiz	ujkusuz
ujumHn	ujumin	ujumun
uzɑntɯlH	uzɑntɯli	uzɑntɯlɯ
uzɑtɯmH	uzɑtɯmi	uzɑtɯmɯ
jɯɰɯnH	jɯɰɯni	jɯɰɯnɯ
jyksekDA	jyksekde	jyksekte
jɑʃɑmlArHHn	jɑʃɑmlɑriin	jɑʃɑmlɑrɯɯn
jɑrɯʃHn	jɑrɯʃin	jɑrɯʃɯn
jumurtɑHn	jumurtɑin	jumurtɑɯn
ʧɑtɯʃmAH	ʧɑtɯʃmɑi	ʧɑtɯʃmɑɯ
ɑʧɯlɯʃDA	ɑʧɯlɯʃdɑ	ɑʧɯlɯʃtɑ
ɑbonelArA	ɑbonelerɑ	ɑbonelere
ɑʤentɑlArH	ɑʤentɑlɑri	ɑʤentɑlɑrɯ
ɑrɑʃtɯrmɑʤɯlArHn	ɑrɑʃtɯrmɑʤɯlɑrin	ɑrɑʃtɯrmɑʤɯlɑrɯn
ɑrɑHʃlArH	ɑrɑiʃlɑri	ɑrɑɯʃlɑrɯ
ɑrɑzilArHn	ɑrɑzilɑrin	ɑrɑzilerin
ɑjnɯH	ɑjnɯi	ɑjnɯɯ
ɑzotlH	ɑzotli	ɑzotlu
døngyH	døngyi	døngyy
dɑvrɑnHʃlArA	dɑvrɑniʃlɑrɑ	dɑvrɑnɯʃlɑrɑ
dekontH	dekonti	dekontu
dostlHklAr	dostlikler	dostluklɑr
ekipmɑnlArHn	ekipmɑnlɑrin	ekipmɑnlɑrɯn
elemɑnHHn	elemɑniin	elemɑnɯɯn
hykymetDA	hykymetde	hykymette
hɑreketDA	hɑreketde	hɑrekette
hɑvuzHn	hɑvuzin	hɑvuzun
hɑjɑtnHzDA	hɑjɑtnizdɑ	hɑjɑtnɯzdɑ
hesɑpDAn	hesɑpdɑn	hesɑptɑn
hormonH	hormoni	hormonu
hujlH	hujli	hujlu
kɑtkɯHHn	kɑtkɯiin	kɑtkɯɯɯn
korumɑlH	korumɑli	korumɑlɯ
kumɑndɑlH	kumɑndɑli	kumɑndɑlɯ
mɑɑʃH	mɑɑʃi	mɑɑʃɯ
miktɑrlArHHn	miktɑrlɑriin	miktɑrlɑrɯɯn
minerɑllArHn	minerɑllɑrin	minerɑllerin
olAʤAklArH	olɑʤɑklɑri	olɑʤɑklɑrɯ
politikɑmHz	politikɑmiz	politikɑmɯz
rizikoHn	rizikoin	rizikoun
sɑntrɑllAr	sɑntrɑllɑr	sɑntrɑller
suʧlHlHk	suʧlilik	suʧluluk
tɑʃɯmAlArH	tɑʃɯmɑlɑri	tɑʃɯmɑlɑrɯ
tɑkɯlHp	tɑkɯlip	tɑkɯlɯp
tɑksitDA	tɑksitde	tɑksitte
teklifDA	teklifde	teklifte
tohumH	tohumi	tohumu
trɑfikDA	trɑfikde	trɑfikte
umutsHz	umutsiz	umutsuz
jɑnlɯʃH	jɑnlɯʃi	jɑnlɯʃɯ
ʧubuklArH	ʧubuklɑri	ʧubuklɑrɯ
ɑɰɯrlɯkDA	ɑɰɯrlɯkdɑ	ɑɰɯrlɯktɑ
ɑrkɑdɑʃHHn	ɑrkɑdɑʃiin	ɑrkɑdɑʃɯɯn
ɑjrɯntɯH	ɑjrɯntɯi	ɑjrɯntɯɯ
bɯrɑkmAH	bɯrɑkmɑi	bɯrɑkmɑɯ
bɑʃbɑkɑnHn	bɑʃbɑkɑnin	bɑʃbɑkɑnɯn
bɑʃlɑDHklArH	bɑʃlɑdiklɑri	bɑʃlɑdɯklɑrɯ
bɑʃlArH	bɑʃlɑri	bɑʃlɑrɯ
bɑhɑdɯrlH	bɑhɑdɯrli	bɑhɑdɯrlɯ
bulDHkʧA	buldikʧɑ	buldukʧɑ
ʤɑnlɯHn	ʤɑnlɯin	ʤɑnlɯɯn
destekDAn	destekden	destekten
ekipmɑnH	ekipmɑni	ekipmɑnɯ
fijɑtHn	fijɑtin	fijɑtɯn
fotoɰrɑflH	fotoɰrɑfli	fotoɰrɑflɯ
gøryʃDA	gøryʃde	gøryʃte
hesɑplH	hesɑpli	hesɑplɯ
inʃɑɑtHn	inʃɑɑtin	inʃɑɑtɯn
izolɑsjonH	izolɑsjoni	izolɑsjonu
kɯʃH	kɯʃi	kɯʃɯ
kɑrɑrsHz	kɑrɑrsiz	kɑrɑrsɯz
kontrolDAn	kontroldɑn	kontrolden
konutlArH	konutlɑri	konutlɑrɯ
konutH	konuti	konutu
kullAnHʤHHHn	kullɑniʤiiin	kullɑnɯʤɯɯɯn
mɑɰɑzɑlArH	mɑɰɑzɑlɑri	mɑɰɑzɑlɑrɯ
meslektɑʃmHz	meslektɑʃmiz	meslektɑʃmɯz
notlArHn	notlɑrin	notlɑrɯn
okʧHlHk	okʧilik	okʧuluk
oluʃumlArH	oluʃumlɑri	oluʃumlɑrɯ
pɑrmɑklArH	pɑrmɑklɑri	pɑrmɑklɑrɯ
pɑzɑrlArH	pɑzɑrlɑri	pɑzɑrlɑrɯ
progrɑmmHz	progrɑmmiz	progrɑmmɯz
restorɑsjonH	restorɑsjoni	restorɑsjonu
ruhsɑtlArH	ruhsɑtlɑri	ruhsɑtlɑrɯ
sɯnɯfDAki	sɯnɯfdɑki	sɯnɯftɑki
sɑɰlɑmlHk	sɑɰlɑmlik	sɑɰlɑmlɯk
sɑjfɑmHzDAn	sɑjfɑmizden	sɑjfɑmɯzdɑn
sojkɯrɯmH	sojkɯrɯmi	sojkɯrɯmɯ
sponsorH	sponsori	sponsoru
sunDHklArH	sundiklɑri	sunduklɑrɯ
tyrkyH	tyrkyi	tyrkyy
tɑbiɑtHn	tɑbiɑtin	tɑbiɑtɯn
televizjonHn	televizjonin	televizjonun
torbɑH	torbɑi	torbɑɯ
trɑvmɑH	trɑvmɑi	trɑvmɑɯ
tutɑrlHlHk	tutɑrlilik	tutɑrlɯlɯk
ujɑrɯH	ujɑrɯi	ujɑrɯɯ
jɑkɯtlArHn	jɑkɯtlɑrin	jɑkɯtlɑrɯn
zijɑretDAn	zijɑretden	zijɑretten
ɯʃɯnlArHHn	ɯʃɯnlɑriin	ɯʃɯnlɑrɯɯn
ɯrkʧH	ɯrkʧi	ɯrkʧɯ
ɑʤɯH	ɑʤɯi	ɑʤɯɯ
ɑksɑklHklAr	ɑksɑkliklɑr	ɑksɑklɯklɑr
ɑnɑhtɑrlAmAlH	ɑnɑhtɑrlɑmɑli	ɑnɑhtɑrlɑmɑlɯ
ɑnlɑʃmɑHHn	ɑnlɑʃmɑiin	ɑnlɑʃmɑɯɯn
ɑrɑmAH	ɑrɑmɑi	ɑrɑmɑɯ
ɑrɑHʃ	ɑrɑiʃ	ɑrɑɯʃ
ɑtɯfDA	ɑtɯfdɑ	ɑtɯftɑ
bɑʃlɑngɯʧDAki	bɑʃlɑngɯʧdɑki	bɑʃlɑngɯʧtɑki
bɑskɯnH	bɑskɯni	bɑskɯnɯ
bellekDA	bellekde	bellekte
bilɑnʧoH	bilɑnʧoi	bilɑnʧou
boʃlukDA	boʃlukdɑ	boʃluktɑ
broʃyrlAr	broʃyrlɑr	broʃyrler
derinlHkDA	derinlikde	derinlikte
eʃjɑH	eʃjɑi	eʃjɑɯ
fɑturɑH	fɑturɑi	fɑturɑɯ
gydymlH	gydymli	gydymly
hɑnɯmHn	hɑnɯmin	hɑnɯmɯn
kɑdromHz	kɑdromiz	kɑdromuz
koʤɑHHn	koʤɑiin	koʤɑɯɯn
kolHn	kolin	kolun
lyzumH	lyzumi	lyzumu
lisɑnsnH	lisɑnsni	lisɑnsnɯ
mysɑbɑkɑlArH	mysɑbɑkɑlɑri	mysɑbɑkɑlɑrɯ
mɑʧDA	mɑʧdɑ	mɑʧtɑ
mɑkinɑHHn	mɑkinɑiin	mɑkinɑɯɯn
mekɑnizmɑlArHHn	mekɑnizmɑlɑriin	mekɑnizmɑlɑrɯɯn
numɑrɑnHz	numɑrɑniz	numɑrɑnɯz
odunHn	odunin	odunun
ortɑklɯklArH	ortɑklɯklɑri	ortɑklɯklɑrɯ
ortɑmlArHHn	ortɑmlɑriin	ortɑmlɑrɯɯn
plɑnlAmAnHn	plɑnlɑmɑnin	plɑnlɑmɑnɯn
slogɑnlArH	slogɑnlɑri	slogɑnlɑrɯ
ufɑklH	ufɑkli	ufɑklɯ
ustɑHn	ustɑin	ustɑɯn
ujgunsHz	ujgunsiz	ujgunsuz
uzɑjH	uzɑji	uzɑjɯ
vizjonmHz	vizjonmiz	vizjonmuz
jɑɰsHz	jɑɰsiz	jɑɰsɯz
jɑnlɯʃlArH	jɑnlɯʃlɑri	jɑnlɯʃlɑrɯ
jɑtɑklHk	jɑtɑklik	jɑtɑklɯk
jɑtɑklArHHn	jɑtɑklɑriin	jɑtɑklɑrɯɯn
jurttɑʃlHk	jurttɑʃlik	jurttɑʃlɯk
zɑmɑnmHzDA	zɑmɑnmizde	zɑmɑnmɯzdɑ
ʧɯkɑrlArHHn	ʧɯkɑrlɑriin	ʧɯkɑrlɑrɯɯn
ʧɑdɯrHn	ʧɑdɯrin	ʧɑdɯrɯn
ɯsɯHn	ɯsɯin	ɯsɯɯn
ʃɑnsnHz	ʃɑnsniz	ʃɑnsnɯz
ɑɰlArHn	ɑɰlɑrin	ɑɰlɑrɯn
ɑsfɑltH	ɑsfɑlti	ɑsfɑltɯ
bɯrɑkAlHm	bɯrɑkɑlim	bɯrɑkɑlɯm
bɑbɑlArH	bɑbɑlɑri	bɑbɑlɑrɯ
bɑkɯmsHz	bɑkɯmsiz	bɑkɯmsɯz
bɑtɯlHlAʃmA	bɑtɯlilɑʃmɑ	bɑtɯlɯlɑʃmɑ
bombɑH	bombɑi	bombɑɯ
burɑlArH	burɑlɑri	burɑlɑrɯ
ʤɑnlHlArH	ʤɑnlilɑri	ʤɑnlɯlɑrɯ
enfeksijonlArA	enfeksijonlere	enfeksijonlɑrɑ
fɑrkHHn	fɑrkiin	fɑrkɯɯn
gøkDAn	gøkden	gøkten
gømylH	gømyli	gømyly
gørynHʃDA	gøryniʃde	gørynyʃte
gururH	gururi	gururu
hɑrflArHn	hɑrflɑrin	hɑrflerin
hɑstɑlɯkDA	hɑstɑlɯkdɑ	hɑstɑlɯktɑ
hɑstɑlArmHzHn	hɑstɑlɑrmizin	hɑstɑlɑrmɯzɯn
hɑtDAn	hɑtdɑn	hɑttɑn
hɑjɑllAr	hɑjɑllɑr	hɑjɑller
hɑjɑtlArH	hɑjɑtlɑri	hɑjɑtlɑrɯ
hektɑrlHk	hektɑrlik	hektɑrlɯk
hoʃgørylH	hoʃgøryli	hoʃgøryly
hukukDA	hukukdɑ	hukuktɑ
køpryHn	køpryin	køpryyn
kɑʧHʃ	kɑʧiʃ	kɑʧɯʃ
kɑʧHp	kɑʧip	kɑʧɯp
kɑlDHkDAn	kɑldikdɑn	kɑldɯktɑn
kɑlkHʃ	kɑlkiʃ	kɑlkɯʃ
kɑpɑklH	kɑpɑkli	kɑpɑklɯ
kɑpDA	kɑpdɑ	kɑptɑ
kɑtHn	kɑtin	kɑtɯn
klɑsørH	klɑsøri	klɑsøry
komʃuH	komʃui	komʃuu
kompozisjonH	kompozisjoni	kompozisjonu
kojmAH	kojmɑi	kojmɑɯ
kuʃlArH	kuʃlɑri	kuʃlɑrɯ
kulɑklHk	kulɑklik	kulɑklɯk
kurulmHzHn	kurulmizin	kurulmuzun
lirɑH	lirɑi	lirɑɯ
mimɑrlArHn	mimɑrlɑrin	mimɑrlɑrɯn
orgɑnHHn	orgɑniin	orgɑnɯɯn
oturDHklArH	oturdiklɑri	oturduklɑrɯ
ruhHHn	ruhiin	ruhuun
sɑbɑhDAn	sɑbɑhdɑn	sɑbɑhtɑn
sokulmAH	sokulmɑi	sokulmɑɯ
sorulArHHn	sorulɑriin	sorulɑrɯɯn
tɑʃɯmAH	tɑʃɯmɑi	tɑʃɯmɑɯ
ulɑʃɯmHn	ulɑʃɯmin	ulɑʃɯmɯn
ustɑlHk	ustɑlik	ustɑlɯk
ujgulɑmADA	ujgulɑmɑdɑ	ujgulɑmɑtɑ
uzɑmAH	uzɑmɑi	uzɑmɑɯ
jɑʃɑmlArH	jɑʃɑmlɑri	jɑʃɑmlɑrɯ
jɑrɑtmAH	jɑrɑtmɑi	jɑrɑtmɑɯ
jɑrdɯmʤɯlArHHn	jɑrdɯmʤɯlɑriin	jɑrdɯmʤɯlɑrɯɯn
jɑrdɯmlArHn	jɑrdɯmlɑrin	jɑrdɯmlɑrɯn
jɑjɯnlArHHn	jɑjɯnlɑriin	jɑjɯnlɑrɯɯn
ʃɑnsmHz	ʃɑnsmiz	ʃɑnsmɯz
ɑnlɑHnʤA	ɑnlɑinʤɑ	ɑnlɑɯnʤɑ
ɑrkɑdɑʃlArmHzH	ɑrkɑdɑʃlɑrmizi	ɑrkɑdɑʃlɑrmɯzɯ
ɑtmAH	ɑtmɑi	ɑtmɑɯ
ʤumhurbɑʃkɑnɯmHz	ʤumhurbɑʃkɑnɯmiz	ʤumhurbɑʃkɑnɯmɯz
dekorɑsjonH	dekorɑsjoni	dekorɑsjonu
devɑmlHlHk	devɑmlilik	devɑmlɯlɯk
enstityHHn	enstityiin	enstityyyn
fijɑtlH	fijɑtli	fijɑtlɯ
formyllArH	formyllɑri	formylleri
gøkjyzyHn	gøkjyzyin	gøkjyzyyn
insɑnmHz	insɑnmiz	insɑnmɯz
kɑʧɑkʧHlHk	kɑʧɑkʧilik	kɑʧɑkʧɯlɯk
kɑbulA	kɑbulɑ	kɑbule
kɑvgɑH	kɑvgɑi	kɑvgɑɯ
kɑzɑnHp	kɑzɑnip	kɑzɑnɯp
kimjɑsAllArHn	kimjɑsɑllɑrin	kimjɑsɑllɑrɯn
klinikDA	klinikde	klinikte
krɑllHk	krɑllik	krɑllɯk
kumɑndɑnH	kumɑndɑni	kumɑndɑnɯ
kurmAH	kurmɑi	kurmɑɯ
kurtulHʃH	kurtuliʃi	kurtuluʃu
lisɑnsHn	lisɑnsin	lisɑnsɯn
mɑsrɑflArHn	mɑsrɑflɑrin	mɑsrɑflɑrɯn
mesɑʒnHzH	mesɑʒnizi	mesɑʒnɯzɯ
milɑtDAn	milɑtdɑn	milɑttɑn
okullArmHzDA	okullɑrmizde	okullɑrmɯzdɑ
oluklH	olukli	oluklu
operɑtørHn	operɑtørin	operɑtøryn
otH	oti	otu
refɑhH	refɑhi	refɑhɯ
sytunHn	sytunin	sytunun
sɑɰlɑHp	sɑɰlɑip	sɑɰlɑɯp
sertifikɑlArH	sertifikɑlɑri	sertifikɑlɑrɯ
soɰukDA	soɰukdɑ	soɰuktɑ
tɑnɯmAH	tɑnɯmɑi	tɑnɯmɑɯ
uʧɑklArHn	uʧɑklɑrin	uʧɑklɑrɯn
uʧsHz	uʧsiz	uʧsuz
versijonlArH	versijonleri	versijonlɑrɯ
jɑɰmurH	jɑɰmuri	jɑɰmuru
jɑklɑʃɯmlArHn	jɑklɑʃɯmlɑrin	jɑklɑʃɯmlɑrɯn
jɑklɑʃDHkʧA	jɑklɑʃdikʧɑ	jɑklɑʃtɯkʧɑ
jɑnnHzA	jɑnnize	jɑnnɯzɑ
jɑrɑtmAH	jɑrɑtmɑi	jɑrɑtmɑɯ
jɑrgɯsHz	jɑrgɯsiz	jɑrgɯsɯz
jɑzɯʤɯHn	jɑzɯʤɯin	jɑzɯʤɯɯn
jɑzDHkDAn	jɑzdikdɑn	jɑzdɯktɑn
zɯrhlH	zɯrhli	zɯrhlɯ
zekɑH	zekɑi	zekɑɯ
ʧɯkHʃDA	ʧɯkiʃdɑ	ʧɯkɯʃtɑ
ʧɑlɯʃɑnlArmHz	ʧɑlɯʃɑnlɑrmiz	ʧɑlɯʃɑnlɑrmɯz
ʧɑmurH	ʧɑmuri	ʧɑmuru
ʧɑtɯʃmAlArH	ʧɑtɯʃmɑlɑri	ʧɑtɯʃmɑlɑrɯ
yʧnʤHlHk	yʧnʤilik	yʧnʤylyk
ɑʤɯlH	ɑʤɯli	ɑʤɯlɯ
ɑmbɑlɑʒH	ɑmbɑlɑʒi	ɑmbɑlɑʒɯ
ɑmelijɑtlArH	ɑmelijɑtlɑri	ɑmelijɑtlɑrɯ
ɑnomɑlilArH	ɑnomɑlilɑri	ɑnomɑlileri
ɑtɑlHm	ɑtɑlim	ɑtɑlɯm
ɑvHn	ɑvin	ɑvɯn
ɑvʤɯlHk	ɑvʤɯlik	ɑvʤɯlɯk
ɑzɑlmADA	ɑzɑlmɑdɑ	ɑzɑlmɑtɑ
bɑkHʃlArH	bɑkiʃlɑri	bɑkɯʃlɑrɯ
blokH	bloki	bloku
bombɑHn	bombɑin	bombɑɯn
bonoH	bonoi	bonou
dɑɰHHn	dɑɰiin	dɑɰɯɯn
elbetDAki	elbetdeki	elbetteki
gørDHkʧA	gørdikʧe	gørdykʧe
gøzHHn	gøziin	gøzyyn
hykymlHHn	hykymliin	hykymlyyn
hɑvuzlArH	hɑvuzlɑri	hɑvuzlɑrɯ
hɑjɑtmHn	hɑjɑtmin	hɑjɑtmɯn
hɑjrɑnlHk	hɑjrɑnlik	hɑjrɑnlɯk
ihbɑrH	ihbɑri	ihbɑrɯ
istɑsjonHHn	istɑsjoniin	istɑsjonuun
køjlHlArH	køjlileri	køjlyleri
kɑbɯzlHk	kɑbɯzlik	kɑbɯzlɯk
kɑhvɑltɯH	kɑhvɑltɯi	kɑhvɑltɯɯ
kɑmerɑHn	kɑmerɑin	kɑmerɑɯn
kɑslArHHn	kɑsleriin	kɑslɑrɯɯn
klɑsørHn	klɑsørin	klɑsøryn
kuʃH	kuʃi	kuʃu
meslektɑʃlArmHzA	meslektɑʃlɑrmize	meslektɑʃlɑrmɯzɑ
normlArH	normlɑri	normlɑrɯ
okumAHn	okumɑin	okumɑɯn
pɑrʧɑlAnmAH	pɑrʧɑlɑnmɑi	pɑrʧɑlɑnmɑɯ
sɯzmA	sɯzme	sɯzmɑ
senɑrjolArH	senɑrjolɑri	senɑrjolɑrɯ
sunumlArH	sunumlɑri	sunumlɑrɯ
tɑʃɯnmɑzlArHn	tɑʃɯnmɑzlɑrin	tɑʃɯnmɑzlɑrɯn
tɑbiɑtH	tɑbiɑti	tɑbiɑtɯ
tɑbloHHn	tɑbloiin	tɑblouun
vɑsɯflArH	vɑsɯflɑri	vɑsɯflɑrɯ
jyryHʃlArH	jyryiʃleri	jyryyʃleri
jɑnlɯʃlHklAr	jɑnlɯʃliklɑr	jɑnlɯʃlɯklɑr
jɑrɑtDHklArH	jɑrɑtdiklɑri	jɑrɑttɯklɑrɯ
jɑzɑrlArHHn	jɑzɑrlɑriin	jɑzɑrlɑrɯɯn
ødylHn	ødylin	ødylyn
ʃykrɑnlArmH	ʃykrɑnlɑrmi	ʃykrɑnlɑrmɯ
ɑʧDHklArH	ɑʧdiklɑri	ɑʧtɯklɑrɯ
ɑdɑptørH	ɑdɑptøri	ɑdɑptøry
ɑrɑlɯkDA	ɑrɑlɯkdɑ	ɑrɑlɯktɑ
ɑrsɑHn	ɑrsɑin	ɑrsɑɯn
ɑsɯrlHk	ɑsɯrlik	ɑsɯrlɯk
bɑroHn	bɑroin	bɑroun
bitymlH	bitymli	bitymly
dɯʃDA	dɯʃdɑ	dɯʃtɑ
dɑɰɯtHʤH	dɑɰɯtiʤi	dɑɰɯtɯʤɯ
dijɑgrɑmlArH	dijɑgrɑmlɑri	dijɑgrɑmlɑrɯ
durHʃH	duriʃi	duruʃu
duvɑrlArHHn	duvɑrlɑriin	duvɑrlɑrɯɯn
enfeksijonA	enfeksijone	enfeksijonɑ
kɑbloHn	kɑbloin	kɑbloun
kɑpsɑmHHn	kɑpsɑmiin	kɑpsɑmɯɯn
kitɑpDAki	kitɑpdɑki	kitɑptɑki
konservɑtuvɑrH	konservɑtuvɑri	konservɑtuvɑrɯ
korkuHn	korkuin	korkuun
kullɑnmAnHzH	kullɑnmɑnizi	kullɑnmɑnɯzɯ
meʤlisDAn	meʤlisden	meʤlisten
oʤɑklArHHn	oʤɑklɑriin	oʤɑklɑrɯɯn
oluʃumHn	oluʃumin	oluʃumun
oruʧlArH	oruʧlɑri	oruʧlɑrɯ
sonunʤuH	sonunʤui	sonunʤuu
sorunmHz	sorunmiz	sorunmuz
stɑʒHn	stɑʒin	stɑʒɯn
tɑbɑkɑlArH	tɑbɑkɑlɑri	tɑbɑkɑlɑrɯ
tɑhsilɑtH	tɑhsilɑti	tɑhsilɑtɯ
tɑrɑfsHzlHk	tɑrɑfsizlik	tɑrɑfsɯzlɯk
tɑrzlArH	tɑrzlɑri	tɑrzlɑrɯ
telefonlArHn	telefonlerin	telefonlɑrɯn
tuzlArH	tuzlɑri	tuzlɑrɯ
uʧurumHn	uʧurumin	uʧurumun
umutlH	umutli	umutlu
ujumsHzlHk	ujumsizlik	ujumsuzluk
vɑtɑndɑʃmHz	vɑtɑndɑʃmiz	vɑtɑndɑʃmɯz
jyzjɯlH	jyzjɯli	jyzjɯlɯ
jɑɰHʃlAr	jɑɰiʃlɑr	jɑɰɯʃlɑr
jɑngɯnHn	jɑngɯnin	jɑngɯnɯn
jɑpɯtH	jɑpɯti	jɑpɯtɯ
jɑrɑH	jɑrɑi	jɑrɑɯ
jɑzɑrlHk	jɑzɑrlik	jɑzɑrlɯk
jurtlArH	jurtlɑri	jurtlɑrɯ
ʧoɰɑlmAH	ʧoɰɑlmɑi	ʧoɰɑlmɑɯ
ɑʧɯklɑmɑlH	ɑʧɯklɑmɑli	ɑʧɯklɑmɑlɯ
ɑʧmAH	ɑʧmɑi	ɑʧmɑɯ
ɑɰrɯsHz	ɑɰrɯsiz	ɑɰrɯsɯz
ɑdresDA	ɑdresde	ɑdreste
ɑntrenørH	ɑntrenøri	ɑntrenøry
ɑrɑzilArDA	ɑrɑzilɑrdɑ	ɑrɑzilerde
ɑrkɑdɑʃnHz	ɑrkɑdɑʃniz	ɑrkɑdɑʃnɯz
ɑzɑlHʃ	ɑzɑliʃ	ɑzɑlɯʃ
bɑʃsɑvʤɯH	bɑʃsɑvʤɯi	bɑʃsɑvʤɯɯ
bɑʃvurulArHHn	bɑʃvurulɑriin	bɑʃvurulɑrɯɯn
bɑʤɑklArH	bɑʤɑklɑri	bɑʤɑklɑrɯ
bɑkɑnlɯklArHn	bɑkɑnlɯklɑrin	bɑkɑnlɯklɑrɯn
binɑlArHHn	binɑlɑriin	binɑlɑrɯɯn
ʤinsDAn	ʤinsden	ʤinsten
detɑjH	detɑji	detɑjɯ
dolmɑH	dolmɑi	dolmɑɯ
fɑturɑsHz	fɑturɑsiz	fɑturɑsɯz
fidɑnH	fidɑni	fidɑnɯ
gyʧsHzlHk	gyʧsizlik	gyʧsyzlyk
gyryltyH	gyryltyi	gyryltyy
kɑmerɑH	kɑmerɑi	kɑmerɑɯ
kɑmpusH	kɑmpusi	kɑmpusu
kɑpɯlArHn	kɑpɯlɑrin	kɑpɯlɑrɯn
kɑtsɑjɯlArH	kɑtsɑjɯlɑri	kɑtsɑjɯlɑrɯ
kɑtDAki	kɑtdɑki	kɑttɑki
kɑzɑnɯmH	kɑzɑnɯmi	kɑzɑnɯmɯ
klorlH	klorli	klorlu
kolesterolH	kolesteroli	kolesteroly
kontrolHn	kontrolin	kontrolyn
konutHn	konutin	konutun
kopjɑlArH	kopjɑlɑri	kopjɑlɑrɯ
mɑɰɑrɑHn	mɑɰɑrɑin	mɑɰɑrɑɯn
mezɑrlHk	mezɑrlik	mezɑrlɯk
miljonHn	miljonin	miljonun
optimizɑsjonH	optimizɑsjoni	optimizɑsjonu
ormɑnHn	ormɑnin	ormɑnɯn
ortɑmlArHn	ortɑmlɑrin	ortɑmlɑrɯn
protokolHn	protokolin	protokolyn
sɑɑtlArA	sɑɑtlɑrɑ	sɑɑtlere
sɑvɑʃʧH	sɑvɑʃʧi	sɑvɑʃʧɯ
sɑjmɑnlHk	sɑjmɑnlik	sɑjmɑnlɯk
sendikɑmHz	sendikɑmiz	sendikɑmɯz
sunuʤuHn	sunuʤuin	sunuʤuun
tymørH	tymøri	tymøry
tɑʃlArHHn	tɑʃlɑriin	tɑʃlɑrɯɯn
tɑkɯmlArHHn	tɑkɯmlɑriin	tɑkɯmlɑrɯɯn
tɑrɑfnHzA	tɑrɑfnize	tɑrɑfnɯzɑ
teminɑtlArHn	teminɑtlɑrin	teminɑtlɑrɯn
tutHʃ	tutiʃ	tutuʃ
tutukluHn	tutukluin	tutukluun
ulɑʃDHkDAn	ulɑʃdikdɑn	ulɑʃtɯktɑn
unutHp	unutip	unutup
ujgulɑHʤH	ujgulɑiʤi	ujgulɑɯʤɯ
vɑsɯflH	vɑsɯfli	vɑsɯflɯ
vebɑH	vebɑi	vebɑɯ
jɑʃlHlArA	jɑʃlilɑrɑ	jɑʃlɯlɑrɑ
jɑngɯnH	jɑngɯni	jɑngɯnɯ
ʧɑɰrɯlArH	ʧɑɰrɯlɑri	ʧɑɰrɯlɑrɯ
ʧɑdɯrH	ʧɑdɯri	ʧɑdɯrɯ
ʧɑlɯʃmAlArnHz	ʧɑlɯʃmɑlɑrniz	ʧɑlɯʃmɑlɑrnɯz
ʃɑrkɯH	ʃɑrkɯi	ʃɑrkɯɯ
ɑnlArH	ɑnlɑri	ɑnlɑrɯ
bɯrɑkmAH	bɯrɑkmɑi	bɯrɑkmɑɯ
byjyHp	byjyip	byjyyp
bɑɰlArHn	bɑɰlɑrin	bɑɰlɑrɯn
bɑʃørtyH	bɑʃørtyi	bɑʃørtyy
bɑsɑmɑkDA	bɑsɑmɑkdɑ	bɑsɑmɑktɑ
ʤiroH	ʤiroi	ʤirou
dɑkikɑH	dɑkikɑi	dɑkikɑɯ
dɑmgɑH	dɑmgɑi	dɑmgɑɯ
depolArDA	depolerde	depolɑrdɑ
depresjonH	depresjoni	depresjonu
eʤzɑnelArDA	eʤzɑnelerdɑ	eʤzɑnelerde
ekipmɑnHn	ekipmɑnin	ekipmɑnɯn
elmɑlH	elmɑli	elmɑlɯ
gynlH	gynli	gynly
gitmADA	gitmede	gitmete
hɑllArA	hɑllɑrɑ	hɑllere
hɑritɑHn	hɑritɑin	hɑritɑɯn
hɑjɑtmHz	hɑjɑtmiz	hɑjɑtmɯz
ihtijɑʧlArnHzA	ihtijɑʧlɑrnize	ihtijɑʧlɑrnɯzɑ
kɑlɯnlHkDA	kɑlɯnlikdɑ	kɑlɯnlɯktɑ
kɑnɑllArHn	kɑnɑllɑrin	kɑnɑllɑrɯn
konuklArHn	konuklɑrin	konuklɑrɯn
korkulH	korkuli	korkulu
koroH	koroi	korou
koruHp	koruip	koruup
kurmAlArH	kurmɑlɑri	kurmɑlɑrɯ
lɑborɑtuɑrlArH	lɑborɑtuɑrlɑri	lɑborɑtuɑrlɑrɯ
motivɑsjonH	motivɑsjoni	motivɑsjonu
nɑmuslH	nɑmusli	nɑmuslu
noktɑlH	noktɑli	noktɑlɯ
olAʤAklArnH	olɑʤɑklɑrni	olɑʤɑklɑrnɯ
oluʃumHHn	oluʃumiin	oluʃumuun
pɑrɑHHn	pɑrɑiin	pɑrɑɯɯn
politikɑH	politikɑi	politikɑɯ
rezeksijonH	rezeksijoni	rezeksijonu
rolHHn	roliin	rolyyn
sɯklHk	sɯklik	sɯklɯk
sɑɰlɑmADAn	sɑɰlɑmɑdɑn	sɑɰlɑmɑtɑn
sembollArH	sembollɑri	sembolleri
senɑrjoH	senɑrjoi	senɑrjou
stɑtyA	stɑtyɑ	stɑtye
tɑrɑfmHzA	tɑrɑfmize	tɑrɑfmɯzɑ
tɑvɑnH	tɑvɑni	tɑvɑnɯ
tempoH	tempoi	tempou
uzunlukDA	uzunlukdɑ	uzunluktɑ
vɑkɯflArHn	vɑkɯflɑrin	vɑkɯflɑrɯn
vefɑtH	vefɑti	vefɑtɯ
jɑtHp	jɑtip	jɑtɯp
jɑjɯlɯmH	jɑjɯlɯmi	jɑjɯlɯmɯ
jollH	jolli	jollu
ɑnHn	ɑnin	ɑnɯn
ɑrkɑdɑʃmHn	ɑrkɑdɑʃmin	ɑrkɑdɑʃmɯn
ɑtsHz	ɑtsiz	ɑtsɯz
ɑjrɯlDHkDAn	ɑjrɯldikdɑn	ɑjrɯldɯktɑn
bɑkɑnHHn	bɑkɑniin	bɑkɑnɯɯn
bɑskɯH	bɑskɯi	bɑskɯɯ
biblijogrɑfjɑH	biblijogrɑfjɑi	biblijogrɑfjɑɯ
dønHnʤA	døninʤe	dønynʤe
deɰiʃmADA	deɰiʃmede	deɰiʃmete
dolHp	dolip	dolup
dostmHz	dostmiz	dostmuz
evrɑklArHn	evrɑklɑrin	evrɑklɑrɯn
formyllAr	formyllɑr	formyller
fuɑrlArH	fuɑrlɑri	fuɑrlɑrɯ
gøkjyzynH	gøkjyzyni	gøkjyzyny
grɑfikDA	grɑfikde	grɑfikte
hɑtɯrH	hɑtɯri	hɑtɯrɯ
hɑjɑllArH	hɑjɑllɑri	hɑjɑlleri
kɑbuklArH	kɑbuklɑri	kɑbuklɑrɯ
kɑslArDA	kɑslerde	kɑslɑrdɑ
kɑjgɯlArH	kɑjgɯlɑri	kɑjgɯlɑrɯ
kɑzɑnʧlArH	kɑzɑnʧlɑri	kɑzɑnʧlɑrɯ
kirɑʤɯHn	kirɑʤɯin	kirɑʤɯɯn
kullHk	kullik	kulluk
kurslArHn	kurslɑrin	kurslɑrɯn
lɑfH	lɑfi	lɑfɯ
mɑʧlArH	mɑʧlɑri	mɑʧlɑrɯ
mɑkbuzlArH	mɑkbuzlɑri	mɑkbuzlɑrɯ
mezunlArHn	mezunlɑrin	mezunlɑrɯn
mirɑsHn	mirɑsin	mirɑsɯn
modɑH	modɑi	modɑɯ
pɑrlɑmentoHn	pɑrlɑmentoin	pɑrlɑmentoun
ryzgɑrlH	ryzgɑrli	ryzgɑrlɯ
sɯʤɑklɯklArH	sɯʤɑklɯklɑri	sɯʤɑklɯklɑrɯ
sɯrlArH	sɯrlɑri	sɯrlɑrɯ
sɑɰlAnmADA	sɑɰlɑnmɑdɑ	sɑɰlɑnmɑtɑ
sɑkɯnʤɑH	sɑkɯnʤɑi	sɑkɯnʤɑɯ
sɑjfɑmHzA	sɑjfɑmize	sɑjfɑmɯzɑ
silɑhsHz	silɑhsiz	silɑhsɯz
sinemɑHn	sinemɑin	sinemɑɯn
tɑbɑkɑHn	tɑbɑkɑin	tɑbɑkɑɯn
tijɑtrolArH	tijɑtrolɑri	tijɑtrolɑrɯ
torunH	toruni	torunu
umutlArH	umutlɑri	umutlɑrɯ
ujmAlArH	ujmɑlɑri	ujmɑlɑrɯ
ujumsHz	ujumsiz	ujumsuz
jɑrɯʃDA	jɑrɯʃdɑ	jɑrɯʃtɑ
jɑzmAH	jɑzmɑi	jɑzmɑɯ
jumurtɑlArH	jumurtɑlɑri	jumurtɑlɑrɯ
jurttɑʃHn	jurttɑʃin	jurttɑʃɯn
ʧɯkHʃlAr	ʧɯkiʃlɑr	ʧɯkɯʃlɑr
ʧɑlɯʃmAlArmHzHn	ʧɑlɯʃmɑlɑrmizin	ʧɑlɯʃmɑlɑrmɯzɯn
ʧɑlɯʃmAlArnHzH	ʧɑlɯʃmɑlɑrnizi	ʧɑlɯʃmɑlɑrnɯzɯ
ɑʧɯklɑmAlArHn	ɑʧɯklɑmɑlɑrin	ɑʧɯklɑmɑlɑrɯn
ɑɰɑʧDAn	ɑɰɑʧdɑn	ɑɰɑʧtɑn
ɑidɑtlArH	ɑidɑtlɑri	ɑidɑtlɑrɯ
ɑmelijɑtHn	ɑmelijɑtin	ɑmelijɑtɯn
ɑnɑjɑsɑmHzHn	ɑnɑjɑsɑmizin	ɑnɑjɑsɑmɯzɯn
ɑrɑbɑlArH	ɑrɑbɑlɑri	ɑrɑbɑlɑrɯ
ɑrɑHʃlAr	ɑrɑiʃlɑr	ɑrɑɯʃlɑr
ɑromɑlH	ɑromɑli	ɑromɑlɯ
ɑtɯklArHHn	ɑtɯklɑriin	ɑtɯklɑrɯɯn
ɑtɯlɯmH	ɑtɯlɯmi	ɑtɯlɯmɯ
bɑʃnHzH	bɑʃnizi	bɑʃnɯzɯ
bɑʃlɯʤɑlArH	bɑʃlɯʤɑlɑri	bɑʃlɯʤɑlɑrɯ
bɑnjoH	bɑnjoi	bɑnjou
bɑsmɑnHz	bɑsmɑniz	bɑsmɑnɯz
døkymɑnH	døkymɑni	døkymɑnɯ
dolulHk	dolulik	doluluk
dujuH	dujui	dujuu
fɑrklHlHklArA	fɑrkliliklɑrɑ	fɑrklɯlɯklɑrɑ
formlArHHn	formlɑriin	formlɑrɯɯn
gøryH	gøryi	gøryy
geniʃlikDA	geniʃlikde	geniʃlikte
hɑlkmHzH	hɑlkmizi	hɑlkmɯzɯ
hɑtɑHn	hɑtɑin	hɑtɑɯn
hɑjɑtmH	hɑjɑtmi	hɑjɑtmɯ
ihtijɑʧlArnHzH	ihtijɑʧlɑrnizi	ihtijɑʧlɑrnɯzɯ
kɑbulnH	kɑbulni	kɑbulny
kɑdɑrHHn	kɑdɑriin	kɑdɑrɯɯn
kɑdroHHn	kɑdroiin	kɑdrouun
kɑhrɑmɑnlArH	kɑhrɑmɑnlɑri	kɑhrɑmɑnlɑrɯ
kɑnɑlHHn	kɑnɑliin	kɑnɑlɯɯn
koʃullH	koʃulli	koʃullu
komʃulArH	komʃulɑri	komʃulɑrɯ
kurtulHp	kurtulip	kurtulup
lezjonH	lezjoni	lezjonu
myrɑʤɑɑtDA	myrɑʤɑɑtdɑ	myrɑʤɑɑttɑ
modylɑsjonH	modylɑsjoni	modylɑsjonu
notHn	notin	notun
oʤɑkDA	oʤɑkdɑ	oʤɑktɑ
opsijonlArHn	opsijonlɑrin	opsijonlɑrɯn
otobysH	otobysi	otobysy
ojlArH	ojlɑri	ojlɑrɯ
plɑnsHz	plɑnsiz	plɑnsɯz
pozisjonlArH	pozisjonlɑri	pozisjonlɑrɯ
puɑnHn	puɑnin	puɑnɯn
puɑnHHn	puɑniin	puɑnɯɯn
pulH	puli	pulu
rekorH	rekori	rekoru
sytunlArH	sytunlɑri	sytunlɑrɯ
senɑtoHn	senɑtoin	senɑtoun
skorlArH	skorlɑri	skorlɑrɯ
tɑkɯmlArHn	tɑkɯmlɑrin	tɑkɯmlɑrɯn
tɑnklArH	tɑnklɑri	tɑnklɑrɯ
topluluklArHn	topluluklɑrin	topluluklɑrɯn
toplummHz	toplummiz	toplummuz
turlH	turli	turlu
jyrytmADA	jyrytmede	jyrytmete
jɑpɯmHHn	jɑpɯmiin	jɑpɯmɯɯn
jolsuzlHklArHn	jolsuzliklɑrin	jolsuzluklɑrɯn
ʧøkHʃ	ʧøkiʃ	ʧøkyʃ
ʧɑlɯʃmAnHz	ʧɑlɯʃmɑniz	ʧɑlɯʃmɑnɯz
ʧɑplArH	ʧɑplɑri	ʧɑplɑrɯ
ʧekmADA	ʧekmede	ʧekmete
ʧekDHklArH	ʧekdikleri	ʧektikleri
ølymsHz	ølymsiz	ølymsyz
ølHnʤAA	ølinʤee	ølynʤee
øzgyrlHklArHHn	øzgyrlikleriin	øzgyrlykleriin
ɑʧmADA	ɑʧmɑdɑ	ɑʧmɑtɑ
ɑrsɑlArHn	ɑrsɑlɑrin	ɑrsɑlɑrɯn
ɑjɑklArHHn	ɑjɑklɑriin	ɑjɑklɑrɯɯn
ɑjɑrlArHHn	ɑjɑrlɑriin	ɑjɑrlɑrɯɯn
ɑjvɑlHk	ɑjvɑlik	ɑjvɑlɯk
ɑzɯnlɯklArHn	ɑzɯnlɯklɑrin	ɑzɯnlɯklɑrɯn
bɑʃlɯkDA	bɑʃlɯkdɑ	bɑʃlɯktɑ
bɑnkɑmHzHn	bɑnkɑmizin	bɑnkɑmɯzɯn
bulHʃlAr	buliʃlɑr	buluʃlɑr
dyʃmɑnlArH	dyʃmɑnlɑri	dyʃmɑnlɑrɯ
dykkɑnlArH	dykkɑnlɑri	dykkɑnlɑrɯ
dezɑvɑntɑʒH	dezɑvɑntɑʒi	dezɑvɑntɑʒɯ
doɰHp	doɰip	doɰup
dolɑjsHz	dolɑjsiz	dolɑjsɯz
dosjɑlArnHzH	dosjɑlɑrnizi	dosjɑlɑrnɯzɯ
dojAsHjA	dojɑsijɑ	dojɑsɯjɑ
enstitymHz	enstitymiz	enstitymyz
etDHkʧA	etdikʧe	ettikʧe
fɑbrikɑlArHHn	fɑbrikɑlɑriin	fɑbrikɑlɑrɯɯn
fɑktørHHn	fɑktøriin	fɑktøryyn
fɑjH	fɑji	fɑjɯ
geʧDHklArH	geʧdikleri	geʧtikleri
geliʃDHkʧA	geliʃdikʧe	geliʃtikʧe
hɑlDAki	hɑldɑki	hɑldeki
hukukʧHlAr	hukukʧilɑr	hukukʧulɑr
iʤrɑH	iʤrɑi	iʤrɑɯ
internetDAki	internetdeki	internetteki
istekDA	istekde	istekte
kɑʧH	kɑʧi	kɑʧɯ
kɑrɯHHn	kɑrɯiin	kɑrɯɯɯn
kɑsHn	kɑsin	kɑsɯn
kojmAH	kojmɑi	kojmɑɯ
lɑborɑtuvɑrHn	lɑborɑtuvɑrin	lɑborɑtuvɑrɯn
mɑɰɑzɑH	mɑɰɑzɑi	mɑɰɑzɑɯ
mɑɰdurH	mɑɰduri	mɑɰduru
meʤmuɑH	meʤmuɑi	meʤmuɑɯ
misjonmHz	misjonmiz	misjonmuz
mobiljɑlArH	mobiljɑlɑri	mobiljɑlɑrɯ
motorlArHn	motorlɑrin	motorlɑrɯn
orgɑnizɑsjonlArHn	orgɑnizɑsjonlɑrin	orgɑnizɑsjonlɑrɯn
pɑzɑrlAmAH	pɑzɑrlɑmɑi	pɑzɑrlɑmɑɯ
sɯzAn	sɯzen	sɯzɑn
sɑntrɑllArH	sɑntrɑllɑri	sɑntrɑlleri
sorgulAnmAH	sorgulɑnmɑi	sorgulɑnmɑɯ
stoklArH	stoklɑri	stoklɑrɯ
tɯkɑnɯklHk	tɯkɑnɯklik	tɯkɑnɯklɯk
tɑhɑkkukH	tɑhɑkkuki	tɑhɑkkuku
tɑzminɑtsHz	tɑzminɑtsiz	tɑzminɑtsɯz
tekrɑrlAnmAH	tekrɑrlɑnmɑi	tekrɑrlɑnmɑɯ
telefonlArDA	telefonlerde	telefonlɑrdɑ
tipDAki	tipdeki	tipteki
uʧɑklArH	uʧɑklɑri	uʧɑklɑrɯ
ustɑlArH	ustɑlɑri	ustɑlɑrɯ
jɯɰɯnlArH	jɯɰɯnlɑri	jɯɰɯnlɑrɯ
jyrytDHklArH	jyrytdikleri	jyryttykleri
jɑkHp	jɑkip	jɑkɯp
jɑpɯlɑʃmɑHn	jɑpɯlɑʃmɑin	jɑpɯlɑʃmɑɯn
jokDAn	jokdɑn	joktɑn
ʧɑmlHk	ʧɑmlik	ʧɑmlɯk
ɯsɯH	ɯsɯi	ɯsɯɯ
ørtyHHn	ørtyiin	ørtyyyn
yrynmHz	yrynmiz	yrynmyz
ɑʧɯHHn	ɑʧɯiin	ɑʧɯɯɯn
ɑkɯmlArHHn	ɑkɯmlɑriin	ɑkɯmlɑrɯɯn
ɑlmAksHzHn	ɑlmɑksizin	ɑlmɑksɯzɯn
ɑlmAHHn	ɑlmɑiin	ɑlmɑɯɯn
ɑnlɑmAH	ɑnlɑmɑi	ɑnlɑmɑɯ
ɑjnɑlH	ɑjnɑli	ɑjnɑlɯ
ɑjrɯlHʃ	ɑjrɯliʃ	ɑjrɯlɯʃ
bytynHn	bytynin	bytynyn
bɑhɑrH	bɑhɑri	bɑhɑrɯ
bɑskɯlArHn	bɑskɯlɑrin	bɑskɯlɑrɯn
bɑjɑnlArHn	bɑjɑnlɑrin	bɑjɑnlɑrɯn
bɑjrɑklH	bɑjrɑkli	bɑjrɑklɯ
bojɑH	bojɑi	bojɑɯ
bojHHn	bojiin	bojuun
bozuklHklArHn	bozukliklɑrin	bozukluklɑrɯn
buluʃmAH	buluʃmɑi	buluʃmɑɯ
bulunmADAn	bulunmɑdɑn	bulunmɑtɑn
bulutlArH	bulutlɑri	bulutlɑrɯ
dyzenlAnmADA	dyzenlenmede	dyzenlenmete
ekDAki	ekdeki	ekteki
fɯkrɑlArH	fɯkrɑlɑri	fɯkrɑlɑrɯ
gøryʃHp	gøryʃip	gøryʃyp
hɑritɑlArHHn	hɑritɑlɑriin	hɑritɑlɑrɯɯn
hɑvuzlH	hɑvuzli	hɑvuzlu
inʃɑɑtlArH	inʃɑɑtlɑri	inʃɑɑtlɑrɯ
inɑnʧlArH	inɑnʧlɑri	inɑnʧlɑrɯ
kɑlkɯnmAH	kɑlkɯnmɑi	kɑlkɯnmɑɯ
kɑrʃɯlɑmAH	kɑrʃɯlɑmɑi	kɑrʃɯlɑmɑɯ
kɑrɑjoluHn	kɑrɑjoluin	kɑrɑjoluun
kɑtkɯH	kɑtkɯi	kɑtkɯɯ
komisjonlArHHn	komisjonlɑriin	komisjonlɑrɯɯn
kulɑkDAki	kulɑkdɑki	kulɑktɑki
mɑʧHn	mɑʧin	mɑʧɯn
mekɑnizmɑlArHn	mekɑnizmɑlɑrin	mekɑnizmɑlɑrɯn
okuDHklArH	okudiklɑri	okuduklɑrɯ
olmAlArHHn	olmɑlɑriin	olmɑlɑrɯɯn
plɑtformlArH	plɑtformlɑri	plɑtformlɑrɯ
rehɑbilitɑsjonH	rehɑbilitɑsjoni	rehɑbilitɑsjonu
resulH	resuli	resuly
sɯkɯntɯH	sɯkɯntɯi	sɯkɯntɯɯ
sɑvunmAHn	sɑvunmɑin	sɑvunmɑɯn
tɑʃɯHʤHH	tɑʃɯiʤii	tɑʃɯɯʤɯɯ
tɑnɯmlAmHʃ	tɑnɯmlɑmiʃ	tɑnɯmlɑmɯʃ
tɑnɯmlAmADA	tɑnɯmlɑmɑdɑ	tɑnɯmlɑmɑtɑ
tɑrɑftɑrH	tɑrɑftɑri	tɑrɑftɑrɯ
tɑsɑrlAnmAH	tɑsɑrlɑnmɑi	tɑsɑrlɑnmɑɯ
tɑvlH	tɑvli	tɑvlɯ
telefonHHn	telefoniin	telefonuun
terminɑllAr	terminɑllɑr	terminɑller
tutkuH	tutkui	tutkuu
tuzlHlHk	tuzlilik	tuzluluk
jɑɰHʃH	jɑɰiʃi	jɑɰɯʃɯ
jɑɰmurHn	jɑɰmurin	jɑɰmurun
jɑrɯnH	jɑrɯni	jɑrɯnɯ
jɑtHʃ	jɑtiʃ	jɑtɯʃ
ʧɯkɑrH	ʧɯkɑri	ʧɯkɑrɯ
ʧɑmurlH	ʧɑmurli	ʧɑmurlu
ʧɑtɯʃmAlArHn	ʧɑtɯʃmɑlɑrin	ʧɑtɯʃmɑlɑrɯn
ɯsɯHHn	ɯsɯiin	ɯsɯɯɯn
ølymHHn	ølymiin	ølymyyn
ʃɑʃɯlHk	ʃɑʃɯlik	ʃɑʃɯlɯk
ʃikɑjetDA	ʃikɑjetde	ʃikɑjette
ɑʒɑnlArHn	ɑʒɑnlɑrin	ɑʒɑnlɑrɯn
ɑlɯʤɯlArHn	ɑlɯʤɯlɑrin	ɑlɯʤɯlɑrɯn
ɑlejhDA	ɑlejhde	ɑlejhte
ɑnomɑlilAr	ɑnomɑlilɑr	ɑnomɑliler
ɑrɯzɑlArH	ɑrɯzɑlɑri	ɑrɯzɑlɑrɯ
ɑrɑʤɯnHzH	ɑrɑʤɯnizi	ɑrɑʤɯnɯzɯ
ɑrɑnHzDA	ɑrɑnizdɑ	ɑrɑnɯzdɑ
ɑsɯlsHz	ɑsɯlsiz	ɑsɯlsɯz
bɑɰlɑntɯlArHn	bɑɰlɑntɯlɑrin	bɑɰlɑntɯlɑrɯn
bɑʃmH	bɑʃmi	bɑʃmɯ
bollHk	bollik	bolluk
bojutlArHHn	bojutlɑriin	bojutlɑrɯɯn
ʤilɑlH	ʤilɑli	ʤilɑlɯ
dokymɑnlArHn	dokymɑnlɑrin	dokymɑnlɑrɯn
doktorlArH	doktorlɑri	doktorlɑrɯ
dujgulH	dujguli	dujgulu
gyzellHkDA	gyzellikde	gyzellikte
hɑrʧDAn	hɑrʧdɑn	hɑrʧtɑn
hɑtlH	hɑtli	hɑtlɯ
hɑjɑtnHz	hɑjɑtniz	hɑjɑtnɯz
kɯjAsHjA	kɯjɑsijɑ	kɯjɑsɯjɑ
kykyrtlH	kykyrtli	kykyrtly
kɑnɑmAHn	kɑnɑmɑin	kɑnɑmɑɯn
kɑrɯʃmAH	kɑrɯʃmɑi	kɑrɯʃmɑɯ
kodHn	kodin	kodun
konsɑntrɑsjonlArH	konsɑntrɑsjonlɑri	konsɑntrɑsjonlɑrɯ
kujuH	kujui	kujuu
lyzumsHz	lyzumsiz	lyzumsuz
ofisDA	ofisde	ofiste
okʧH	okʧi	okʧu
orgɑnizmɑHn	orgɑnizmɑin	orgɑnizmɑɯn
piʃmɑnlHk	piʃmɑnlik	piʃmɑnlɯk
plɑnlAmAHHn	plɑnlɑmɑiin	plɑnlɑmɑɯɯn
sɯrɑlArH	sɯrɑlɑri	sɯrɑlɑrɯ
sɑɰlɑmAlArH	sɑɰlɑmɑlɑri	sɑɰlɑmɑlɑrɯ
sɑnAH	sɑnɑi	sɑnɑɯ
simylɑsjonH	simylɑsjoni	simylɑsjonu
tɑkɯmmHzHn	tɑkɯmmizin	tɑkɯmmɯzɯn
tɑnɯmHHn	tɑnɯmiin	tɑnɯmɯɯn
tezgɑhH	tezgɑhi	tezgɑhɯ
tezgɑhlArH	tezgɑhlɑri	tezgɑhlɑrɯ
joɰunlHkDA	joɰunlikdɑ	joɰunluktɑ
ɯsɯtHʤH	ɯsɯtiʤi	ɯsɯtɯʤɯ
ølDHkDAn	øldikden	øldykten
øzgyrlHklArA	øzgyrliklere	øzgyrlyklere
ʃɑrkɯHn	ʃɑrkɯin	ʃɑrkɯɯn
ɑlgoritmɑH	ɑlgoritmɑi	ɑlgoritmɑɯ
ɑnlɑʃmɑzlɯklArHn	ɑnlɑʃmɑzlɯklɑrin	ɑnlɑʃmɑzlɯklɑrɯn
ɑrɑʧlHk	ɑrɑʧlik	ɑrɑʧlɯk
ɑrɑmHzDAki	ɑrɑmizdeki	ɑrɑmɯzdɑki
ɑrkɑdɑʃHn	ɑrkɑdɑʃin	ɑrkɑdɑʃɯn
ɑrkɑdɑʃlArmH	ɑrkɑdɑʃlɑrmi	ɑrkɑdɑʃlɑrmɯ
ɑtɑmAH	ɑtɑmɑi	ɑtɑmɑɯ
bɯrɑkDHklArH	bɯrɑkdiklɑri	bɯrɑktɯklɑrɯ
bɑɰlɑntɯlArHHn	bɑɰlɑntɯlɑriin	bɑɰlɑntɯlɑrɯɯn
bɑʃørtylH	bɑʃørtyli	bɑʃørtyly
bɑntlH	bɑntli	bɑntlɯ
borsɑHn	borsɑin	borsɑɯn
dyʃHʃH	dyʃiʃi	dyʃyʃy
dɑɰɯlHʃH	dɑɰɯliʃi	dɑɰɯlɯʃɯ
dɑnɯʃmɑnlArHn	dɑnɯʃmɑnlɑrin	dɑnɯʃmɑnlɑrɯn
erozjonH	erozjoni	erozjonu
firmɑnHz	firmɑniz	firmɑnɯz
fotoɰrɑfʧHHn	fotoɰrɑfʧiin	fotoɰrɑfʧɯɯn
gɯdɑlArH	gɯdɑlɑri	gɯdɑlɑrɯ
gønyllylHk	gønyllylik	gønyllylyk
hykymsHz	hykymsiz	hykymsyz
hɑfɯzɑH	hɑfɯzɑi	hɑfɯzɑɯ
hɑftɑH	hɑftɑi	hɑftɑɯ
hɑritɑH	hɑritɑi	hɑritɑɯ
hɑvɑHHn	hɑvɑiin	hɑvɑɯɯn
hormonlArHn	hormonlɑrin	hormonlɑrɯn
iʃgyʤyHn	iʃgyʤyin	iʃgyʤyyn
ithɑlɑtDA	ithɑlɑtdɑ	ithɑlɑttɑ
kɑlkHnʤA	kɑlkinʤɑ	kɑlkɯnʤɑ
kɑnɑmAlArH	kɑnɑmɑlɑri	kɑnɑmɑlɑrɯ
kɑpɑnHp	kɑpɑnip	kɑpɑnɯp
kɑtmɑnlArH	kɑtmɑnlɑri	kɑtmɑnlɑrɯ
kɑzɑnH	kɑzɑni	kɑzɑnɯ
kokusHz	kokusiz	kokusuz
kurmADA	kurmɑdɑ	kurmɑtɑ
lezjonlArDA	lezjonlerde	lezjonlɑrdɑ
milletDAn	milletden	milletten
mimɑrHn	mimɑrin	mimɑrɯn
modernizɑsjonH	modernizɑsjoni	modernizɑsjonu
muhtɑrlHk	muhtɑrlik	muhtɑrlɯk
okumAH	okumɑi	okumɑɯ
ojnɑmAH	ojnɑmɑi	ojnɑmɑɯ
protokolA	protokolɑ	protokole
sɑɰlAnmAHHn	sɑɰlɑnmɑiin	sɑɰlɑnmɑɯɯn
sɑldɯrɯlArHn	sɑldɯrɯlɑrin	sɑldɯrɯlɑrɯn
sɑrɑjHn	sɑrɑjin	sɑrɑjɯn
sɑjgɯnlHk	sɑjgɯnlik	sɑjgɯnlɯk
sipɑriʃlArHn	sipɑriʃlɑrin	sipɑriʃlerin
sorumsHz	sorumsiz	sorumsuz
tɑkHn	tɑkin	tɑkɯn
tɑsɑrɯlArH	tɑsɑrɯlɑri	tɑsɑrɯlɑrɯ
tɑvɯrlArH	tɑvɯrlɑri	tɑvɯrlɑrɯ
teʃekkylH	teʃekkyli	teʃekkyly
televizjonDAn	televizjonden	televizjondɑn
tutDHklArH	tutdiklɑri	tuttuklɑrɯ
vesikɑlHk	vesikɑlik	vesikɑlɯk
jyryHʃlAr	jyryiʃler	jyryyʃler
jɑpAnHn	jɑpɑnin	jɑpɑnɯn
jɑrɑlArHn	jɑrɑlɑrin	jɑrɑlɑrɯn
jɑtɑkDAn	jɑtɑkdɑn	jɑtɑktɑn
jɑzɯmHzDA	jɑzɯmizde	jɑzɯmɯzdɑ
zɑmɑnlArHHn	zɑmɑnlɑriin	zɑmɑnlɑrɯɯn
zɑrɑrlArHn	zɑrɑrlɑrin	zɑrɑrlɑrɯn
zɑrfH	zɑrfi	zɑrfɯ
ʧɑlHp	ʧɑlip	ʧɑlɯp
ønnHzA	ønnize	ønnyze
øjkyHn	øjkyin	øjkyyn
ʃoførH	ʃoføri	ʃoføry
ystynlHklArH	ystynlikleri	ystynlykleri
ɑʃɯmH	ɑʃɯmi	ɑʃɯmɯ
ɑkrɑbɑlHk	ɑkrɑbɑlik	ɑkrɑbɑlɯk
ɑkrɑbɑlArH	ɑkrɑbɑlɑri	ɑkrɑbɑlɑrɯ
ɑmɑʧlArHn	ɑmɑʧlɑrin	ɑmɑʧlɑrɯn
ɑnɑjɑsɑHHn	ɑnɑjɑsɑiin	ɑnɑjɑsɑɯɯn
ɑrɑbuluʤulHk	ɑrɑbuluʤulik	ɑrɑbuluʤuluk
ɑrɑmAH	ɑrɑmɑi	ɑrɑmɑɯ
ɑtHʃH	ɑtiʃi	ɑtɯʃɯ
ɑjɑkkɑbɯH	ɑjɑkkɑbɯi	ɑjɑkkɑbɯɯ
bɑɰɯmlɯH	bɑɰɯmlɯi	bɑɰɯmlɯɯ
bɑʃlAAlHm	bɑʃlɑɑlim	bɑʃlɑɑlɯm
bɑkɑnlɯklArH	bɑkɑnlɯklɑri	bɑkɑnlɯklɑrɯ
bɑsɑmɑklArH	bɑsɑmɑklɑri	bɑsɑmɑklɑrɯ
bɑsmɑH	bɑsmɑi	bɑsmɑɯ
bulgulArHHn	bulgulɑriin	bulgulɑrɯɯn
bulunmADHkʧA	bulunmɑdikʧɑ	bulunmɑdɯkʧɑ
dɑlgɑlArHHn	dɑlgɑlɑriin	dɑlgɑlɑrɯɯn
depoA	depoe	depoɑ
doɰuH	doɰui	doɰuu
dolgunlHk	dolgunlik	dolgunluk
fɑzlɑlHk	fɑzlɑlik	fɑzlɑlɯk
gølHHn	gøliin	gølyyn
gylH	gyli	gyly
gyryltyHn	gyryltyin	gyryltyyn
hɑlɯHn	hɑlɯin	hɑlɯɯn
iʧDA	iʧde	iʧte
kɯsɯrlHk	kɯsɯrlik	kɯsɯrlɯk
kyltyrmHzHn	kyltyrmizin	kyltyrmyzyn
kɑrɯʃɯklHk	kɑrɯʃɯklik	kɑrɯʃɯklɯk
kɑrʃɯlɑʃtɯrmAH	kɑrʃɯlɑʃtɯrmɑi	kɑrʃɯlɑʃtɯrmɑɯ
kɑrikɑtyrlAr	kɑrikɑtyrlɑr	kɑrikɑtyrler
kɑrtnHzA	kɑrtnize	kɑrtnɯzɑ
kɑsɑbɑHn	kɑsɑbɑin	kɑsɑbɑɯn
kɑjmɑklH	kɑjmɑkli	kɑjmɑklɯ
konuʃmɑʤɯlArHn	konuʃmɑʤɯlɑrin	konuʃmɑʤɯlɑrɯn
kulɑklArH	kulɑklɑri	kulɑklɑrɯ
kullɑnɯmHn	kullɑnɯmin	kullɑnɯmɯn
mɑhɑllinA	mɑhɑllinɑ	mɑhɑlline
mɑkɑmHn	mɑkɑmin	mɑkɑmɯn
mɑkɑmlArHn	mɑkɑmlɑrin	mɑkɑmlɑrɯn
mɑksɑtlH	mɑksɑtli	mɑksɑtlɯ
mɑmyllArH	mɑmyllɑri	mɑmylleri
mɑrkɑH	mɑrkɑi	mɑrkɑɯ
molɑH	molɑi	molɑɯ
olmAHnʤA	olmɑinʤɑ	olmɑɯnʤɑ
olumsuzlHk	olumsuzlik	olumsuzluk
orɑH	orɑi	orɑɯ
orgɑnHn	orgɑnin	orgɑnɯn
pɑdiʃɑhH	pɑdiʃɑhi	pɑdiʃɑhɯ
pusulɑH	pusulɑi	pusulɑɯ
rɑdjɑsjonHn	rɑdjɑsjonin	rɑdjɑsjonun
sɯʤɑkDAn	sɯʤɑkdɑn	sɯʤɑktɑn
sɑlɯnɯmH	sɑlɯnɯmi	sɑlɯnɯmɯ
sɑtɯrlArHn	sɑtɯrlɑrin	sɑtɯrlɑrɯn
sɑvunmAsHz	sɑvunmɑsiz	sɑvunmɑsɯz
sempozjumHn	sempozjumin	sempozjumun
sorumlulukDAn	sorumlulukdɑn	sorumluluktɑn
sorHp	sorip	sorup
suʧlHlAr	suʧlilɑr	suʧlulɑr
tɑbɑkɑlH	tɑbɑkɑli	tɑbɑkɑlɯ
tɑnɯHn	tɑnɯin	tɑnɯɯn
temɑslArDA	temɑslerde	temɑslɑrdɑ
umutsHzlHk	umutsizlik	umutsuzluk
uzunluklArH	uzunluklɑri	uzunluklɑrɯ
veritɑbɑnɯHn	veritɑbɑnɯin	veritɑbɑnɯɯn
vurHʃ	vuriʃ	vuruʃ
jɑnmHzA	jɑnmize	jɑnmɯzɑ
ʧɯkɑrmɑH	ʧɯkɑrmɑi	ʧɯkɑrmɑɯ
ʧøzymHHn	ʧøzymiin	ʧøzymyyn
ʧoɰumHzHn	ʧoɰumizin	ʧoɰumuzun
ʧoʤuklArnHzA	ʧoʤuklɑrnize	ʧoʤuklɑrnɯzɑ
ɑɰrɯH	ɑɰrɯi	ɑɰrɯɯ
ɑnlɑʃmɑlArHn	ɑnlɑʃmɑlɑrin	ɑnlɑʃmɑlɑrɯn
ɑjdɯnH	ɑjdɯni	ɑjdɯnɯ
bɯrɑkDHkDAn	bɯrɑkdikdɑn	bɯrɑktɯktɑn
bɑɰlɑntɯnHz	bɑɰlɑntɯniz	bɑɰlɑntɯnɯz
bulɑʃmAH	bulɑʃmɑi	bulɑʃmɑɯ
bulutlArHn	bulutlɑrin	bulutlɑrɯn
døkymɑnHn	døkymɑnin	døkymɑnɯn
dɑvrɑnmAH	dɑvrɑnmɑi	dɑvrɑnmɑɯ
dɑjɑnmAH	dɑjɑnmɑi	dɑjɑnmɑɯ
doɰuHn	doɰuin	doɰuun
dostlArHHn	dostlɑriin	dostlɑrɯɯn
dojumsHz	dojumsiz	dojumsuz
edebijɑtDA	edebijɑtdɑ	edebijɑttɑ
enfeksijonlArDA	enfeksijonlerde	enfeksijonlɑrdɑ
fijɑtlArmHzA	fijɑtlɑrmize	fijɑtlɑrmɯzɑ
geʧirDHkDAn	geʧirdikden	geʧirdikten
hɑtɯrɑlArH	hɑtɯrɑlɑri	hɑtɯrɑlɑrɯ
ilkokulH	ilkokuli	ilkokulu
kɑplArH	kɑplɑri	kɑplɑrɯ
kɑtɑlogH	kɑtɑlogi	kɑtɑlogu
komutɑnlArH	komutɑnlɑri	komutɑnlɑrɯ
kuʃkulH	kuʃkuli	kuʃkulu
kullɑnmAlArnH	kullɑnmɑlɑrni	kullɑnmɑlɑrnɯ
kumɑʃlArHn	kumɑʃlɑrin	kumɑʃlɑrɯn
kurultɑjHn	kurultɑjin	kurultɑjɯn
lɑborɑtuvɑrlArHn	lɑborɑtuvɑrlɑrin	lɑborɑtuvɑrlɑrɯn
mɑɰdurHn	mɑɰdurin	mɑɰdurun
mɑhkumHn	mɑhkumin	mɑhkumun
medjɑH	medjɑi	medjɑɯ
minerɑllArHHn	minerɑllɑriin	minerɑlleriin
mirɑsʧHlArH	mirɑsʧilɑri	mirɑsʧɯlɑrɯ
pɑrɑnHz	pɑrɑniz	pɑrɑnɯz
reklɑmHn	reklɑmin	reklɑmɯn
rektørlHkʧA	rektørlikʧe	rektørlykʧe
sɯnɯrlɑmɑlArH	sɯnɯrlɑmɑlɑri	sɯnɯrlɑmɑlɑrɯ
sɯnɑvsHz	sɯnɑvsiz	sɯnɑvsɯz
sɑɰlɯkDA	sɑɰlɯkdɑ	sɑɰlɯktɑ
sɑnɑtlArHHn	sɑnɑtlɑriin	sɑnɑtlɑrɯɯn
sɑjfɑlArmHzDA	sɑjfɑlɑrmizde	sɑjfɑlɑrmɯzdɑ
sɑjgɯHn	sɑjgɯin	sɑjgɯɯn
sektørmHzHn	sektørmizin	sektørmyzyn
stokH	stoki	stoku
telefonlArDAn	telefonlerden	telefonlɑrdɑn
topluluklArHHn	topluluklɑriin	topluluklɑrɯɯn
triljonlHk	triljonlik	triljonluk
tutɑnɑkDA	tutɑnɑkdɑ	tutɑnɑktɑ
tutuklulHk	tutuklulik	tutukluluk
uʧɑkDA	uʧɑkdɑ	uʧɑktɑ
unsurHn	unsurin	unsurun
usulDA	usuldɑ	usulde
ujgɑrlHklArHn	ujgɑrliklɑrin	ujgɑrlɯklɑrɯn
uzɑjlArH	uzɑjlɑri	uzɑjlɑrɯ
jykymlHlHklArHn	jykymliliklerin	jykymlylyklerin
jyksekokulmHz	jyksekokulmiz	jyksekokulmuz
jɑpɯlAnmAHn	jɑpɯlɑnmɑin	jɑpɯlɑnmɑɯn
jɑsɑklAnmAH	jɑsɑklɑnmɑi	jɑsɑklɑnmɑɯ
ʧoɰulʤulHk	ʧoɰulʤulik	ʧoɰulʤuluk
yʧHHn	yʧiin	yʧyyn
ɑhlɑklH	ɑhlɑkli	ɑhlɑklɯ
ɑnnelArH	ɑnnelɑri	ɑnneleri
bɑbɑmH	bɑbɑmi	bɑbɑmɯ
bɑjɑnHn	bɑjɑnin	bɑjɑnɯn
belirtmADA	belirtmede	belirtmete
boɰɑzHn	boɰɑzin	boɰɑzɯn
boruHHn	boruiin	boruuun
bojɑHn	bojɑin	bojɑɯn
brɑnʃDA	brɑnʃdɑ	brɑnʃtɑ
ʤoɰrɑfjɑHn	ʤoɰrɑfjɑin	ʤoɰrɑfjɑɯn
dɑjɑnɯʃmɑHn	dɑjɑnɯʃmɑin	dɑjɑnɯʃmɑɯn
divɑnHHn	divɑniin	divɑnɯɯn
drenɑʒH	drenɑʒi	drenɑʒɯ
elemɑnHn	elemɑnin	elemɑnɯn
fɑturɑlArnHzH	fɑturɑlɑrnizi	fɑturɑlɑrnɯzɯ
fijɑtDAn	fijɑtdɑn	fijɑttɑn
gɑjrimenkullAr	gɑjrimenkullɑr	gɑjrimenkuller
hɑzɯrlɯklArHn	hɑzɯrlɯklɑrin	hɑzɯrlɯklɑrɯn
kɯlɑvuzlHk	kɯlɑvuzlik	kɯlɑvuzluk
kɑdrolArHHn	kɑdrolɑriin	kɑdrolɑrɯɯn
kɑnɯtlArH	kɑnɯtlɑri	kɑnɯtlɑrɯ
kɑrʃɯnHzDA	kɑrʃɯnizdɑ	kɑrʃɯnɯzdɑ
kɑjɑʧlArHn	kɑjɑʧlɑrin	kɑjɑʧlɑrɯn
koʃuH	koʃui	koʃuu
komʃumHz	komʃumiz	komʃumuz
konsɑntrɑsjonHHn	konsɑntrɑsjoniin	konsɑntrɑsjonuun
konHʃ	koniʃ	konuʃ
krɑlHn	krɑlin	krɑlɯn
kuʃɑkDAn	kuʃɑkdɑn	kuʃɑktɑn
kuruluʃmHz	kuruluʃmiz	kuruluʃmuz
levhɑlArHn	levhɑlɑrin	levhɑlɑrɯn
mɑɰɑrɑH	mɑɰɑrɑi	mɑɰɑrɑɯ
metrɑʒlH	metrɑʒli	metrɑʒlɯ
mimɑrlArH	mimɑrlɑri	mimɑrlɑrɯ
odɑklArH	odɑklɑri	odɑklɑrɯ
onɑjHHn	onɑjiin	onɑjɯɯn
opsijonHn	opsijonin	opsijonun
otojolH	otojoli	otojolu
oturumHn	oturumin	oturumun
ojunlArHHn	ojunlɑriin	ojunlɑrɯɯn
pɑrɑʃytH	pɑrɑʃyti	pɑrɑʃyty
pɑrkDA	pɑrkdɑ	pɑrktɑ
pɑtronH	pɑtroni	pɑtronu
pijɑsɑlArHHn	pijɑsɑlɑriin	pijɑsɑlɑrɯɯn
plɑtformHn	plɑtformin	plɑtformun
søkHp	søkip	søkyp
sɑkɯnʤɑlArH	sɑkɯnʤɑlɑri	sɑkɯnʤɑlɑrɯ
sɑntrɑlHn	sɑntrɑlin	sɑntrɑlɯn
sɑtHʃHn	sɑtiʃin	sɑtɯʃɯn
sɑtHʃHHn	sɑtiʃiin	sɑtɯʃɯɯn
seʧDHkDAn	seʧdikden	seʧtikten
sokɑkDAn	sokɑkdɑn	sokɑktɑn
stɑndɑrdlArH	stɑndɑrdlɑri	stɑndɑrdlɑrɯ
stɑndɑrtDA	stɑndɑrtdɑ	stɑndɑrttɑ
tɑbiɑtDA	tɑbiɑtdɑ	tɑbiɑttɑ
tɑhɑmmylH	tɑhɑmmyli	tɑhɑmmyly
tɑmɑmlAmAH	tɑmɑmlɑmɑi	tɑmɑmlɑmɑɯ
tedɑvilArDA	tedɑvilerdɑ	tedɑvilerde
ujduHn	ujduin	ujduun
jɑʃɑntɯH	jɑʃɑntɯi	jɑʃɑntɯɯ
jɑrɑlArH	jɑrɑlɑri	jɑrɑlɑrɯ
jɑrgɯlAnmAH	jɑrgɯlɑnmɑi	jɑrgɯlɑnmɑɯ
jɑzmɑlArH	jɑzmɑlɑri	jɑzmɑlɑrɯ
jolʤulukDA	jolʤulukdɑ	jolʤuluktɑ
jorgunlHkDAn	jorgunlikdɑn	jorgunluktɑn
ølHnʤA	ølinʤe	ølynʤe
øzyrlylHk	øzyrlylik	øzyrlylyk
ɑʃɯlArHn	ɑʃɯlɑrin	ɑʃɯlɑrɯn
ɑlɯʃtɯrmɑlArH	ɑlɯʃtɯrmɑlɑri	ɑlɯʃtɯrmɑlɑrɯ
ɑlɯʤɯlArH	ɑlɯʤɯlɑri	ɑlɯʤɯlɑrɯ
ɑlmAmAH	ɑlmɑmɑi	ɑlmɑmɑɯ
ɑnɑjɑsɑH	ɑnɑjɑsɑi	ɑnɑjɑsɑɯ
ɑnlɑjɯʃmHz	ɑnlɑjɯʃmiz	ɑnlɑjɯʃmɯz
ɑnlɑHp	ɑnlɑip	ɑnlɑɯp
ɑrɑplArHn	ɑrɑplɑrin	ɑrɑplɑrɯn
ɑsɯllArH	ɑsɯllɑri	ɑsɯllɑrɯ
bɑʃkɑnlHkʧA	bɑʃkɑnlikʧɑ	bɑʃkɑnlɯkʧɑ
bɑkɑnlArHn	bɑkɑnlɑrin	bɑkɑnlɑrɯn
bɑsDAn	bɑsdɑn	bɑstɑn
bozuklHklArHHn	bozukliklɑriin	bozukluklɑrɯɯn
bulunmAmADA	bulunmɑmɑdɑ	bulunmɑmɑtɑ
dønyʃymHn	dønyʃymin	dønyʃymyn
dørtlH	dørtli	dørtly
dɑrɑlmAH	dɑrɑlmɑi	dɑrɑlmɑɯ
etkilAmADA	etkilemede	etkilemete
fermɑntɑsjonHn	fermɑntɑsjonin	fermɑntɑsjonun
futbolH	futboli	futbolu
gøkDA	gøkde	gøkte
gyzergɑhH	gyzergɑhi	gyzergɑhɯ
globɑllAʃAn	globɑllɑʃɑn	globɑlleʃen
hɑlkɑlH	hɑlkɑli	hɑlkɑlɯ
hɑstɑlɯksHz	hɑstɑlɯksiz	hɑstɑlɯksɯz
hɑzɯrlɯksHz	hɑzɯrlɯksiz	hɑzɯrlɯksɯz
husulA	husulɑ	husule
iddiɑlArHn	iddiɑlɑrin	iddiɑlɑrɯn
ikɑmetgɑhH	ikɑmetgɑhi	ikɑmetgɑhɯ
istisnɑH	istisnɑi	istisnɑɯ
kɯlɑvuzlArH	kɯlɑvuzlɑri	kɯlɑvuzlɑrɯ
kɑfɑmH	kɑfɑmi	kɑfɑmɯ
kɑlHʃ	kɑliʃ	kɑlɯʃ
kɑmpʧHlHk	kɑmpʧilik	kɑmpʧɯlɯk
kɑpɯlH	kɑpɯli	kɑpɯlɯ
kɑvgɑlArH	kɑvgɑlɑri	kɑvgɑlɑrɯ
kɑjɑHn	kɑjɑin	kɑjɑɯn
kɑjnɑkDA	kɑjnɑkdɑ	kɑjnɑktɑ
kontenʒɑnH	kontenʒɑni	kontenʒɑnɯ
kopHp	kopip	kopup
kopjɑlAnmAH	kopjɑlɑnmɑi	kopjɑlɑnmɑɯ
kurmAHn	kurmɑin	kurmɑɯn
mɑɑʃlArH	mɑɑʃlɑri	mɑɑʃlɑrɯ
okullArmHzHn	okullɑrmizin	okullɑrmɯzɯn
ojunHHn	ojuniin	ojunuun
puɑnlArHHn	puɑnlɑriin	puɑnlɑrɯɯn
reɑksijonlArHn	reɑksijonlɑrin	reɑksijonlɑrɯn
søjlemADAn	søjlemeden	søjlemeten
sorumlulHklArHHn	sorumluliklɑriin	sorumluluklɑrɯɯn
tɑʃlH	tɑʃli	tɑʃlɯ
tɑnrɯʧɑH	tɑnrɯʧɑi	tɑnrɯʧɑɯ
tɑrɑfnHzDAn	tɑrɑfnizdɑn	tɑrɑfnɯzdɑn
tɑsɑrɯH	tɑsɑrɯi	tɑsɑrɯɯ
tɑtbikɑtH	tɑtbikɑti	tɑtbikɑtɯ
telefonnHzDAn	telefonnizden	telefonnuzdɑn
tonlArH	tonlɑri	tonlɑrɯ
toplɑDHklArH	toplɑdiklɑri	toplɑdɯklɑrɯ
tozlArH	tozlɑri	tozlɑrɯ
ustɑlArHn	ustɑlɑrin	ustɑlɑrɯn
ujkuH	ujkui	ujkuu
jɑʃɑmmHzDA	jɑʃɑmmizde	jɑʃɑmmɯzdɑ
jɑkɑlɑHp	jɑkɑlɑip	jɑkɑlɑɯp
jɑsɑlArHHn	jɑsɑlɑriin	jɑsɑlɑrɯɯn
jɑtɑklArHn	jɑtɑklɑrin	jɑtɑklɑrɯn
zɑrɑrlArHHn	zɑrɑrlɑriin	zɑrɑrlɑrɯɯn
zorlHklArHn	zorliklɑrin	zorluklɑrɯn
ʧɯktɯlArH	ʧɯktɯlɑri	ʧɯktɯlɑrɯ
ʧøkHʃH	ʧøkiʃi	ʧøkyʃy
ʧɑlɯʃɑnlArmHzA	ʧɑlɯʃɑnlɑrmize	ʧɑlɯʃɑnlɑrmɯzɑ
ønHHn	øniin	ønyyn
øzgyrlHkʧH	øzgyrlikʧi	øzgyrlykʧy
ɑʧɯklArHHn	ɑʧɯklɑriin	ɑʧɯklɑrɯɯn
ɑʧɯmHzDAn	ɑʧɯmizden	ɑʧɯmɯzdɑn
ɑɰɑʧlArHHn	ɑɰɑʧlɑriin	ɑɰɑʧlɑrɯɯn
ɑksɑklHklArn	ɑksɑkliklɑrn	ɑksɑklɯklɑrn
ɑrtɯrɯmH	ɑrtɯrɯmi	ɑrtɯrɯmɯ
ɑjɯrHp	ɑjɯrip	ɑjɯrɯp
ɑzɑH	ɑzɑi	ɑzɑɯ
bɑrolArHn	bɑrolɑrin	bɑrolɑrɯn
bɑjrɑklArH	bɑjrɑklɑri	bɑjrɑklɑrɯ
bozuklHklArA	bozukliklɑrɑ	bozukluklɑrɑ
broʃyrH	broʃyri	broʃyry
bulutlH	bulutli	bulutlu
ʤɑmlH	ʤɑmli	ʤɑmlɯ
ʤɑzHn	ʤɑzin	ʤɑzɯn
døkymHn	døkymin	døkymyn
dɑvrɑnHʃlArDAn	dɑvrɑniʃlɑrdɑn	dɑvrɑnɯʃlɑrdɑn
dernekDA	dernekde	dernekte
doɰmAH	doɰmɑi	doɰmɑɯ
dostlArmHz	dostlɑrmiz	dostlɑrmɯz
ekrɑnlH	ekrɑnli	ekrɑnlɯ
fɯrtɯnɑH	fɯrtɯnɑi	fɯrtɯnɑɯ
finɑlA	finɑlɑ	finɑle
fonlArHHn	fonlɑriin	fonlɑrɯɯn
fotoɰrɑfHHn	fotoɰrɑfiin	fotoɰrɑfɯɯn
girmADAn	girmeden	girmeten
gitDHkDAn	gitdikden	gittikten
hɑsɑrlArH	hɑsɑrlɑri	hɑsɑrlɑrɯ
kɯsɯtlAnmAH	kɯsɯtlɑnmɑi	kɯsɯtlɑnmɑɯ
kɑblolArHn	kɑblolɑrin	kɑblolɑrɯn
kɑdɯnlArHHn	kɑdɯnlɑriin	kɑdɯnlɑrɯɯn
kɑdɑrlHk	kɑdɑrlik	kɑdɑrlɯk
kɑtɯlɯmHHn	kɑtɯlɯmiin	kɑtɯlɯmɯɯn
kɑjɑlArHn	kɑjɑlɑrin	kɑjɑlɑrɯn
kentDAki	kentdeki	kentteki
komutlArHn	komutlɑrin	komutlɑrɯn
konuklArH	konuklɑri	konuklɑrɯ
kumɑʃH	kumɑʃi	kumɑʃɯ
kutulArHn	kutulɑrin	kutulɑrɯn
mɑrkɑHHn	mɑrkɑiin	mɑrkɑɯɯn
mɑsɑʒH	mɑsɑʒi	mɑsɑʒɯ
mɑsrɑflArHHn	mɑsrɑflɑriin	mɑsrɑflɑrɯɯn
mɑtemɑtikDA	mɑtemɑtikde	mɑtemɑtikte
mukozɑHn	mukozɑin	mukozɑɯn
olɑnɑklArHn	olɑnɑklɑrin	olɑnɑklɑrɯn
olDHklArHHn	oldiklɑriin	olduklɑrɯɯn
olmAmHzA	olmɑmize	olmɑmɯzɑ
oluʃumlArHn	oluʃumlɑrin	oluʃumlɑrɯn
orgɑnizɑsjonHHn	orgɑnizɑsjoniin	orgɑnizɑsjonuun
pɑrɑgrɑfH	pɑrɑgrɑfi	pɑrɑgrɑfɯ
pɑrlɑHʤH	pɑrlɑiʤi	pɑrlɑɯʤɯ
pilɑvH	pilɑvi	pilɑvɯ
profesørlHk	profesørlik	profesørlyk
protokolHHn	protokoliin	protokolyyn
rɑkɑmlArHHn	rɑkɑmlɑriin	rɑkɑmlɑrɯɯn
rɑndɯmɑnH	rɑndɯmɑni	rɑndɯmɑnɯ
syryʤyH	syryʤyi	syryʤyy
syreʧDAn	syreʧden	syreʧten
sɑhɑlArHn	sɑhɑlɑrin	sɑhɑlɑrɯn
sɑhɑlArHHn	sɑhɑlɑriin	sɑhɑlɑrɯɯn
sɑlonHHn	sɑloniin	sɑlonuun
solH	soli	solu
sorHnʤA	sorinʤɑ	sorunʤɑ
sorunlArmHzH	sorunlɑrmizi	sorunlɑrmɯzɯ
stɑndɑrdHn	stɑndɑrdin	stɑndɑrdɯn
suʧlHlArHn	suʧlilɑrin	suʧlulɑrɯn
tɑhtDAn	tɑhtdɑn	tɑhttɑn
tɑsɑrɯmHHn	tɑsɑrɯmiin	tɑsɑrɯmɯɯn
tɑsɑrrufDA	tɑsɑrrufdɑ	tɑsɑrruftɑ
teʃekkyllH	teʃekkylli	teʃekkylly
tebligɑtH	tebligɑti	tebligɑtɯ
tulumH	tulumi	tulumu
tutɑrlArHn	tutɑrlɑrin	tutɑrlɑrɯn
tutmADA	tutmɑdɑ	tutmɑtɑ
ujmAH	ujmɑi	ujmɑɯ
vɑkɑHn	vɑkɑin	vɑkɑɯn
jɯllArHHn	jɯllɑriin	jɯllɑrɯɯn
jɑʃɑmmHzA	jɑʃɑmmize	jɑʃɑmmɯzɑ
jɑkɑlAnmAH	jɑkɑlɑnmɑi	jɑkɑlɑnmɑɯ
jɑngɯnlArH	jɑngɯnlɑri	jɑngɯnlɑrɯ
jɑrɑlɯHn	jɑrɑlɯin	jɑrɑlɯɯn
jɑrɑlAnmAHn	jɑrɑlɑnmɑin	jɑrɑlɑnmɑɯn
jɑrɑrlAnmAH	jɑrɑrlɑnmɑi	jɑrɑrlɑnmɑɯ
jɑjH	jɑji	jɑjɯ
jɑjlɑH	jɑjlɑi	jɑjlɑɯ
jolluksHz	jolluksiz	jolluksuz
zɑrHHn	zɑriin	zɑrɯɯn
zɑrfHn	zɑrfin	zɑrfɯn
ʧɯkmAlArH	ʧɯkmɑlɑri	ʧɯkmɑlɑrɯ
ʧɑtɯʃmAHn	ʧɑtɯʃmɑin	ʧɑtɯʃmɑɯn
ʧoklHk	ʧoklik	ʧokluk
ʧubuklH	ʧubukli	ʧubuklu
ɯʃɯnH	ɯʃɯni	ɯʃɯnɯ
ʃokH	ʃoki	ʃoku
ʃuurlH	ʃuurli	ʃuurlu
ɑʧɯklɑmAHHn	ɑʧɯklɑmɑiin	ɑʧɯklɑmɑɯɯn
ɑʧlɯkDAn	ɑʧlɯkdɑn	ɑʧlɯktɑn
ɑʃɑɰɯlHk	ɑʃɑɰɯlik	ɑʃɑɰɯlɯk
ɑdɑjHHn	ɑdɑjiin	ɑdɑjɯɯn
ɑksɑmH	ɑksɑmi	ɑksɑmɯ
ɑrɑzilArHHn	ɑrɑzilɑriin	ɑrɑzileriin
ɑrkɑdɑʃlArnHzA	ɑrkɑdɑʃlɑrnize	ɑrkɑdɑʃlɑrnɯzɑ
ɑtɑlArH	ɑtɑlɑri	ɑtɑlɑrɯ
ɑtɑlArmHz	ɑtɑlɑrmiz	ɑtɑlɑrmɯz
bɑʃvurunHzH	bɑʃvurunizi	bɑʃvurunuzu
bɑhɑrHn	bɑhɑrin	bɑhɑrɯn
bɑnkɑmHzA	bɑnkɑmize	bɑnkɑmɯzɑ
bɑrɑʒlArHn	bɑrɑʒlɑrin	bɑrɑʒlɑrɯn
bɑsɯnʧDA	bɑsɯnʧdɑ	bɑsɯnʧtɑ
bulmAnHz	bulmɑniz	bulmɑnɯz
bulunmAHHn	bulunmɑiin	bulunmɑɯɯn
ʤɑmlArHn	ʤɑmlɑrin	ʤɑmlɑrɯn
ʤAr	ʤɑr	ʤer
dyʃHʃlAr	dyʃiʃler	dyʃyʃler
dɑnslArH	dɑnslɑri	dɑnslɑrɯ
demirbɑʃlArHn	demirbɑʃlɑrin	demirbɑʃlɑrɯn
dernekDAn	dernekden	dernekten
frekɑnsDA	frekɑnsdɑ	frekɑnstɑ
hɑlklArHHn	hɑlklɑriin	hɑlklɑrɯɯn
hɑmɑmHn	hɑmɑmin	hɑmɑmɯn
hɑjɑtnHzA	hɑjɑtnize	hɑjɑtnɯzɑ
hɑjɑtlArHHn	hɑjɑtlɑriin	hɑjɑtlɑrɯɯn
hɑjvɑnlArHHn	hɑjvɑnlɑriin	hɑjvɑnlɑrɯɯn
ihtivɑH	ihtivɑi	ihtivɑɯ
inʃɑɑtHHn	inʃɑɑtiin	inʃɑɑtɯɯn
ispɑtH	ispɑti	ispɑtɯ
kyrsyH	kyrsyi	kyrsyy
kɑdɑstroH	kɑdɑstroi	kɑdɑstrou
kɑmerɑH	kɑmerɑi	kɑmerɑɯ
kɑjɯtDA	kɑjɯtdɑ	kɑjɯttɑ
kollArHHn	kollɑriin	kollɑrɯɯn
kullAnHʤHDAn	kullɑniʤidɑn	kullɑnɯʤɯdɑn
kullɑnmAnHzA	kullɑnmɑnize	kullɑnmɑnɯzɑ
kursDA	kursdɑ	kurstɑ
lehDA	lehde	lehte
lezjonlArHn	lezjonlerin	lezjonlɑrɯn
mɑnɑstɯrH	mɑnɑstɯri	mɑnɑstɯrɯ
mesɑʒlArnHzH	mesɑʒlɑrnizi	mesɑʒlɑrnɯzɯ
militɑnlArH	militɑnlɑri	militɑnlɑrɯ
ordulArHHn	ordulɑriin	ordulɑrɯɯn
pɑrklArH	pɑrklɑri	pɑrklɑrɯ
puɑnlArHn	puɑnlɑrin	puɑnlɑrɯn
sɑnɑtʧHlArA	sɑnɑtʧilɑrɑ	sɑnɑtʧɯlɑrɑ
sɑnɑtlArHn	sɑnɑtlɑrin	sɑnɑtlɑrɯn
sɑndɯklArH	sɑndɯklɑri	sɑndɯklɑrɯ
sɑrfijɑtH	sɑrfijɑti	sɑrfijɑtɯ
sɑtHʃlArHHn	sɑtiʃlɑriin	sɑtɯʃlɑrɯɯn
sɑtHʃDA	sɑtiʃdɑ	sɑtɯʃtɑ
sɑtɯʤɯlArHn	sɑtɯʤɯlɑrin	sɑtɯʤɯlɑrɯn
sɑjmɑnH	sɑjmɑni	sɑjmɑnɯ
sigortɑHHn	sigortɑiin	sigortɑɯɯn
sorunlArnHzH	sorunlɑrnizi	sorunlɑrnɯzɯ
tɯkAlH	tɯkɑli	tɯkɑlɯ
tɑʃɯtlArHn	tɑʃɯtlɑrin	tɑʃɯtlɑrɯn
tɑrɯmHHn	tɑrɯmiin	tɑrɯmɯɯn
tɑsɑrɯmlArHn	tɑsɑrɯmlɑrin	tɑsɑrɯmlɑrɯn
tɑslɑkDA	tɑslɑkdɑ	tɑslɑktɑ
torbɑlArH	torbɑlɑri	torbɑlɑrɯ
ujHp	ujip	ujup
virysHHn	virysiin	virysyyn
jɯldɯzHn	jɯldɯzin	jɯldɯzɯn
jɑklɑʃɯmHHn	jɑklɑʃɯmiin	jɑklɑʃɯmɯɯn
jɑnɯtlArHn	jɑnɯtlɑrin	jɑnɯtlɑrɯn
jɑpmAksHzHn	jɑpmɑksizin	jɑpmɑksɯzɯn
jɑrgɯlAmAnHn	jɑrgɯlɑmɑnin	jɑrgɯlɑmɑnɯn
jolmHzA	jolmize	jolmuzɑ
ʧøzynyrlyklH	ʧøzynyrlykli	ʧøzynyrlykly
ʧɑjHn	ʧɑjin	ʧɑjɯn
ølʧekDAki	ølʧekdeki	ølʧekteki
ʃɑrkɯH	ʃɑrkɯi	ʃɑrkɯɯ
ʃemɑlArH	ʃemɑlɑri	ʃemɑlɑrɯ
ɑɰrɯHHn	ɑɰrɯiin	ɑɰrɯɯɯn
ɑʃHp	ɑʃip	ɑʃɯp
ɑʃɯHHn	ɑʃɯiin	ɑʃɯɯɯn
ɑʃɑɰɯlAHʤH	ɑʃɑɰɯlɑiʤi	ɑʃɑɰɯlɑɯʤɯ
ɑʃɑmɑH	ɑʃɑmɑi	ɑʃɑmɑɯ
ɑlɑʤɑklArHn	ɑlɑʤɑklɑrin	ɑlɑʤɑklɑrɯn
ɑltlHk	ɑltlik	ɑltlɯk
ɑnimɑsjonH	ɑnimɑsjoni	ɑnimɑsjonu
ɑrɑDHklArH	ɑrɑdiklɑri	ɑrɑdɯklɑrɯ
ɑvukɑtlArHHn	ɑvukɑtlɑriin	ɑvukɑtlɑrɯɯn
byroHn	byroin	byroun
bɑɰɯʃDA	bɑɰɯʃdɑ	bɑɰɯʃtɑ
bɑkmAH	bɑkmɑi	bɑkmɑɯ
boʃluklArHn	boʃluklɑrin	boʃluklɑrɯn
bunɑlɯmH	bunɑlɯmi	bunɑlɯmɯ
ʤevɑplAmAnHzDAn	ʤevɑplɑmɑnizden	ʤevɑplɑmɑnɯzdɑn
ʤevɑplArHn	ʤevɑplɑrin	ʤevɑplɑrɯn
dɑlHp	dɑlip	dɑlɯp
dokuH	dokui	dokuu
duruʃmɑH	duruʃmɑi	duruʃmɑɯ
dujgulArmH	dujgulɑrmi	dujgulɑrmɯ
dujgulArHHn	dujgulɑriin	dujgulɑrɯɯn
erkekDA	erkekde	erkekte
fɯrɯnH	fɯrɯni	fɯrɯnɯ
filoH	filoi	filou
finɑlDA	finɑldɑ	finɑlde
fotoɰrɑfʧHlArH	fotoɰrɑfʧilɑri	fotoɰrɑfʧɯlɑrɯ
fotoɰrɑfʧHlArHn	fotoɰrɑfʧilɑrin	fotoɰrɑfʧɯlɑrɯn
geʧirmADA	geʧirmede	geʧirmete
hɑritɑHHn	hɑritɑiin	hɑritɑɯɯn
hesɑplAmADA	hesɑplɑmɑde	hesɑplɑmɑdɑ
iʃgɑlA	iʃgɑlɑ	iʃgɑle
inɑtʧH	inɑtʧi	inɑtʧɯ
kɯsɑsH	kɯsɑsi	kɯsɑsɯ
kɯjɯH	kɯjɯi	kɯjɯɯ
kɑmpHn	kɑmpin	kɑmpɯn
kɑrɯʃɯklHklAr	kɑrɯʃɯkliklɑr	kɑrɯʃɯklɯklɑr
kɑrɑrgɑhH	kɑrɑrgɑhi	kɑrɑrgɑhɯ
kɑsɑH	kɑsɑi	kɑsɑɯ
kɑtɑloglArH	kɑtɑloglɑri	kɑtɑloglɑrɯ
komutHHn	komutiin	komutuun
mɑmullAr	mɑmullɑr	mɑmuller
mɑsɑlH	mɑsɑli	mɑsɑlɯ
merɑkH	merɑki	merɑkɯ
mesɑʒnHz	mesɑʒniz	mesɑʒnɯz
okulmHzA	okulmize	okulmuzɑ
okuHnʤA	okuinʤɑ	okuunʤɑ
ormɑnlArHHn	ormɑnlɑriin	ormɑnlɑrɯɯn
otobysHn	otobysin	otobysyn
oturmAH	oturmɑi	oturmɑɯ
pɑrklArHn	pɑrklɑrin	pɑrklɑrɯn
pɑjlɑʃɯmlH	pɑjlɑʃɯmli	pɑjlɑʃɯmlɯ
pijɑsɑH	pijɑsɑi	pijɑsɑɯ
pompɑlH	pompɑli	pompɑlɯ
pompɑlArH	pompɑlɑri	pompɑlɑrɯ
portɑlH	portɑli	portɑlɯ
progrɑmlAnmAH	progrɑmlɑnmɑi	progrɑmlɑnmɑɯ
sɑhɑH	sɑhɑi	sɑhɑɯ
sɑnɑtkɑrlArHn	sɑnɑtkɑrlɑrin	sɑnɑtkɑrlɑrɯn
sigortɑlHlArHn	sigortɑlilɑrin	sigortɑlɯlɑrɯn
soɰɑnH	soɰɑni	soɰɑnɯ
sorumluHHn	sorumluiin	sorumluuun
sojɑdnHz	sojɑdniz	sojɑdnɯz
suʧlHlArH	suʧlilɑri	suʧlulɑrɯ
tɑʃHHn	tɑʃiin	tɑʃɯɯn
tɑʃɯtlArH	tɑʃɯtlɑri	tɑʃɯtlɑrɯ
tɑnɯAlHm	tɑnɯɑlim	tɑnɯɑlɯm
tɑrɑftɑrlArH	tɑrɑftɑrlɑri	tɑrɑftɑrlɑrɯ
teʧhizɑtH	teʧhizɑti	teʧhizɑtɯ
teʃkilɑtmHz	teʃkilɑtmiz	teʃkilɑtmɯz
testDA	testde	testte
toplumlArHHn	toplumlɑriin	toplumlɑrɯɯn
uɰrɑDHklArH	uɰrɑdiklɑri	uɰrɑdɯklɑrɯ
unsurHHn	unsuriin	unsuruun
vyʤutlArH	vyʤutlɑri	vyʤutlɑrɯ
vizjonA	vizjone	vizjonɑ
jɑvruH	jɑvrui	jɑvruu
jɑjgɯnlHk	jɑjgɯnlik	jɑjgɯnlɯk
jumurtɑlArHn	jumurtɑlɑrin	jumurtɑlɑrɯn
zɑmɑnnHzH	zɑmɑnnizi	zɑmɑnnɯzɯ
zɑtHn	zɑtin	zɑtɯn
zɑjɯflHk	zɑjɯflik	zɑjɯflɯk
ʧɯɰlɯklArH	ʧɯɰlɯklɑri	ʧɯɰlɯklɑrɯ
ʧɑɰmHz	ʧɑɰmiz	ʧɑɰmɯz
ɑdlArHn	ɑdlɑrin	ɑdlɑrɯn
ɑmʤɑH	ɑmʤɑi	ɑmʤɑɯ
ɑnɑhtɑrlArH	ɑnɑhtɑrlɑri	ɑnɑhtɑrlɑrɯ
ɑrɑʃtɯrHp	ɑrɑʃtɯrip	ɑrɑʃtɯrɯp
ɑrɑlArH	ɑrɑlɑri	ɑrɑlɑrɯ
ɑrɑmAlArHn	ɑrɑmɑlɑrin	ɑrɑmɑlɑrɯn
ɑrɑmAnHz	ɑrɑmɑniz	ɑrɑmɑnɯz
ɑjrɯlɯklArH	ɑjrɯlɯklɑri	ɑjrɯlɯklɑrɯ
bɑbɑlArHHn	bɑbɑlɑriin	bɑbɑlɑrɯɯn
bɑsɑmɑkDAn	bɑsɑmɑkdɑn	bɑsɑmɑktɑn
bɑtɯH	bɑtɯi	bɑtɯɯ
døngyHn	døngyin	døngyyn
dɑlgɑHn	dɑlgɑin	dɑlgɑɯn
deDHkDAn	dedikden	dedikten
diplomɑlArH	diplomɑlɑri	diplomɑlɑrɯ
doktornHzHn	doktornizin	doktornuzun
dokulH	dokuli	dokulu
donɑnɯmHn	donɑnɯmin	donɑnɯmɯn
fɑbrikɑmHzDA	fɑbrikɑmizde	fɑbrikɑmɯzdɑ
fɑktørHn	fɑktørin	fɑktøryn
filozofH	filozofi	filozofu
fosforlH	fosforli	fosforlu
frekɑnslArH	frekɑnslɑri	frekɑnslɑrɯ
gɯdɑHn	gɯdɑin	gɯdɑɯn
gøzmHn	gøzmin	gøzmyn
gitmADAn	gitmeden	gitmeten
hɯzHn	hɯzin	hɯzɯn
hɑvɑlArHn	hɑvɑlɑrin	hɑvɑlɑrɯn
hɑjɑtnHzHn	hɑjɑtnizin	hɑjɑtnɯzɯn
hɑzɯrlAmAH	hɑzɯrlɑmɑi	hɑzɯrlɑmɑɯ
hiʧDA	hiʧde	hiʧte
iktidɑrHHn	iktidɑriin	iktidɑrɯɯn
kyltyrmHz	kyltyrmiz	kyltyrmyz
kɑnunsHz	kɑnunsiz	kɑnunsuz
kɑrʃɯlɑmAH	kɑrʃɯlɑmɑi	kɑrʃɯlɑmɑɯ
komisjonmHz	komisjonmiz	komisjonmuz
komplikɑsjonlArHn	komplikɑsjonlɑrin	komplikɑsjonlɑrɯn
komutHn	komutin	komutun
kuʃɑklArHn	kuʃɑklɑrin	kuʃɑklɑrɯn
kujrukDA	kujrukdɑ	kujruktɑ
mɑɰɑzɑlArHn	mɑɰɑzɑlɑrin	mɑɰɑzɑlɑrɯn
mɑkɑmHHn	mɑkɑmiin	mɑkɑmɯɯn
numɑrɑHn	numɑrɑin	numɑrɑɯn
obstryksijonH	obstryksijoni	obstryksijonu
odɑmHzH	odɑmizi	odɑmɯzɯ
olguH	olgui	olguu
ortɑklH	ortɑkli	ortɑklɯ
ojnɑmAH	ojnɑmɑi	ojnɑmɑɯ
pyryzlH	pyryzli	pyryzly
pɑrʧɑʤɯklArH	pɑrʧɑʤɯklɑri	pɑrʧɑʤɯklɑrɯ
ruhsɑtHn	ruhsɑtin	ruhsɑtɯn
sɯnɯrlAHʤH	sɯnɯrlɑiʤi	sɯnɯrlɑɯʤɯ
søzlykDA	søzlykde	søzlykte
sɑplH	sɑpli	sɑplɯ
sɑtɯrlHk	sɑtɯrlik	sɑtɯrlɯk
senɑtoHHn	senɑtoiin	senɑtouun
sijɑsetDAn	sijɑsetden	sijɑsetten
sokɑklArHn	sokɑklɑrin	sokɑklɑrɯn
sorumlHlAr	sorumlilɑr	sorumlulɑr
sunmAHn	sunmɑin	sunmɑɯn
sunuʤuHHn	sunuʤuiin	sunuʤuuun
tɑʃɯnmɑzH	tɑʃɯnmɑzi	tɑʃɯnmɑzɯ
tɑɑrruzH	tɑɑrruzi	tɑɑrruzu
tɑburH	tɑburi	tɑburu
tɑlɑʃlH	tɑlɑʃli	tɑlɑʃlɯ
tɑnɯHp	tɑnɯip	tɑnɯɯp
tɑnrɯlArHn	tɑnrɯlɑrin	tɑnrɯlɑrɯn
tɑvukʧHlHk	tɑvukʧilik	tɑvukʧuluk
uʧHp	uʧip	uʧup
ulɑʃmAlArH	ulɑʃmɑlɑri	ulɑʃmɑlɑrɯ
jykseklHkDAki	jykseklikdeki	jykseklikteki
jɑʃɑmnHzH	jɑʃɑmnizi	jɑʃɑmnɯzɯ
jɑkɯtH	jɑkɯti	jɑkɯtɯ
jɑrgɯH	jɑrgɯi	jɑrgɯɯ
jɑsɑklArH	jɑsɑklɑri	jɑsɑklɑrɯ
jɑjɯlHʃ	jɑjɯliʃ	jɑjɯlɯʃ
jolsuzlHklAr	jolsuzliklɑr	jolsuzluklɑr
jumurtɑH	jumurtɑi	jumurtɑɯ
zorunlulHklAr	zorunluliklɑr	zorunluluklɑr
ʧɯkɑrDHklArH	ʧɯkɑrdiklɑri	ʧɯkɑrdɯklɑrɯ
ʧɯkmAmAH	ʧɯkmɑmɑi	ʧɯkmɑmɑɯ
ʧɯkmAHHn	ʧɯkmɑiin	ʧɯkmɑɯɯn
ʧɑmɑʃɯrlArH	ʧɑmɑʃɯrlɑri	ʧɑmɑʃɯrlɑrɯ
ʧɑrlHk	ʧɑrlik	ʧɑrlɯk
ɑʃɯlAnmAH	ɑʃɯlɑnmɑi	ɑʃɯlɑnmɑɯ
ɑʤɯlArHn	ɑʤɯlɑrin	ɑʤɯlɑrɯn
ɑdɑptɑsjonH	ɑdɑptɑsjoni	ɑdɑptɑsjonu
ɑʒɑnH	ɑʒɑni	ɑʒɑnɯ
ɑlɑrmH	ɑlɑrmi	ɑlɑrmɯ
ɑrɑbɑlArHn	ɑrɑbɑlɑrin	ɑrɑbɑlɑrɯn
ɑrɑʤɯnHz	ɑrɑʤɯniz	ɑrɑʤɯnɯz
ɑtlɑHp	ɑtlɑip	ɑtlɑɯp
ɑjgɯtlArH	ɑjgɯtlɑri	ɑjgɯtlɑrɯ
byjymADA	byjymede	byjymete
bɑʃlɑmADA	bɑʃlɑmɑdɑ	bɑʃlɑmɑtɑ
bɑʃlɑmAlArH	bɑʃlɑmɑlɑri	bɑʃlɑmɑlɑrɯ
bɑkmAH	bɑkmɑi	bɑkmɑɯ
bɑlɯklH	bɑlɯkli	bɑlɯklɯ
bɑromHz	bɑromiz	bɑromuz
boɰHʤH	boɰiʤi	boɰuʤu
bulunmAlArnH	bulunmɑlɑrni	bulunmɑlɑrnɯ
dɑɰɯlmAH	dɑɰɯlmɑi	dɑɰɯlmɑɯ
demirbɑʃHn	demirbɑʃin	demirbɑʃɯn
dinlenDHkDAn	dinlendikden	dinlendikten
dolɑplArH	dolɑplɑri	dolɑplɑrɯ
edebijɑtHn	edebijɑtin	edebijɑtɯn
ekrɑnlArH	ekrɑnlɑri	ekrɑnlɑrɯ
enfeksijonlArHn	enfeksijonlerin	enfeksijonlɑrɯn
fermɑnH	fermɑni	fermɑnɯ
formylHn	formylin	formylyn
gyneʃDA	gyneʃde	gyneʃte
hɑlmA	hɑlmɑ	hɑlme
ithɑlɑtHn	ithɑlɑtin	ithɑlɑtɯn
kɯsɯmlArHn	kɯsɯmlɑrin	kɯsɯmlɑrɯn
kɯskɑnʧlHk	kɯskɑnʧlik	kɯskɑnʧlɯk
køpyklH	køpykli	køpykly
kɑinɑtHn	kɑinɑtin	kɑinɑtɯn
kɑpɑklArHn	kɑpɑklɑrin	kɑpɑklɑrɯn
kɑjɯtDAn	kɑjɯtdɑn	kɑjɯttɑn
kɑzɑnlArH	kɑzɑnlɑri	kɑzɑnlɑrɯ
koltukDA	koltukdɑ	koltuktɑ
komplikɑsjonH	komplikɑsjoni	komplikɑsjonu
kortH	korti	kortu
kristɑllArH	kristɑllɑri	kristɑlleri
kulH	kuli	kulu
kumHn	kumin	kumun
mylkH	mylki	mylky
mɑʧDAn	mɑʧdɑn	mɑʧtɑn
mɑmulHn	mɑmulin	mɑmulyn
mevzuH	mevzui	mevzuu
molekylH	molekyli	molekyly
odunH	oduni	odunu
omurgɑHn	omurgɑin	omurgɑɯn
ordumHzHn	ordumizin	ordumuzun
pɑketDA	pɑketde	pɑkette
pɑsɑportH	pɑsɑporti	pɑsɑportu
progrɑmmHzHn	progrɑmmizin	progrɑmmɯzɯn
rɑhɑtsHzlHklArH	rɑhɑtsizlikleri	rɑhɑtsɯzlɯklɑrɯ
rezervɑsjonH	rezervɑsjoni	rezervɑsjonu
rotɑH	rotɑi	rotɑɯ
søzmHz	søzmiz	søzmyz
sekreterjɑH	sekreterjɑi	sekreterjɑɯ
sensørH	sensøri	sensøry
sejɑhɑtA	sejɑhɑtɑ	sejɑhɑte
sezonHn	sezonin	sezonun
soɰɑnlArH	soɰɑnlɑri	soɰɑnlɑrɯ
sonHHn	soniin	sonuun
sorulArmHzH	sorulɑrmizi	sorulɑrmɯzɯ
sporHHn	sporiin	sporuun
stɑtyHHn	stɑtyiin	stɑtyyyn
subɑjH	subɑji	subɑjɯ
tɑnsijonHn	tɑnsijonin	tɑnsijonun
televizjonA	televizjone	televizjonɑ
tijɑtroH	tijɑtroi	tijɑtrou
tonHn	tonin	tonun
trɑvmɑHn	trɑvmɑin	trɑvmɑɯn
tutɑrlArHHn	tutɑrlɑriin	tutɑrlɑrɯɯn
tutulmɑlH	tutulmɑli	tutulmɑlɯ
tutumHn	tutumin	tutumun
uʧHʃH	uʧiʃi	uʧuʃu
uɰrɑHp	uɰrɑip	uɰrɑɯp
ujdulArH	ujdulɑri	ujdulɑrɯ
jɑʃɑmmHzHn	jɑʃɑmmizin	jɑʃɑmmɯzɯn
jɑpɯtHn	jɑpɯtin	jɑpɯtɯn
jɑrɑrlAnmAlArH	jɑrɑrlɑnmɑlɑri	jɑrɑrlɑnmɑlɑrɯ
jɑsɑklH	jɑsɑkli	jɑsɑklɯ
jɑzmADAn	jɑzmɑdɑn	jɑzmɑtɑn
zɑmɑnmHz	zɑmɑnmiz	zɑmɑnmɯz
ʧɯkHʃHHn	ʧɯkiʃiin	ʧɯkɯʃɯɯn
ʧɯkɑrmɑHn	ʧɯkɑrmɑin	ʧɯkɑrmɑɯn
ʧɯkmAHn	ʧɯkmɑin	ʧɯkmɑɯn
ørtyHn	ørtyin	ørtyyn
ʃɑmpijonlHk	ʃɑmpijonlik	ʃɑmpijonluk
ɑʃɑmɑHHn	ɑʃɑmɑiin	ɑʃɑmɑɯɯn
ɑhlɑkHn	ɑhlɑkin	ɑhlɑkɯn
ɑkɯmlArHn	ɑkɯmlɑrin	ɑkɯmlɑrɯn
ɑnimɑsjonlArH	ɑnimɑsjonlɑri	ɑnimɑsjonlɑrɯ
ɑntikorlArH	ɑntikorlɑri	ɑntikorlɑrɯ
ɑrɯtɯmH	ɑrɯtɯmi	ɑrɯtɯmɯ
ɑrɑʃtɯrmɑlArHHn	ɑrɑʃtɯrmɑlɑriin	ɑrɑʃtɯrmɑlɑrɯɯn
ɑtDHklArH	ɑtdiklɑri	ɑttɯklɑrɯ
ɑjdɯnlɑtmAH	ɑjdɯnlɑtmɑi	ɑjdɯnlɑtmɑɯ
ɑjnɑH	ɑjnɑi	ɑjnɑɯ
byjyklHklAr	byjyklikler	byjyklykler
bɑkɑnlɯkDA	bɑkɑnlɯkdɑ	bɑkɑnlɯktɑ
bejɑnlArH	bejɑnlɑri	bejɑnlɑrɯ
bilgisɑjɑrnHzDAki	bilgisɑjɑrnizdɑki	bilgisɑjɑrnɯzdɑki
bloklArHn	bloklɑrin	bloklɑrɯn
borulArHn	borulɑrin	borulɑrɯn
brɑnʃH	brɑnʃi	brɑnʃɯ
bulmAlArH	bulmɑlɑri	bulmɑlɑrɯ
bulHnʤA	bulinʤɑ	bulunʤɑ
butonlArH	butonlɑri	butonlɑrɯ
ʤevɑpDA	ʤevɑpdɑ	ʤevɑptɑ
dyʃHʃA	dyʃiʃe	dyʃyʃe
delikDAn	delikden	delikten
demirjoluHn	demirjoluin	demirjoluun
dujulArH	dujulɑri	dujulɑrɯ
dujHp	dujip	dujup
eʃjɑlArHHn	eʃjɑlɑriin	eʃjɑlɑrɯɯn
esnɑfHHn	esnɑfiin	esnɑfɯɯn
fɯrsɑtDAn	fɯrsɑtdɑn	fɯrsɑttɑn
hɑkikɑtA	hɑkikɑtɑ	hɑkikɑte
hɑriʧDAn	hɑriʧdɑn	hɑriʧten
hɑstɑmHzHn	hɑstɑmizin	hɑstɑmɯzɯn
huzurnHzDA	huzurnizdɑ	huzurnuzdɑ
imtijɑzlH	imtijɑzli	imtijɑzlɯ
inɑnʧlH	inɑnʧli	inɑnʧlɯ
køʃkH	køʃki	køʃky
kɑlɯntɯH	kɑlɯntɯi	kɑlɯntɯɯ
kɑlɑnlArH	kɑlɑnlɑri	kɑlɑnlɑrɯ
kɑlmADAn	kɑlmɑdɑn	kɑlmɑtɑn
kɑmjonHn	kɑmjonin	kɑmjonun
kɑplɯʤɑH	kɑplɯʤɑi	kɑplɯʤɑɯ
kɑrɑmsɑrlHk	kɑrɑmsɑrlik	kɑrɑmsɑrlɯk
kɑrmɑʃɑH	kɑrmɑʃɑi	kɑrmɑʃɑɯ
kɑsHHn	kɑsiin	kɑsɯɯn
kɑzɑH	kɑzɑi	kɑzɑɯ
kirɑlAnmAH	kirɑlɑnmɑi	kirɑlɑnmɑɯ
koʃHp	koʃip	koʃup
korumɑlArH	korumɑlɑri	korumɑlɑrɯ
kojDHklArH	kojdiklɑri	kojduklɑrɯ
kuʃHn	kuʃin	kuʃun
kurtulmAHn	kurtulmɑin	kurtulmɑɯn
mɑɰɑrɑlArH	mɑɰɑrɑlɑri	mɑɰɑrɑlɑrɯ
mɑɰdurlArHn	mɑɰdurlɑrin	mɑɰdurlɑrɯn
mɑʤunH	mɑʤuni	mɑʤunu
mɑlHHn	mɑliin	mɑlɯɯn
mɑsɑlArH	mɑsɑlɑri	mɑsɑlɑrɯ
mikroplArHn	mikroplɑrin	mikroplɑrɯn
mukozɑH	mukozɑi	mukozɑɯ
olɑsɯlHklArH	olɑsɯliklɑri	olɑsɯlɯklɑrɯ
olumsuzlHklArn	olumsuzliklɑrn	olumsuzluklɑrn
orgɑnizmɑlArHn	orgɑnizmɑlɑrin	orgɑnizmɑlɑrɯn
ortɑklɯklArHn	ortɑklɯklɑrin	ortɑklɯklɑrɯn
plɑtformHHn	plɑtformiin	plɑtformuun
progrɑmmHzDA	progrɑmmizde	progrɑmmɯzdɑ
referɑnslArH	referɑnslɑri	referɑnslɑrɯ
reklɑmlArH	reklɑmlɑri	reklɑmlɑrɯ
ruhsɑtHHn	ruhsɑtiin	ruhsɑtɯɯn
sɯnɯflAmAH	sɯnɯflɑmɑi	sɯnɯflɑmɑɯ
sɑɰdujulH	sɑɰdujuli	sɑɰdujulu
sɑfhɑlArH	sɑfhɑlɑri	sɑfhɑlɑrɯ
sɑnɑtDAn	sɑnɑtdɑn	sɑnɑttɑn
sɑtHʃDAn	sɑtiʃdɑn	sɑtɯʃtɑn
sɑvunmAH	sɑvunmɑi	sɑvunmɑɯ
sɑjfɑmHzH	sɑjfɑmizi	sɑjfɑmɯzɯ
sɑjfɑnHzH	sɑjfɑnizi	sɑjfɑnɯzɯ
sektørmHz	sektørmiz	sektørmyz
sigortɑH	sigortɑi	sigortɑɯ
sorumluluklArHn	sorumluluklɑrin	sorumluluklɑrɯn
suʧsHz	suʧsiz	suʧsuz
tɑʃlHk	tɑʃlik	tɑʃlɯk
tɑtsHz	tɑtsiz	tɑtsɯz
teknikDA	teknikde	teknikte
tijɑtroHHn	tijɑtroiin	tijɑtrouun
toplAHʤH	toplɑiʤi	toplɑɯʤɯ
tutɑrsHz	tutɑrsiz	tutɑrsɯz
ulɑʃmAlArnH	ulɑʃmɑlɑrni	ulɑʃmɑlɑrnɯ
ulɑʃmAnHz	ulɑʃmɑniz	ulɑʃmɑnɯz
usulsHz	usulsiz	usulsyz
uzɑtHp	uzɑtip	uzɑtɯp
vurHp	vurip	vurup
jyksekokullArHn	jyksekokullɑrin	jyksekokullɑrɯn
jɑkHʃ	jɑkiʃ	jɑkɯʃ
jɑndɑʃlArH	jɑndɑʃlɑri	jɑndɑʃlɑrɯ
jɑnlɯʃlArHn	jɑnlɯʃlɑrin	jɑnlɯʃlɑrɯn
jolʤuHn	jolʤuin	jolʤuun
ʧoʤuklArnHzH	ʧoʤuklɑrnizi	ʧoʤuklɑrnɯzɯ
ʧoʤuklHkDAn	ʧoʤuklikdɑn	ʧoʤukluktɑn
øjkyH	øjkyi	øjkyy
ʃɑnsHHn	ʃɑnsiin	ʃɑnsɯɯn
ɑʧDHkDAn	ɑʧdikdɑn	ɑʧtɯktɑn
ɑkɑrsulArHn	ɑkɑrsulɑrin	ɑkɑrsulɑrɯn
ɑlɯʃveriʃDA	ɑlɯʃveriʃde	ɑlɯʃveriʃte
ɑlkolsHz	ɑlkolsiz	ɑlkolsyz
ɑnlɑmAH	ɑnlɑmɑi	ɑnlɑmɑɯ
ɑnnelArA	ɑnnelɑrɑ	ɑnnelere
ɑpɑrtmɑnHn	ɑpɑrtmɑnin	ɑpɑrtmɑnɯn
ɑrɑmɑHn	ɑrɑmɑin	ɑrɑmɑɯn
ɑjɑkkɑbɯlArH	ɑjɑkkɑbɯlɑri	ɑjɑkkɑbɯlɑrɯ
bɑʃDAki	bɑʃdɑki	bɑʃtɑki
bɑrɑʒlArH	bɑrɑʒlɑri	bɑrɑʒlɑrɯ
bombɑlH	bombɑli	bombɑlɯ
bulmɑHn	bulmɑin	bulmɑɯn
bulunDHkDAn	bulundikdɑn	bulunduktɑn
bulundurmAH	bulundurmɑi	bulundurmɑɯ
ʤoʃkuH	ʤoʃkui	ʤoʃkuu
dɑɰɯtHʤHH	dɑɰɯtiʤii	dɑɰɯtɯʤɯɯ
dɑmɑrlArHHn	dɑmɑrlɑriin	dɑmɑrlɑrɯɯn
dɑmlɑH	dɑmlɑi	dɑmlɑɯ
dɑrlHk	dɑrlik	dɑrlɯk
depolArHHn	depoleriin	depolɑrɯɯn
doɰrultuH	doɰrultui	doɰrultuu
dokulArHHn	dokulɑriin	dokulɑrɯɯn
dokumɑʤɯlHk	dokumɑʤɯlik	dokumɑʤɯlɯk
durumnHz	durumniz	durumnuz
enstitymHzDA	enstitymizde	enstitymyzde
esɑslArHn	esɑslerin	esɑslɑrɯn
fɑbrikɑmHz	fɑbrikɑmiz	fɑbrikɑmɯz
gøzmHz	gøzmiz	gøzmyz
hɑlkʧH	hɑlkʧi	hɑlkʧɯ
hɑllArHn	hɑllɑrin	hɑllerin
hɑvɑsHz	hɑvɑsiz	hɑvɑsɯz
herkesDA	herkesde	herkeste
ihtijɑʧDAn	ihtijɑʧdɑn	ihtijɑʧtɑn
imzɑlAmHʃ	imzɑlɑmiʃ	imzɑlɑmɯʃ
inʤeleDHkDAn	inʤeledikden	inʤeledikten
itirɑzHn	itirɑzin	itirɑzɯn
kɑplAnmAH	kɑplɑnmɑi	kɑplɑnmɑɯ
kɑplArHn	kɑplɑrin	kɑplɑrɯn
kɑpsɑmAH	kɑpsɑmɑi	kɑpsɑmɑɯ
kɑptɑnH	kɑptɑni	kɑptɑnɯ
kɑsɑHn	kɑsɑin	kɑsɑɯn
kɑtkɯlH	kɑtkɯli	kɑtkɯlɯ
kɑzɑnmAH	kɑzɑnmɑi	kɑzɑnmɑɯ
kilolH	kiloli	kilolu
konɑklArH	konɑklɑri	konɑklɑrɯ
konumHHn	konumiin	konumuun
koruʤulArHn	koruʤulɑrin	koruʤulɑrɯn
kumɑʃHn	kumɑʃin	kumɑʃɯn
kurʃunlH	kurʃunli	kurʃunlu
kurɑlHn	kurɑlin	kurɑlɯn
mɑɰɑzɑnHn	mɑɰɑzɑnin	mɑɰɑzɑnɯn
meblɑɰH	meblɑɰi	meblɑɰɯ
menfɑɑtlAr	menfɑɑtlɑr	menfɑɑtler
mezunlArmHzHn	mezunlɑrmizin	mezunlɑrmɯzɯn
miktɑrlArHn	miktɑrlɑrin	miktɑrlɑrɯn
nyshɑlArH	nyshɑlɑri	nyshɑlɑrɯ
olimpijɑtlArH	olimpijɑtlɑri	olimpijɑtlɑrɯ
olHʃHHn	oliʃiin	oluʃuun
orɑnlArHn	orɑnlɑrin	orɑnlɑrɯn
ovɑlHk	ovɑlik	ovɑlɯk
ovɑHn	ovɑin	ovɑɯn
pɑrɑnHzH	pɑrɑnizi	pɑrɑnɯzɯ
plɑʒH	plɑʒi	plɑʒɯ
progrɑmlArmHz	progrɑmlɑrmiz	progrɑmlɑrmɯz
reformHHn	reformiin	reformuun
rekɑbetDAn	rekɑbetden	rekɑbetten
sɯrɑHn	sɯrɑin	sɯrɑɯn
sɑfhɑH	sɑfhɑi	sɑfhɑɯ
sɑkɑllH	sɑkɑlli	sɑkɑllɯ
sɑnɑtʧHA	sɑnɑtʧiɑ	sɑnɑtʧɯɑ
sɑntrɑllArHn	sɑntrɑllɑrin	sɑntrɑllerin
sɑrHp	sɑrip	sɑrɯp
sɑvʤɯlArH	sɑvʤɯlɑri	sɑvʤɯlɑrɯ
sɑvʤɯlArHn	sɑvʤɯlɑrin	sɑvʤɯlɑrɯn
sorunlArmHzHn	sorunlɑrmizin	sorunlɑrmɯzɯn
sunmADAn	sunmɑdɑn	sunmɑtɑn
tɑʃɯHp	tɑʃɯip	tɑʃɯɯp
tɑmɑmlɑnHp	tɑmɑmlɑnip	tɑmɑmlɑnɯp
tɑnɯtɯmlArH	tɑnɯtɯmlɑri	tɑnɯtɯmlɑrɯ
tɑnɯH	tɑnɯi	tɑnɯɯ
tekerryrH	tekerryri	tekerryry
televizjonlArHn	televizjonlerin	televizjonlɑrɯn
tiʤɑretDAki	tiʤɑretdeki	tiʤɑretteki
tuzHn	tuzin	tuzun
uʧlArHHn	uʧlɑriin	uʧlɑrɯɯn
ufukDA	ufukdɑ	ufuktɑ
vɑrHʃH	vɑriʃi	vɑrɯʃɯ
viryslH	virysli	virysly
jɑʃɑmmHzH	jɑʃɑmmizi	jɑʃɑmmɯzɯ
jɑʃɑmnHzHn	jɑʃɑmnizin	jɑʃɑmnɯzɯn
jɑʃɑmADAn	jɑʃɑmɑdɑn	jɑʃɑmɑtɑn
jɑlɯtɯmlH	jɑlɯtɯmli	jɑlɯtɯmlɯ
jɑnsHz	jɑnsiz	jɑnsɯz
jɑpɯmHz	jɑpɯmiz	jɑpɯmɯz
jɑpmAmAH	jɑpmɑmɑi	jɑpmɑmɑɯ
jɑrɯmɑdɑH	jɑrɯmɑdɑi	jɑrɯmɑdɑɯ
jɑrɑtHp	jɑrɑtip	jɑrɑtɯp
jɑrɑtmADA	jɑrɑtmɑdɑ	jɑrɑtmɑtɑ
jɑzɯmHn	jɑzɯmin	jɑzɯmɯn
jolʤulArH	jolʤulɑri	jolʤulɑrɯ
zɑrɑrlHlArH	zɑrɑrlilɑri	zɑrɑrlɯlɑrɯ
zorH	zori	zoru
ʧɑtlɑklArH	ʧɑtlɑklɑri	ʧɑtlɑklɑrɯ
ɯʃɯkDA	ɯʃɯkdɑ	ɯʃɯktɑ
ʃɑhɯslArH	ʃɑhɯslɑri	ʃɑhɯslɑrɯ
yzymH	yzymi	yzymy
ɑʧɯlɯmH	ɑʧɯlɯmi	ɑʧɯlɯmɯ
ɑdɑlArHn	ɑdɑlɑrin	ɑdɑlɑrɯn
ɑksɑklHk	ɑksɑklik	ɑksɑklɯk
ɑlHnʤAA	ɑlinʤɑɑ	ɑlɯnʤɑɑ
ɑlɯnmAlArH	ɑlɯnmɑlɑri	ɑlɯnmɑlɑrɯ
ɑlɑʃɯmlH	ɑlɑʃɯmli	ɑlɑʃɯmlɯ
ɑmbɑrH	ɑmbɑri	ɑmbɑrɯ
ɑnketDA	ɑnketde	ɑnkette
ɑnlɑtmAH	ɑnlɑtmɑi	ɑnlɑtmɑɯ
ɑnlɑjɯʃlH	ɑnlɑjɯʃli	ɑnlɑjɯʃlɯ
ɑntlɑʃmɑlArH	ɑntlɑʃmɑlɑri	ɑntlɑʃmɑlɑrɯ
ɑntrenørlHk	ɑntrenørlik	ɑntrenørlyk
ɑrɑʃtɯrmɑʤɯlArH	ɑrɑʃtɯrmɑʤɯlɑri	ɑrɑʃtɯrmɑʤɯlɑrɯ
ɑrɑHʃlArA	ɑrɑiʃlɑrɑ	ɑrɑɯʃlɑrɑ
ɑrmutlH	ɑrmutli	ɑrmutlu
ɑtɯmlH	ɑtɯmli	ɑtɯmlɯ
ɑvluHn	ɑvluin	ɑvluun
ɑjɑrlArHn	ɑjɑrlɑrin	ɑjɑrlɑrɯn
ɑjrɯlmɑlArH	ɑjrɯlmɑlɑri	ɑjrɯlmɑlɑrɯ
byroHHn	byroiin	byrouun
bɑɰlArHHn	bɑɰlɑriin	bɑɰlɑrɯɯn
bɑɰlɑHp	bɑɰlɑip	bɑɰlɑɯp
bɑʃlɯklArHHn	bɑʃlɯklɑriin	bɑʃlɯklɑrɯɯn
bɑjrɑmHn	bɑjrɑmin	bɑjrɑmɯn
bɑzɯH	bɑzɯi	bɑzɯɯ
belirlemADA	belirlemede	belirlemete
betonH	betoni	betonu
bulɑntɯH	bulɑntɯi	bulɑntɯɯ
dyʃmɑnlArHn	dyʃmɑnlɑrin	dyʃmɑnlɑrɯn
dɑɰɯtɯmHHn	dɑɰɯtɯmiin	dɑɰɯtɯmɯɯn
dɑlgɑHHn	dɑlgɑiin	dɑlgɑɯɯn
dɑmgɑlH	dɑmgɑli	dɑmgɑlɯ
dɑvrɑnHʃA	dɑvrɑniʃɑ	dɑvrɑnɯʃɑ
dɑjɑnɑklArH	dɑjɑnɑklɑri	dɑjɑnɑklɑrɯ
demADAn	demeden	demeten
depolArHn	depolerin	depolɑrɯn
desteklAmADA	desteklemede	desteklemete
dozlArH	dozlɑri	dozlɑrɯ
editørHn	editørin	editøryn
emisjonH	emisjoni	emisjonu
fɯrsɑtlArHn	fɯrsɑtlɑrin	fɯrsɑtlɑrɯn
fɑrksHz	fɑrksiz	fɑrksɯz
federɑsjonHn	federɑsjonin	federɑsjonun
firmɑnHzA	firmɑnize	firmɑnɯzɑ
fizikDA	fizikde	fizikte
gøzmHzHn	gøzmizin	gøzmyzyn
gɑzHHn	gɑziin	gɑzɯɯn
hɑreketDAn	hɑreketden	hɑreketten
iddiɑlArHHn	iddiɑlɑriin	iddiɑlɑrɯɯn
ihrɑʤɑtmHz	ihrɑʤɑtmiz	ihrɑʤɑtmɯz
ilɑʧDAn	ilɑʧdɑn	ilɑʧtɑn
imkɑnmHz	imkɑnmiz	imkɑnmɯz
istikɑmetDA	istikɑmetde	istikɑmette
istikrɑrsHzlHk	istikrɑrsizlik	istikrɑrsɯzlɯk
izɑhH	izɑhi	izɑhɯ
kɑfɑlArH	kɑfɑlɑri	kɑfɑlɑrɯ
kɑlɯplArHn	kɑlɯplɑrin	kɑlɯplɑrɯn
kɑnunlArHHn	kɑnunlɑriin	kɑnunlɑrɯɯn
kɑpɑklArHHn	kɑpɑklɑriin	kɑpɑklɑrɯɯn
kɑplɯʤɑlArH	kɑplɯʤɑlɑri	kɑplɯʤɑlɑrɯ
kɑrbonhidrɑtlArHn	kɑrbonhidrɑtlɑrin	kɑrbonhidrɑtlɑrɯn
kɑtɯlɯmlArH	kɑtɯlɯmlɑri	kɑtɯlɯmlɑrɯ
kokuH	kokui	kokuu
konfederɑsjonH	konfederɑsjoni	konfederɑsjonu
kontrolDA	kontroldɑ	kontrolde
konuklArmHz	konuklɑrmiz	konuklɑrmɯz
konHp	konip	konup
koordinɑsjonHn	koordinɑsjonin	koordinɑsjonun
kujumʤulHk	kujumʤulik	kujumʤuluk
lokɑntɑH	lokɑntɑi	lokɑntɑɯ
mɯsɯrlH	mɯsɯrli	mɯsɯrlɯ
mɑkbuzlArHn	mɑkbuzlɑrin	mɑkbuzlɑrɯn
mɑkinɑlH	mɑkinɑli	mɑkinɑlɯ
mɑterjɑllArHHn	mɑterjɑllɑriin	mɑterjɑlleriin
menyHn	menyin	menyyn
merɑklHlArH	merɑklilɑri	merɑklɯlɑrɯ
mevʤutlArH	mevʤutlɑri	mevʤutlɑrɯ
oʤɑklArHn	oʤɑklɑrin	oʤɑklɑrɯn
okumADA	okumɑdɑ	okumɑtɑ
okumADAn	okumɑdɑn	okumɑtɑn
olH	oli	olu
onurHHn	onuriin	onuruun
oturumlArH	oturumlɑri	oturumlɑrɯ
pɑjlH	pɑjli	pɑjlɯ
petrolH	petroli	petroly
pompɑHn	pompɑin	pompɑɯn
portføjHHn	portføjiin	portføjyyn
protokolDA	protokoldɑ	protokolde
sytunlH	sytunli	sytunlu
sɑflHk	sɑflik	sɑflɯk
sɑrɯlHp	sɑrɯlip	sɑrɯlɯp
sɑjfɑlArmHz	sɑjfɑlɑrmiz	sɑjfɑlɑrmɯz
seɑnsDA	seɑnsdɑ	seɑnstɑ
sendikɑHn	sendikɑin	sendikɑɯn
sorumlHlArHHn	sorumlilɑriin	sorumlulɑrɯɯn
sponsorlHk	sponsorlik	sponsorluk
stoklArHn	stoklɑrin	stoklɑrɯn
tɑʃɯmAHn	tɑʃɯmɑin	tɑʃɯmɑɯn
tɑbɑnHn	tɑbɑnin	tɑbɑnɯn
tɑlimɑtHn	tɑlimɑtin	tɑlimɑtɯn
tɑrɑHʤHH	tɑrɑiʤii	tɑrɑɯʤɯɯ
teʃebbysHn	teʃebbysin	teʃebbysyn
teʃkilɑtlArH	teʃkilɑtlɑri	teʃkilɑtlɑrɯ
tiʤɑretDAn	tiʤɑretden	tiʤɑretten
tugɑjH	tugɑji	tugɑjɯ
turnuvɑlArH	turnuvɑlɑri	turnuvɑlɑrɯ
tutmAHn	tutmɑin	tutmɑɯn
ulɑʃmAmHz	ulɑʃmɑmiz	ulɑʃmɑmɯz
vɑrsɑjAlHm	vɑrsɑjɑlim	vɑrsɑjɑlɯm
jɑkɯtlH	jɑkɯtli	jɑkɯtlɯ
jɑkɑlɑmAHn	jɑkɑlɑmɑin	jɑkɑlɑmɑɯn
jɑpmAHHn	jɑpmɑiin	jɑpmɑɯɯn
jɑrgɯlArH	jɑrgɯlɑri	jɑrgɯlɑrɯ
jɑtkɯnlHk	jɑtkɯnlik	jɑtkɯnlɯk
jɑvrulArH	jɑvrulɑri	jɑvrulɑrɯ
jolʤulukDAn	jolʤulukdɑn	jolʤuluktɑn
jurtlArHn	jurtlɑrin	jurtlɑrɯn
ølyHn	ølyin	ølyyn
ʃuHn	ʃuin	ʃuun
yʤretDAn	yʤretden	yʤretten
ynvɑnlArH	ynvɑnlɑri	ynvɑnlɑrɯ
ɑʃɑmɑlArHHn	ɑʃɑmɑlɑriin	ɑʃɑmɑlɑrɯɯn
ɑlkolA	ɑlkolɑ	ɑlkole
ɑnlɑmAmHz	ɑnlɑmɑmiz	ɑnlɑmɑmɯz
ɑnlɑtmADA	ɑnlɑtmɑdɑ	ɑnlɑtmɑtɑ
ɑrʃivA	ɑrʃivɑ	ɑrʃive
ɑtmAH	ɑtmɑi	ɑtmɑɯ
ɑjdɯnlArHn	ɑjdɯnlɑrin	ɑjdɯnlɑrɯn
ɑjgɯtH	ɑjgɯti	ɑjgɯtɯ
ɑjlɯklArH	ɑjlɯklɑri	ɑjlɯklɑrɯ
bølymmHzHn	bølymmizin	bølymmyzyn
bɑʃvurHp	bɑʃvurip	bɑʃvurup
beklemADA	beklemede	beklemete
belirleDHkDAn	belirledikden	belirledikten
bilɑnʧoHn	bilɑnʧoin	bilɑnʧoun
bilmADA	bilmede	bilmete
bulmAH	bulmɑi	bulmɑɯ
ʤɑmiɑH	ʤɑmiɑi	ʤɑmiɑɯ
dyɰynH	dyɰyni	dyɰyny
dɑmɑrH	dɑmɑri	dɑmɑrɯ
dekɑnHn	dekɑnin	dekɑnɯn
depolAnAn	depolenen	depolɑnɑn
dijɑgrɑmH	dijɑgrɑmi	dijɑgrɑmɯ
dumɑnHHn	dumɑniin	dumɑnɯɯn
dujmAH	dujmɑi	dujmɑɯ
enfeksijonlArHHn	enfeksijonleriin	enfeksijonlɑrɯɯn
erDHkDAn	erdikden	erdikten
fɑbrikɑH	fɑbrikɑi	fɑbrikɑɯ
geleʤekDAn	geleʤekden	geleʤekten
hɯzlAnmAH	hɯzlɑnmɑi	hɯzlɑnmɑɯ
hɑkɑretA	hɑkɑretɑ	hɑkɑrete
hɑrfnA	hɑrfnɑ	hɑrfne
hɑzɯrlAHʤH	hɑzɯrlɑiʤi	hɑzɯrlɑɯʤɯ
hoʤɑHn	hoʤɑin	hoʤɑɯn
ithɑlɑtHHn	ithɑlɑtiin	ithɑlɑtɯɯn
kɯrHp	kɯrip	kɯrɯp
kɑmpɑnjɑHHn	kɑmpɑnjɑiin	kɑmpɑnjɑɯɯn
kɑrʃɯlɑʃHnʤA	kɑrʃɯlɑʃinʤɑ	kɑrʃɯlɑʃɯnʤɑ
kɑrɑkolH	kɑrɑkoli	kɑrɑkolu
kɑtɯlɯmʤɯlArHHn	kɑtɯlɯmʤɯlɑriin	kɑtɯlɯmʤɯlɑrɯɯn
kɑtɯlmAlArnH	kɑtɯlmɑlɑrni	kɑtɯlmɑlɑrnɯ
kɑtHp	kɑtip	kɑtɯp
kɑjbetDHklArH	kɑjbetdikleri	kɑjbettikleri
kɑjbolHp	kɑjbolip	kɑjbolup
kenɑrlH	kenɑrli	kenɑrlɯ
kollArHn	kollɑrin	kollɑrɯn
korkuH	korkui	korkuu
kuʃʧH	kuʃʧi	kuʃʧu
kurslArHHn	kurslɑriin	kurslɑrɯɯn
kurummHzHn	kurummizin	kurummuzun
myhyrlH	myhyrli	myhyrly
metodlArHHn	metodleriin	metodlɑrɯɯn
metodHHn	metodiin	metoduun
oɰlɑnHn	oɰlɑnin	oɰlɑnɯn
okumAnHzH	okumɑnizi	okumɑnɯzɯ
okjɑnusH	okjɑnusi	okjɑnusu
olgulArHHn	olgulɑriin	olgulɑrɯɯn
olmAmHzH	olmɑmizi	olmɑmɯzɯ
olurH	oluri	oluru
opsijonDA	opsijonde	opsijondɑ
ortɑlɑmɑlArHHn	ortɑlɑmɑlɑriin	ortɑlɑmɑlɑrɯɯn
pɑzɑrlAnmAH	pɑzɑrlɑnmɑi	pɑzɑrlɑnmɑɯ
pilotHn	pilotin	pilotun
purolHk	purolik	puroluk
rɑportørlHk	rɑportørlik	rɑportørlyk
rezistɑnsH	rezistɑnsi	rezistɑnsɯ
sɯvɯlArH	sɯvɯlɑri	sɯvɯlɑrɯ
sɑldɯrgɑnlHk	sɑldɯrgɑnlik	sɑldɯrgɑnlɯk
sɑnɑjiDAki	sɑnɑjidɑki	sɑnɑjideki
sezonDA	sezonde	sezondɑ
sigortɑlHlAr	sigortɑlilɑr	sigortɑlɯlɑr
sofrɑH	sofrɑi	sofrɑɯ
sonuʧDAn	sonuʧdɑn	sonuʧtɑn
sorunnHz	sorunniz	sorunnuz
stresDAn	stresden	stresten
suʧlHH	suʧlii	suʧluu
tyjH	tyji	tyjy
tɑnɯmHn	tɑnɯmin	tɑnɯmɯn
tɑnɯmlArHHn	tɑnɯmlɑriin	tɑnɯmlɑrɯɯn
tɑsɑrruflArH	tɑsɑrruflɑri	tɑsɑrruflɑrɯ
tɑvuklArHn	tɑvuklɑrin	tɑvuklɑrɯn
teʤɑvyzHn	teʤɑvyzin	teʤɑvyzyn
telgrɑfDA	telgrɑfdɑ	telgrɑftɑ
tutmAlArH	tutmɑlɑri	tutmɑlɑrɯ
uzɑDHkʧA	uzɑdikʧɑ	uzɑdɯkʧɑ
vɑnɑlArH	vɑnɑlɑri	vɑnɑlɑrɯ
vɑrsɑjɯmH	vɑrsɑjɯmi	vɑrsɑjɯmɯ
jynlH	jynli	jynly
jyrymADA	jyrymede	jyrymete
jɑʃɑHʃ	jɑʃɑiʃ	jɑʃɑɯʃ
jɑbɑnʤɯHn	jɑbɑnʤɯin	jɑbɑnʤɯɯn
jɑpHnʤA	jɑpinʤɑ	jɑpɯnʤɑ
jɑzɯʤɯH	jɑzɯʤɯi	jɑzɯʤɯɯ
jɑzɯlArHHn	jɑzɯlɑriin	jɑzɯlɑrɯɯn
jɑzɯmHzHn	jɑzɯmizin	jɑzɯmɯzɯn
zekɑHn	zekɑin	zekɑɯn
ʧɯkHʃHn	ʧɯkiʃin	ʧɯkɯʃɯn
ʧɯkDHklArH	ʧɯkdikleri	ʧɯktɯklɑrɯ
ʧɑlɯʃmAmHzHn	ʧɑlɯʃmɑmizin	ʧɑlɯʃmɑmɯzɯn
ʧɑrpɯmH	ʧɑrpɯmi	ʧɑrpɯmɯ
ʧɑtɯHn	ʧɑtɯin	ʧɑtɯɯn
ʧimentoHn	ʧimentoin	ʧimentoun
ɯrkʧHlHk	ɯrkʧilik	ɯrkʧɯlɯk
ɑhiretDA	ɑhiretde	ɑhirette
ɑkɯntɯHn	ɑkɯntɯin	ɑkɯntɯɯn
ɑmbɑlɑʒlH	ɑmbɑlɑʒli	ɑmbɑlɑʒlɯ
ɑnɯH	ɑnɯi	ɑnɯɯ
ɑnlɑʃmɑzlɯklArH	ɑnlɑʃmɑzlɯklɑri	ɑnlɑʃmɑzlɯklɑrɯ
ɑnlɑmAHn	ɑnlɑmɑin	ɑnlɑmɑɯn
ɑnormɑllHklAr	ɑnormɑlliklɑr	ɑnormɑllikler
ɑrɯzɑlArHn	ɑrɯzɑlɑrin	ɑrɯzɑlɑrɯn
ɑrtmAHHn	ɑrtmɑiin	ɑrtmɑɯɯn
ɑvʤɯlArH	ɑvʤɯlɑri	ɑvʤɯlɑrɯ
ɑjlArHHn	ɑjlɑriin	ɑjlɑrɯɯn
ɑjrɯlɯkʧH	ɑjrɯlɯkʧi	ɑjrɯlɯkʧɯ
ɑzɑHn	ɑzɑin	ɑzɑɯn
bɑkɯmHn	bɑkɯmin	bɑkɯmɯn
bɑntlArH	bɑntlɑri	bɑntlɑrɯ
bɑrɯʃDA	bɑrɯʃdɑ	bɑrɯʃtɑ
bɑslAmA	bɑsleme	bɑslɑmɑ
bebekDAn	bebekden	bebekten
birlikDAn	birlikden	birlikten
bojɑlArH	bojɑlɑri	bojɑlɑrɯ
bojlArHHn	bojlɑriin	bojlɑrɯɯn
bulɑnɯklHk	bulɑnɯklik	bulɑnɯklɯk
bulmAmHz	bulmɑmiz	bulmɑmɯz
bulunHʃH	buluniʃi	bulunuʃu
ʤumhurijetDAn	ʤumhurijetden	ʤumhurijetten
dyʃmH	dyʃmi	dyʃmy
dyʃmADA	dyʃmede	dyʃmete
dɑvrɑnmAlArH	dɑvrɑnmɑlɑri	dɑvrɑnmɑlɑrɯ
depresjonHn	depresjonin	depresjonun
doɰrultulH	doɰrultuli	doɰrultulu
doɰumHHn	doɰumiin	doɰumuun
doksɑnlH	doksɑnli	doksɑnlɯ
dolguH	dolgui	dolguu
fonHHn	foniin	fonuun
formɑtlArH	formɑtlɑri	formɑtlɑrɯ
fotoɰrɑfDAn	fotoɰrɑfdɑn	fotoɰrɑftɑn
guruplArH	guruplɑri	guruplɑrɯ
hɑmurHn	hɑmurin	hɑmurun
hɑplArH	hɑplɑri	hɑplɑrɯ
hɑvzɑHHn	hɑvzɑiin	hɑvzɑɯɯn
hoʤɑlArH	hoʤɑlɑri	hoʤɑlɑrɯ
hormonlArH	hormonlɑri	hormonlɑrɯ
ilɑʧlArHHn	ilɑʧlɑriin	ilɑʧlɑrɯɯn
imzɑHn	imzɑin	imzɑɯn
inʃɑɑtlArHn	inʃɑɑtlɑrin	inʃɑɑtlɑrɯn
inɑnHʃ	inɑniʃ	inɑnɯʃ
insɑnlArmHzA	insɑnlɑrmize	insɑnlɑrmɯzɑ
izlAnmADA	izlenmede	izlenmete
kyltyrmHzH	kyltyrmizi	kyltyrmyzy
kɑfɑlH	kɑfɑli	kɑfɑlɯ
kɑhrɑmɑnlArHn	kɑhrɑmɑnlɑrin	kɑhrɑmɑnlɑrɯn
kɑldɯrmAH	kɑldɯrmɑi	kɑldɯrmɑɯ
kɑmerɑlArHn	kɑmerɑlɑrin	kɑmerɑlɑrɯn
kɑpsylH	kɑpsyli	kɑpsyly
kɑpsɑmADA	kɑpsɑmɑdɑ	kɑpsɑmɑtɑ
kɑrɑrsHzlHk	kɑrɑrsizlik	kɑrɑrsɯzlɯk
kɑtɯlmADA	kɑtɯlmɑdɑ	kɑtɯlmɑtɑ
konsolosH	konsolosi	konsolosu
kontrollArA	kontrollɑrɑ	kontrollere
kojmADA	kojmɑdɑ	kojmɑtɑ
kojmAlArH	kojmɑlɑri	kojmɑlɑrɯ
kurɑmHHn	kurɑmiin	kurɑmɯɯn
kurbɑnlArH	kurbɑnlɑri	kurbɑnlɑrɯ
kurtulmAH	kurtulmɑi	kurtulmɑɯ
kujruklH	kujrukli	kujruklu
kujuHn	kujuin	kujuun
myzikDA	myzikde	myzikte
mɑdɑljɑH	mɑdɑljɑi	mɑdɑljɑɯ
mɑkbulA	mɑkbulɑ	mɑkbule
mɑmyllAr	mɑmyllɑr	mɑmyller
mɑmullArHHn	mɑmullɑriin	mɑmulleriin
mɑsrɑflH	mɑsrɑfli	mɑsrɑflɯ
mekɑnizmɑHn	mekɑnizmɑin	mekɑnizmɑɯn
modylHHn	modyliin	modylyyn
nyfuslArH	nyfusleri	nyfuslɑrɯ
operɑsjonlArHn	operɑsjonlɑrin	operɑsjonlɑrɯn
ortɑlɑmɑHn	ortɑlɑmɑin	ortɑlɑmɑɯn
otobysDA	otobysde	otobyste
ovɑlArH	ovɑlɑri	ovɑlɑrɯ
ojunʤɑklArH	ojunʤɑklɑri	ojunʤɑklɑrɯ
pɑjlɑʃmADAn	pɑjlɑʃmɑdɑn	pɑjlɑʃmɑtɑn
plɑkɑlArH	plɑkɑlɑri	plɑkɑlɑrɯ
sɯfɑtlArH	sɯfɑtlɑri	sɯfɑtlɑrɯ
sɯkɯʃHp	sɯkɯʃip	sɯkɯʃɯp
sɑlgɯnH	sɑlgɯni	sɑlgɯnɯ
sɑltɑnɑtH	sɑltɑnɑti	sɑltɑnɑtɯ
sɑnɑjilAʃmAHn	sɑnɑjilɑʃmein	sɑnɑjileʃmein
sɑvH	sɑvi	sɑvɯ
sigortɑlHlHk	sigortɑlilik	sigortɑlɯlɯk
sinjɑllArHn	sinjɑllɑrin	sinjɑllerin
sirkylɑsjonH	sirkylɑsjoni	sirkylɑsjonu
soɰuklHk	soɰuklik	soɰukluk
sojɑdlArH	sojɑdlɑri	sojɑdlɑrɯ
tɑzminɑtHHn	tɑzminɑtiin	tɑzminɑtɯɯn
tɑzminɑtlArH	tɑzminɑtlɑri	tɑzminɑtlɑrɯ
temɑsDAn	temɑsdɑn	temɑstɑn
ulɑʃmAnHzH	ulɑʃmɑnizi	ulɑʃmɑnɯzɯ
ujdulArHn	ujdulɑrin	ujdulɑrɯn
vɑkɯflArH	vɑkɯflɑri	vɑkɯflɑrɯ
jɯkɯmH	jɯkɯmi	jɯkɯmɯ
jɑɰɯHn	jɑɰɯin	jɑɰɯɯn
jɑkɯnHHn	jɑkɯniin	jɑkɯnɯɯn
jɑpɯtlArHHn	jɑpɯtlɑriin	jɑpɯtlɑrɯɯn
jɑpDHklArHHn	jɑpdiklɑriin	jɑptɯklɑrɯɯn
jɑrɯʧɑpH	jɑrɯʧɑpi	jɑrɯʧɑpɯ
jɑrɯʃmAlArHn	jɑrɯʃmɑlɑrin	jɑrɯʃmɑlɑrɯn
jɑrdɯmʤɯmHz	jɑrdɯmʤɯmiz	jɑrdɯmʤɯmɯz
jɑrgɯH	jɑrgɯi	jɑrgɯɯ
jɑzɑrHHn	jɑzɑriin	jɑzɑrɯɯn
joɰunlAʃmAH	joɰunlɑʃmɑi	joɰunlɑʃmɑɯ
jolmHz	jolmiz	jolmuz
jolmHzH	jolmizi	jolmuzu
ʧɑbɑHn	ʧɑbɑin	ʧɑbɑɯn
ʧɑpHHn	ʧɑpiin	ʧɑpɯɯn
ʧimentoH	ʧimentoi	ʧimentou
ɯʃɯkDAn	ɯʃɯkdɑn	ɯʃɯktɑn
ʃejtɑnHn	ʃejtɑnin	ʃejtɑnɯn
ɑɰɑH	ɑɰɑi	ɑɰɑɯ
ɑʤɯHn	ɑʤɯin	ɑʤɯɯn
ɑlɯnmADHkʧA	ɑlɯnmɑdikʧɑ	ɑlɯnmɑdɯkʧɑ
ɑntikorlArHn	ɑntikorlɑrin	ɑntikorlɑrɯn
ɑrkɑdɑʃnHzHn	ɑrkɑdɑʃnizin	ɑrkɑdɑʃnɯzɯn
ɑrkɑdɑʃnHzA	ɑrkɑdɑʃnizɑ	ɑrkɑdɑʃnɯzɑ
ɑrkɑdɑʃlArnHzHn	ɑrkɑdɑʃlɑrnizin	ɑrkɑdɑʃlɑrnɯzɯn
ɑrtɯklArHHn	ɑrtɯklɑriin	ɑrtɯklɑrɯɯn
ɑtlArH	ɑtlɑri	ɑtlɑrɯ
ɑjɯplH	ɑjɯpli	ɑjɯplɯ
ɑjɑrlArnHzH	ɑjɑrlɑrnizi	ɑjɑrlɑrnɯzɯ
ɑjgɯtlArHn	ɑjgɯtlɑrin	ɑjgɯtlɑrɯn
ɑjlɯkDAn	ɑjlɯkdɑn	ɑjlɯktɑn
ɑzɯnlɯkDA	ɑzɯnlɯkdɑ	ɑzɯnlɯktɑ
ɑzɑlDHkʧA	ɑzɑldikʧɑ	ɑzɑldɯkʧɑ
bɯkmADAn	bɯkmɑden	bɯkmɑdɑn
bɑɰHn	bɑɰin	bɑɰɯn
bɑɰɯnH	bɑɰɯni	bɑɰɯnɯ
bɑɰɯntɯlArH	bɑɰɯntɯlɑri	bɑɰɯntɯlɑrɯ
bɑʃɑrɯlArHn	bɑʃɑrɯlɑrin	bɑʃɑrɯlɑrɯn
bɑlɯklArHHn	bɑlɯklɑriin	bɑlɯklɑrɯɯn
bolmH	bolmi	bolmu
bojɑH	bojɑi	bojɑɯ
bulutH	buluti	bulutu
bursHn	bursin	bursun
ʤevɑpsHz	ʤevɑpsiz	ʤevɑpsɯz
dyʃH	dyʃi	dyʃy
dyʃHʃHn	dyʃiʃin	dyʃyʃyn
dykkɑnHn	dykkɑnin	dykkɑnɯn
dɑnsH	dɑnsi	dɑnsɯ
detɑjlArHn	detɑjlɑrin	detɑjlɑrɯn
dujHʃsAl	dujiʃsɑl	dujuʃsɑl
eʃjɑlArnHzH	eʃjɑlɑrnizi	eʃjɑlɑrnɯzɯ
ekipDA	ekipde	ekipte
emisjonlArH	emisjonlɑri	emisjonlɑrɯ
fɯkrɑHn	fɯkrɑin	fɯkrɑɯn
fɯrɯnlArH	fɯrɯnlɑri	fɯrɯnlɑrɯ
fɯrtɯnɑlH	fɯrtɯnɑli	fɯrtɯnɑlɯ
fɑjHHn	fɑjiin	fɑjɯɯn
felɑketDAn	felɑketden	felɑketten
fermɑntɑsjonH	fermɑntɑsjoni	fermɑntɑsjonu
gynɑhH	gynɑhi	gynɑhɯ
gɑrɑntilArH	gɑrɑntilɑri	gɑrɑntileri
gɑjrimenkulA	gɑjrimenkulɑ	gɑjrimenkule
hykymsHzlHk	hykymsizlik	hykymsyzlyk
hɑkimlArHn	hɑkimlɑrin	hɑkimlerin
hɑlkɑlArH	hɑlkɑlɑri	hɑlkɑlɑrɯ
hɑriʧDA	hɑriʧdɑ	hɑriʧte
hoʤɑmHzHn	hoʤɑmizin	hoʤɑmɯzɯn
iʃtɑhsHzlHk	iʃtɑhsizlik	iʃtɑhsɯzlɯk
ifɑH	ifɑi	ifɑɯ
ihtilɑflArHn	ihtilɑflɑrin	ihtilɑflɑrɯn
ikɑmetgɑhHHn	ikɑmetgɑhiin	ikɑmetgɑhɯɯn
ikrɑmH	ikrɑmi	ikrɑmɯ
ilɑnHHn	ilɑniin	ilɑnɯɯn
insɑnmHzA	insɑnmize	insɑnmɯzɑ
izlemADA	izlemede	izlemete
kɯzgɯnlHk	kɯzgɯnlik	kɯzgɯnlɯk
kɑlplArH	kɑlplɑri	kɑlpleri
kɑmerɑlArH	kɑmerɑlɑri	kɑmerɑlɑrɯ
kɑmpysDA	kɑmpysde	kɑmpyste
kɑmpɑnjɑmHz	kɑmpɑnjɑmiz	kɑmpɑnjɑmɯz
kɑmjonH	kɑmjoni	kɑmjonu
kɑrʃɯlɑʃmɑH	kɑrʃɯlɑʃmɑi	kɑrʃɯlɑʃmɑɯ
kɑrʃɯmHzDAki	kɑrʃɯmizdɑki	kɑrʃɯmɯzdɑki
kɑtkɯlArnHzH	kɑtkɯlɑrnizi	kɑtkɯlɑrnɯzɯ
kolesterolHn	kolesterolin	kolesterolyn
komutɑHn	komutɑin	komutɑɯn
konsorsijumH	konsorsijumi	konsorsijumu
kontrollArDA	kontrollɑrdɑ	kontrollerde
korumɑsHz	korumɑsiz	korumɑsɯz
kristɑllAr	kristɑllɑr	kristɑller
kuruDHkDAn	kurudikdɑn	kuruduktɑn
limɑnlArH	limɑnlɑri	limɑnlɑrɯ
lirɑHn	lirɑin	lirɑɯn
mɑmullArHn	mɑmullɑrin	mɑmullerin
modlArH	modlɑri	modlɑrɯ
molekylHn	molekylin	molekylyn
okullArmHz	okullɑrmiz	okullɑrmɯz
okulmHzH	okulmizi	okulmuzu
onɑrɯmlArH	onɑrɯmlɑri	onɑrɯmlɑrɯ
oruʧlArHHn	oruʧlɑriin	oruʧlɑrɯɯn
ojlAmAH	ojlɑmɑi	ojlɑmɑɯ
pɑrɑgrɑfDA	pɑrɑgrɑfdɑ	pɑrɑgrɑftɑ
pɑtentDAn	pɑtentden	pɑtentten
plɑkɑlH	plɑkɑli	plɑkɑlɯ
progrɑmnHz	progrɑmniz	progrɑmnɯz
rɑkɑmlH	rɑkɑmli	rɑkɑmlɯ
renkDAki	renkdeki	renkteki
syrgylH	syrgyli	syrgyly
sytDAn	sytden	sytten
sɑbunlH	sɑbunli	sɑbunlu
sɑnɯklArH	sɑnɯklɑri	sɑnɯklɑrɯ
sɑnɑtʧHlArHHn	sɑnɑtʧilɑriin	sɑnɑtʧɯlɑrɯɯn
sɑvʤɯHHn	sɑvʤɯiin	sɑvʤɯɯɯn
stɑdjumH	stɑdjumi	stɑdjumu
tɯrnɑklArH	tɯrnɑklɑri	tɯrnɑklɑrɯ
tɑnɯHHn	tɑnɯiin	tɑnɯɯɯn
tɑnɯtɯmHHn	tɑnɯtɯmiin	tɑnɯtɯmɯɯn
teʃekkyrH	teʃekkyri	teʃekkyry
tolerɑnsH	tolerɑnsi	tolerɑnsɯ
toplɑmlArHHn	toplɑmlɑriin	toplɑmlɑrɯɯn
turmHz	turmiz	turmuz
uʧDA	uʧdɑ	uʧtɑ
ulusmHzHn	ulusmizin	ulusmuzun
ujumHHn	ujumiin	ujumuun
vurgulAnmAH	vurgulɑnmɑi	vurgulɑnmɑɯ
jyksekDAn	jyksekden	jyksekten
jyryHp	jyryip	jyryyp
jɑɰɯʃHn	jɑɰɯʃin	jɑɰɯʃɯn
jɑpDHklArmHzH	jɑpdiklɑrmizi	jɑptɯklɑrmɯzɯ
jɑzAlHm	jɑzɑlim	jɑzɑlɯm
jerjyzynH	jerjyzyni	jerjyzyny
jolsuzlHklArH	jolsuzliklɑri	jolsuzluklɑrɯ
jolsuzlHklArA	jolsuzliklɑrɑ	jolsuzluklɑrɑ
ʧɑdɯrlArH	ʧɑdɯrlɑri	ʧɑdɯrlɑrɯ
ʧɑlɯʃmAmAH	ʧɑlɯʃmɑmɑi	ʧɑlɯʃmɑmɑɯ
ʧɑlɯʃmAnHzH	ʧɑlɯʃmɑnizi	ʧɑlɯʃmɑnɯzɯ
ʃɑrkɯlArHn	ʃɑrkɯlɑrin	ʃɑrkɯlɑrɯn
ylkyH	ylkyi	ylkyy
ɑʧɯklɑmAlArHHn	ɑʧɯklɑmɑlɑriin	ɑʧɯklɑmɑlɑrɯɯn
ɑkmAH	ɑkmɑi	ɑkmɑɯ
ɑlmAnHzA	ɑlmɑnize	ɑlmɑnɯzɑ
ɑnlɑtmAH	ɑnlɑtmɑi	ɑnlɑtmɑɯ
ɑrɯzɑHn	ɑrɯzɑin	ɑrɯzɑɯn
ɑrkɑdɑʃlHklAr	ɑrkɑdɑʃliklɑr	ɑrkɑdɑʃlɯklɑr
ɑskerlHkDAn	ɑskerlikden	ɑskerlikten
bɑʃɑrɯlArnHzHn	bɑʃɑrɯlɑrnizin	bɑʃɑrɯlɑrnɯzɯn
bɑkɯmHHn	bɑkɯmiin	bɑkɯmɯɯn
bɑkmAmHz	bɑkmɑmiz	bɑkmɑmɯz
bejɑzH	bejɑzi	bejɑzɯ
bilgisɑjɑrnHzDAn	bilgisɑjɑrnizdɑn	bilgisɑjɑrnɯzdɑn
binɑmHzHn	binɑmizin	binɑmɯzɯn
birkɑʧHHn	birkɑʧiin	birkɑʧɯɯn
bombɑlArH	bombɑlɑri	bombɑlɑrɯ
borsɑlArH	borsɑlɑri	borsɑlɑrɯ
bulHʃlArH	buliʃlɑri	buluʃlɑrɯ
bulHʃlArHn	buliʃlɑrin	buluʃlɑrɯn
ʤiltDAn	ʤiltden	ʤiltten
dɑmɑrHn	dɑmɑrin	dɑmɑrɯn
deɰiʃiklHkDAn	deɰiʃiklikden	deɰiʃiklikten
deklɑnʃørA	deklɑnʃørɑ	deklɑnʃøre
diplomɑHn	diplomɑin	diplomɑɯn
doɰrulAnmAH	doɰrulɑnmɑi	doɰrulɑnmɑɯ
doɰulH	doɰuli	doɰulu
doɰumHn	doɰumin	doɰumun
dujguHn	dujguin	dujguun
eʃgydymH	eʃgydymi	eʃgydymy
elekDAn	elekden	elekten
erkekDAn	erkekden	erkekten
etrɑfDAki	etrɑfdɑki	etrɑftɑki
fidɑnlHk	fidɑnlik	fidɑnlɯk
fidɑnlArHn	fidɑnlɑrin	fidɑnlɑrɯn
figyrH	figyri	figyry
filozoflArHn	filozoflɑrin	filozoflɑrɯn
firmɑmHzDA	firmɑmizde	firmɑmɯzdɑ
formlH	formli	formlu
gyllHk	gyllik	gyllyk
gebelHkDAn	gebelikden	gebelikten
getirDHkDAn	getirdikden	getirdikten
golH	goli	goly
hɑklArmHzH	hɑklɑrmizi	hɑklɑrmɯzɯ
hɑlɯlArH	hɑlɯlɑri	hɑlɯlɑrɯ
hɑnHn	hɑnin	hɑnɯn
hɑstɑnelArDAn	hɑstɑnelerdɑn	hɑstɑnelerden
hesɑplAArAk	hesɑplɑɑrek	hesɑplɑɑrɑk
iddiɑA	iddiɑe	iddiɑɑ
imtijɑzlAr	imtijɑzler	imtijɑzlɑr
imzɑlArHn	imzɑlɑrin	imzɑlɑrɯn
insɑnmHzH	insɑnmizi	insɑnmɯzɯ
ishɑlA	ishɑlɑ	ishɑle
isjɑnHn	isjɑnin	isjɑnɯn
ittifɑkH	ittifɑki	ittifɑkɯ
kɯlɯfH	kɯlɯfi	kɯlɯfɯ
kørH	køri	køry
kyltyrmHzA	kyltyrmize	kyltyrmyze
kɑlDHkʧA	kɑldikʧɑ	kɑldɯkʧɑ
kɑlmAHHn	kɑlmɑiin	kɑlmɑɯɯn
kɑnsHz	kɑnsiz	kɑnsɯz
kɑpɯlArHHn	kɑpɯlɑriin	kɑpɯlɑrɯɯn
kɑrbonlH	kɑrbonli	kɑrbonlu
kɑrtmH	kɑrtmi	kɑrtmɯ
kɑtɯlɯmʤɯlHk	kɑtɯlɯmʤɯlik	kɑtɯlɯmʤɯlɯk
kɑtɯlmADAn	kɑtɯlmɑdɑn	kɑtɯlmɑtɑn
kɑtɯlmAHHn	kɑtɯlmɑiin	kɑtɯlmɑɯɯn
kɑjnɑklArmHz	kɑjnɑklɑrmiz	kɑjnɑklɑrmɯz
kesilDHkDAn	kesildikden	kesildikten
koʃulHHn	koʃuliin	koʃuluun
koʤɑHn	koʤɑin	koʤɑɯn
kolonH	koloni	kolonu
kontrollArHn	kontrollɑrin	kontrollerin
konuʃAlHm	konuʃɑlim	konuʃɑlɯm
konumlH	konumli	konumlu
kullɑnHʃ	kullɑniʃ	kullɑnɯʃ
kuruluʃnHzHn	kuruluʃnizin	kuruluʃnuzun
lyksH	lyksi	lyksy
mɑkroH	mɑkroi	mɑkrou
merɑklHH	merɑklii	merɑklɯɯ
meslektɑʃlArH	meslektɑʃlɑri	meslektɑʃlɑrɯ
muhtɑrHn	muhtɑrin	muhtɑrɯn
mutsuzlHk	mutsuzlik	mutsuzluk
noksɑnlHklAr	noksɑnliklɑr	noksɑnlɯklɑr
normH	normi	normu
olmAmAHHn	olmɑmɑiin	olmɑmɑɯɯn
omurgɑH	omurgɑi	omurgɑɯ
ordumHz	ordumiz	ordumuz
ojnɑDHklArH	ojnɑdiklɑri	ojnɑdɯklɑrɯ
perspektifDAn	perspektifden	perspektiften
plɑstikDAn	plɑstikden	plɑstikten
puɑnlHk	puɑnlik	puɑnlɯk
ryzgɑrlArHn	ryzgɑrlɑrin	ryzgɑrlɑrɯn
ressɑmHn	ressɑmin	ressɑmɯn
ressɑmlArHn	ressɑmlɑrin	ressɑmlɑrɯn
sɯrlH	sɯrli	sɯrlɯ
søjlemADA	søjlemede	søjlemete
sɑʧlArHn	sɑʧlɑrin	sɑʧlɑrɯn
sɑlgɯHn	sɑlgɯin	sɑlgɯɯn
sɑnʤɯlH	sɑnʤɯli	sɑnʤɯlɯ
sɑntrɑllArDA	sɑntrɑllɑrdɑ	sɑntrɑllerde
sɑplArH	sɑplɑri	sɑplɑrɯ
sektørmHzDA	sektørmizde	sektørmyzde
sembollArHn	sembollɑrin	sembollerin
sesDA	sesde	seste
sinemɑHHn	sinemɑiin	sinemɑɯɯn
sokmAH	sokmɑi	sokmɑɯ
solunumHn	solunumin	solunumun
sorulArnHzA	sorulɑrnize	sorulɑrnɯzɑ
stɑʒlArH	stɑʒlɑri	stɑʒlɑrɯ
subɑjlArH	subɑjlɑri	subɑjlɑrɯ
sultɑHn	sultɑin	sultɑɯn
tɑbelɑH	tɑbelɑi	tɑbelɑɯ
tɑblolArHHn	tɑblolɑriin	tɑblolɑrɯɯn
tɑkipDA	tɑkipde	tɑkipte
tohumHn	tohumin	tohumun
toklHk	toklik	tokluk
toplulukDA	toplulukdɑ	topluluktɑ
torunlArH	torunlɑri	torunlɑrɯ
tutuklAnmAH	tutuklɑnmɑi	tutuklɑnmɑɯ
uʧHʃA	uʧiʃɑ	uʧuʃɑ
ulɑʃmADA	ulɑʃmɑdɑ	ulɑʃmɑtɑ
urHn	urin	urun
vidɑlH	vidɑli	vidɑlɯ
jɯkɑHp	jɯkɑip	jɯkɑɯp
jyzmH	jyzmi	jyzmy
jyzjɯllArHn	jyzjɯllɑrin	jyzjɯllɑrɯn
jɑʃɑDHkʧA	jɑʃɑdikʧɑ	jɑʃɑdɯkʧɑ
jɑʃɑmAlArH	jɑʃɑmɑlɑri	jɑʃɑmɑlɑrɯ
jɑpɯʃtɯrɯʤɯlArH	jɑpɯʃtɯrɯʤɯlɑri	jɑpɯʃtɯrɯʤɯlɑrɯ
jɑpɯtlArHn	jɑpɯtlɑrin	jɑpɯtlɑrɯn
juvɑlArH	juvɑlɑri	juvɑlɑrɯ
zɑmlArH	zɑmlɑri	zɑmlɑrɯ
zɑjɯflAmHʃ	zɑjɯflɑmiʃ	zɑjɯflɑmɯʃ
ʧɯkHʃA	ʧɯkiʃɑ	ʧɯkɯʃɑ
ʧɑɰɯrHp	ʧɑɰɯrip	ʧɑɰɯrɯp
ʧɑɰdɑʃlHk	ʧɑɰdɑʃlik	ʧɑɰdɑʃlɯk
ʧɑɰrɯH	ʧɑɰrɯi	ʧɑɰrɯɯ
ɯrkH	ɯrki	ɯrkɯ
ølymlH	ølymli	ølymly
øzellikDAki	øzellikdeki	øzellikteki
ʃykrɑnlArmHzH	ʃykrɑnlɑrmizi	ʃykrɑnlɑrmɯzɯ
ʃɑrtDA	ʃɑrtdɑ	ʃɑrttɑ
ystlHk	ystlik	ystlyk
ɑʃɯlH	ɑʃɯli	ɑʃɯlɯ
ɑdɯmHn	ɑdɯmin	ɑdɯmɯn
ɑʒɑnslArH	ɑʒɑnslɑri	ɑʒɑnslɑrɯ
ɑktivɑsjonH	ɑktivɑsjoni	ɑktivɑsjonu
ɑlɯnHʃ	ɑlɯniʃ	ɑlɯnɯʃ
ɑlgɯlAHʤH	ɑlgɯlɑiʤi	ɑlgɯlɑɯʤɯ
ɑnɑhtɑrHn	ɑnɑhtɑrin	ɑnɑhtɑrɯn
ɑrkɑdɑʃlArmHzDAn	ɑrkɑdɑʃlɑrmizden	ɑrkɑdɑʃlɑrmɯzdɑn
ɑrmɑtyrlAr	ɑrmɑtyrlɑr	ɑrmɑtyrler
ɑstɯmlH	ɑstɯmli	ɑstɯmlɯ
ɑtɯlHp	ɑtɯlip	ɑtɯlɯp
ɑtlArHn	ɑtlɑrin	ɑtlɑrɯn
bɑɰɯrHp	bɑɰɯrip	bɑɰɯrɯp
bɑʃlɑmAnHn	bɑʃlɑmɑnin	bɑʃlɑmɑnɯn
bɑʃlɑmAHHn	bɑʃlɑmɑiin	bɑʃlɑmɑɯɯn
bɑʤɑlArH	bɑʤɑlɑri	bɑʤɑlɑrɯ
bɑkmADA	bɑkmɑdɑ	bɑkmɑtɑ
bɑlH	bɑli	bɑlɯ
bɑnkɑH	bɑnkɑi	bɑnkɑɯ
bɑsɯnʧlArH	bɑsɯnʧlɑri	bɑsɯnʧlɑrɯ
bɑsDHkDAn	bɑsdikden	bɑstɯktɑn
bertɑrɑfH	bertɑrɑfi	bertɑrɑfɯ
borulArHHn	borulɑriin	borulɑrɯɯn
bulAbiljor	bulebiljor	bulɑbiljor
ʤɑmiɑHHn	ʤɑmiɑiin	ʤɑmiɑɯɯn
dɯʃmHzDA	dɯʃmizde	dɯʃmɯzdɑ
dyʃynHnʤA	dyʃyninʤe	dyʃynynʤe
dynjɑmHzH	dynjɑmizi	dynjɑmɯzɯ
dɑɰlH	dɑɰli	dɑɰlɯ
depoDA	depode	depodɑ
doɰɑlgɑzHn	doɰɑlgɑzin	doɰɑlgɑzɯn
doɰruHn	doɰruin	doɰruun
dolgulH	dolguli	dolgulu
durmAH	durmɑi	durmɑɯ
durummHz	durummiz	durummuz
fɯrɯnHn	fɯrɯnin	fɯrɯnɯn
fɑkslAr	fɑksler	fɑkslɑr
fɑjlArHn	fɑjlɑrin	fɑjlɑrɯn
gønyllHlArHn	gønyllilerin	gønyllylerin
gyreʃDA	gyreʃde	gyreʃte
hɯrslH	hɯrsli	hɯrslɯ
hykymlHlArA	hykymlilere	hykymlylere
hɑnɯmlArH	hɑnɯmlɑri	hɑnɯmlɑrɯ
hɑsɑrlArHn	hɑsɑrlɑrin	hɑsɑrlɑrɯn
hɑtɑlArHHn	hɑtɑlɑriin	hɑtɑlɑrɯɯn
hɑzɯrlAmADA	hɑzɯrlɑmɑdɑ	hɑzɯrlɑmɑtɑ
hesɑplAmAH	hesɑplɑmɑi	hesɑplɑmɑɯ
hesɑplAnHp	hesɑplɑnip	hesɑplɑnɯp
hipertɑnsijonHn	hipertɑnsijonin	hipertɑnsijonun
hormonlArHHn	hormonlɑriin	hormonlɑrɯɯn
iʧerikDA	iʧerikde	iʧerikte
iʤrɑH	iʤrɑi	iʤrɑɯ
ispɑtlAmHʃ	ispɑtlɑmiʃ	ispɑtlɑmɯʃ
istisnɑsHz	istisnɑsiz	istisnɑsɯz
køpryH	køpryi	køpryy
kɑlkɑnH	kɑlkɑni	kɑlkɑnɯ
kɑtsɑjɯHHn	kɑtsɑjɯiin	kɑtsɑjɯɯɯn
kɑjɯpsHz	kɑjɯpsiz	kɑjɯpsɯz
kɑzɑnDHkDAn	kɑzɑndikdɑn	kɑzɑndɯktɑn
kɑzɑnmADA	kɑzɑnmɑdɑ	kɑzɑnmɑtɑ
kirɑH	kirɑi	kirɑɯ
koɰuʃDA	koɰuʃdɑ	koɰuʃtɑ
kopmAH	kopmɑi	kopmɑɯ
kurmAnHz	kurmɑniz	kurmɑnɯz
kurHʤHnHn	kuriʤinin	kuruʤunun
kurumnHzHn	kurumnizin	kurumnuzun
liberɑllAʃmA	liberɑllɑʃmɑ	liberɑlleʃme
mɑkbuzlArHHn	mɑkbuzlɑriin	mɑkbuzlɑrɯɯn
mɑntɑrlArHn	mɑntɑrlɑrin	mɑntɑrlɑrɯn
mɑtbɑɑHn	mɑtbɑɑin	mɑtbɑɑɯn
medjɑH	medjɑi	medjɑɯ
menyH	menyi	menyy
metɑstɑzH	metɑstɑzi	metɑstɑzɯ
mezɑrlHklAr	mezɑrliklɑr	mezɑrlɯklɑr
militɑnH	militɑni	militɑnɯ
miljɑrH	miljɑri	miljɑrɯ
mirɑsʧH	mirɑsʧi	mirɑsʧɯ
mirɑsʧHlAr	mirɑsʧilɑr	mirɑsʧɯlɑr
monitørH	monitøri	monitøry
muhtɑrlArH	muhtɑrlɑri	muhtɑrlɑrɯ
mutlulHkDAn	mutlulikdɑn	mutluluktɑn
nɑzɑrH	nɑzɑri	nɑzɑrɯ
normlH	normli	normlu
okurlArmHzHn	okurlɑrmizin	okurlɑrmɯzɯn
okurH	okuri	okuru
olmAmH	olmɑmi	olmɑmɯ
pɑmukDA	pɑmukdɑ	pɑmuktɑ
pɑtlɑmAHn	pɑtlɑmɑin	pɑtlɑmɑɯn
pɑtronlArH	pɑtronlɑri	pɑtronlɑrɯ
petrolA	petrolɑ	petrole
pistDA	pistde	pistte
polisDAn	polisden	polisten
reɑksijonHn	reɑksijonin	reɑksijonun
refɑhHn	refɑhin	refɑhɯn
sɑrɯmsH	sɑrɯmsi	sɑrɯmsɯ
sɑjdɑmlHk	sɑjdɑmlik	sɑjdɑmlɯk
seʧmADA	seʧmede	seʧmete
semptomH	semptomi	semptomu
semtDA	semtde	semtte
spektrumlH	spektrumli	spektrumlu
sporlArHHn	sporlɑriin	sporlɑrɯɯn
suʧHHn	suʧiin	suʧuun
sunuʤulArHn	sunuʤulɑrin	sunuʤulɑrɯn
tɑlepDAki	tɑlepdeki	tɑlepteki
tɑsɑrɯmlArHHn	tɑsɑrɯmlɑriin	tɑsɑrɯmlɑrɯɯn
tɑsɑrruflArHn	tɑsɑrruflɑrin	tɑsɑrruflɑrɯn
temɑslArH	temɑslɑri	temɑslɑrɯ
teminɑtHHn	teminɑtiin	teminɑtɯɯn
testDAn	testden	testten
tolerɑnslH	tolerɑnsli	tolerɑnslɯ
toprɑkDAki	toprɑkdɑki	toprɑktɑki
trɑvmɑlH	trɑvmɑli	trɑvmɑlɯ
tuʃlArHn	tuʃlɑrin	tuʃlɑrɯn
uʧurumH	uʧurumi	uʧurumu
ujgulɑHʤHH	ujgulɑiʤii	ujgulɑɯʤɯɯ
uzɑHp	uzɑip	uzɑɯp
voltɑʒH	voltɑʒi	voltɑʒɯ
jønetmelikDAki	jønetmelikdeki	jønetmelikteki
jɑʃlHlArH	jɑʃlilɑri	jɑʃlɯlɑrɯ
jɑkɯtHn	jɑkɯtin	jɑkɯtɯn
jɑklɑʃmAH	jɑklɑʃmɑi	jɑklɑʃmɑɯ
jɑmɑʧlArH	jɑmɑʧlɑri	jɑmɑʧlɑrɯ
jɑptɯrɯmH	jɑptɯrɯmi	jɑptɯrɯmɯ
jɑrɑrlAnHp	jɑrɑrlɑnip	jɑrɑrlɑnɯp
jɑrɑrlAnmAHn	jɑrɑrlɑnmɑin	jɑrɑrlɑnmɑɯn
jɑvrulArHn	jɑvrulɑrin	jɑvrulɑrɯn
jɑjɯlmɑHHn	jɑjɯlmɑiin	jɑjɯlmɑɯɯn
jɑjɯnlArmHz	jɑjɯnlɑrmiz	jɑjɯnlɑrmɯz
jɑzɑrlH	jɑzɑrli	jɑzɑrlɯ
jorumlArnHzH	jorumlɑrnizi	jorumlɑrnɯzɯ
ʧɯkɑrlArHn	ʧɯkɑrlɑrin	ʧɯkɑrlɑrɯn
ʧɑjlArH	ʧɑjlɑri	ʧɑjlɑrɯ
ɯsrɑrH	ɯsrɑri	ɯsrɑrɯ
ølʧysHz	ølʧysiz	ølʧysyz
ʃɑrtHn	ʃɑrtin	ʃɑrtɯn
ynHn	ynin	ynyn
ystmHzA	ystmize	ystmyze
ɑɰɑʧDA	ɑɰɑʧdɑ	ɑɰɑʧtɑ
ɑdɑmlArHn	ɑdɑmlɑrin	ɑdɑmlɑrɯn
ɑdetDAn	ɑdetden	ɑdetten
ɑlɯmHHn	ɑlɯmiin	ɑlɯmɯɯn
ɑlɯnHnʤA	ɑlɯninʤɑ	ɑlɯnɯnʤɑ
ɑldɑtHʤH	ɑldɑtiʤi	ɑldɑtɯʤɯ
ɑmɑtørlHk	ɑmɑtørlik	ɑmɑtørlyk
ɑmbɑrlH	ɑmbɑrli	ɑmbɑrlɯ
ɑrɯzɑH	ɑrɯzɑi	ɑrɯzɑɯ
ɑsistɑnlArHn	ɑsistɑnlɑrin	ɑsistɑnlɑrɯn
ɑtHʤH	ɑtiʤi	ɑtɯʤɯ
ɑtɑH	ɑtɑi	ɑtɑɯ
bɑroHHn	bɑroiin	bɑrouun
bɑsɯH	bɑsɯi	bɑsɯɯ
ʤyzdɑnlArH	ʤyzdɑnlɑri	ʤyzdɑnlɑrɯ
dyzenlemADA	dyzenlemede	dyzenlemete
deklɑrɑsjonH	deklɑrɑsjoni	deklɑrɑsjonu
depoHHn	depoiin	depouun
doɰDHkDAn	doɰdikden	doɰduktɑn
dozHHn	doziin	dozuun
durmADA	durmɑdɑ	durmɑtɑ
durumnHzH	durumnizi	durumnuzu
dujgulArmHzH	dujgulɑrmizi	dujgulɑrmɯzɯ
ebɑtDA	ebɑtdɑ	ebɑttɑ
etkinlHkDAn	etkinlikden	etkinlikten
fɯrkɑH	fɯrkɑi	fɯrkɑɯ
federɑsjonHHn	federɑsjoniin	federɑsjonuun
ferɑhlHk	ferɑhlik	ferɑhlɯk
festivɑlA	festivɑlɑ	festivɑle
finʤɑnH	finʤɑni	finʤɑnɯ
firmɑlArmHzHn	firmɑlɑrmizin	firmɑlɑrmɯzɯn
fijɑtlArmHz	fijɑtlɑrmiz	fijɑtlɑrmɯz
fijɑtDA	fijɑtdɑ	fijɑttɑ
gørynymHn	gørynymin	gørynymyn
gøryntyHHn	gøryntyiin	gøryntyyyn
gymrykDAn	gymrykden	gymrykten
grɑmlHk	grɑmlik	grɑmlɯk
hɑlkDA	hɑlkdɑ	hɑlktɑ
hɑstɑmHz	hɑstɑmiz	hɑstɑmɯz
hɑvuzHHn	hɑvuziin	hɑvuzuun
hɑvzɑlArH	hɑvzɑlɑri	hɑvzɑlɑrɯ
huzurlArnHzDA	huzurlɑrnizde	huzurlɑrnɯzdɑ
iddiɑHHn	iddiɑiin	iddiɑɯɯn
ihrɑʤɑtʧHA	ihrɑʤɑtʧiɑ	ihrɑʤɑtʧɯɑ
ihtijɑtlH	ihtijɑtli	ihtijɑtlɯ
infɑzH	infɑzi	infɑzɯ
istɑsjonlArHn	istɑsjonlɑrin	istɑsjonlɑrɯn
istɑsjonHn	istɑsjonin	istɑsjonun
istifɑH	istifɑi	istifɑɯ
itibɑrlH	itibɑrli	itibɑrlɯ
kɑbullAnmA	kɑbullɑnmɑ	kɑbullenme
kɑldɯrmAH	kɑldɯrmɑi	kɑldɯrmɑɯ
kɑlibrɑsjonH	kɑlibrɑsjoni	kɑlibrɑsjonu
kɑlpDAn	kɑlpdɑn	kɑlpten
kɑmpDAn	kɑmpdɑn	kɑmptɑn
kɑnɯtlAnmAH	kɑnɯtlɑnmɑi	kɑnɯtlɑnmɑɯ
kɑplAnArAk	kɑplɑnerek	kɑplɑnɑrɑk
klimɑlH	klimɑli	klimɑlɯ
kodlArHHn	kodlɑriin	kodlɑrɯɯn
kolonHn	kolonin	kolonun
kombinɑsjonlArH	kombinɑsjonlɑri	kombinɑsjonlɑrɯ
kontrɑtH	kontrɑti	kontrɑtɯ
kontrollArHHn	kontrollɑriin	kontrolleriin
konuʃmAlArHHn	konuʃmɑlɑriin	konuʃmɑlɑrɯɯn
korneɑHn	korneɑin	korneɑɯn
korumADA	korumɑdɑ	korumɑtɑ
kovuʃturmAH	kovuʃturmɑi	kovuʃturmɑɯ
kuʃɑklArH	kuʃɑklɑri	kuʃɑklɑrɯ
kurAʤAklArH	kurɑʤɑklɑri	kurɑʤɑklɑrɯ
kurbɑnHn	kurbɑnin	kurbɑnɯn
lɑfDA	lɑfdɑ	lɑftɑ
mytɑlɑɑH	mytɑlɑɑi	mytɑlɑɑɯ
mɑnzɑrɑH	mɑnzɑrɑi	mɑnzɑrɑɯ
mɑrkɑlArHHn	mɑrkɑlɑriin	mɑrkɑlɑrɯɯn
mɑjɑH	mɑjɑi	mɑjɑɯ
meʤlisDAki	meʤlisdeki	meʤlisteki
mektuplArHn	mektuplɑrin	mektuplɑrɯn
mesɑʒHHn	mesɑʒiin	mesɑʒɯɯn
metotlArHHn	metotlɑriin	metotlɑrɯɯn
odɑkDA	odɑkdɑ	odɑktɑ
oklArH	oklɑri	oklɑrɯ
okurjɑzɑrlHk	okurjɑzɑrlik	okurjɑzɑrlɯk
olgunlAʃmAH	olgunlɑʃmɑi	olgunlɑʃmɑɯ
olmAnHzA	olmɑnize	olmɑnɯzɑ
onlH	onli	onlu
otlArHn	otlɑrin	otlɑrɯn
ovɑHHn	ovɑiin	ovɑɯɯn
pɑslAnmA	pɑslenme	pɑslɑnmɑ
plɑnlAmAH	plɑnlɑmɑi	plɑnlɑmɑɯ
røportɑʒH	røportɑʒi	røportɑʒɯ
rɑfDA	rɑfdɑ	rɑftɑ
revizjonH	revizjoni	revizjonu
romɑnlArH	romɑnlɑri	romɑnlɑrɯ
sɯʤɑkDA	sɯʤɑkdɑ	sɯʤɑktɑ
sɯrtDA	sɯrtdɑ	sɯrttɑ
søzmH	søzmi	søzmy
sɑʧɯlHk	sɑʧɯlik	sɑʧɯlɯk
sɑlɑtɑH	sɑlɑtɑi	sɑlɑtɑɯ
sɑldɯrɯlArHHn	sɑldɯrɯlɑriin	sɑldɯrɯlɑrɯɯn
sɑntrɑllArHHn	sɑntrɑllɑriin	sɑntrɑllɑrɯɯn
sɑjmHzHn	sɑjmizin	sɑjmɯzɯn
sɑjgɯH	sɑjgɯi	sɑjgɯɯ
sedɑsHz	sedɑsiz	sedɑsɯz
senɑrjoHn	senɑrjoin	senɑrjoun
senɑrjoH	senɑrjoi	senɑrjou
sendromHHn	sendromiin	sendromuun
senetDA	senetde	senette
sevinʧDAn	sevinʧden	sevinʧten
sormAH	sormɑi	sormɑɯ
sorumlHlArHn	sorumlilɑrin	sorumlulɑrɯn
tɯklADHkDAn	tɯklɑdikden	tɯklɑdɯktɑn
tɑʃɯtHn	tɑʃɯtin	tɑʃɯtɯn
tɑblɑH	tɑblɑi	tɑblɑɯ
tɑmɑmlɑnmAHHn	tɑmɑmlɑnmɑiin	tɑmɑmlɑnmɑɯɯn
tohumlArHn	tohumlɑrin	tohumlɑrɯn
toplArH	toplɑri	toplɑrɯ
tutɑnɑklArHHn	tutɑnɑklɑriin	tutɑnɑklɑrɯɯn
tutumHHn	tutumiin	tutumuun
uʧHʃlAr	uʧiʃlɑr	uʧuʃlɑr
ujkuHn	ujkuin	ujkuun
uzɑnHp	uzɑnip	uzɑnɯp
jyzjɯllHk	jyzjɯllik	jyzjɯllɯk
jɑnɯtDA	jɑnɯtdɑ	jɑnɯttɑ
jɑrɯjɯllHk	jɑrɯjɯllik	jɑrɯjɯllɯk
jɑsɑlAʃmAH	jɑsɑlɑʃmɑi	jɑsɑlɑʃmɑɯ
jɑstɯklArH	jɑstɯklɑri	jɑstɯklɑrɯ
jɑvɑʃlAmAH	jɑvɑʃlɑmɑi	jɑvɑʃlɑmɑɯ
jokuʃH	jokuʃi	jokuʃu
