Word	UF	SF	Freq
yhdistää	yhdistæA	yhdistææ	4075
hankkia	hɑnkkiA	hɑnkkiɑ	4031
varustettu	vɑrustettU	vɑrustettu	2400
vastausta	vɑstɑUstA	vɑstɑustɑ	2392
velvollisuus	velvollisUUs	velvollisuus	2254
voittoa	voittoA	voittoɑ	2033
neuvostoa	neuvostoA	neuvostoɑ	1785
viettää	viettæA	viettææ	1688
otteeseen	otteeseen	otteeseen	1670
television	television	television	1518
lääketieteen	lææketieteen	lææketieteen	1438
mestari	mestɑri	mestɑri	1412
vienti	vienti	vienti	1258
perusteltu	perusteltU	perusteltu	1151
ehdolla	ehdollA	ehdollɑ	999
vapaaehtoisesti	vɑpɑAehtoisesti	vɑpɑɑehtoisesti	963
ulkomaiset	ulkomɑiset	ulkomɑiset	813
muisti	muisti	muisti	787
tultava	tultAvA	tultɑvɑ	761
tuonnin	tuonnin	tuonnin	736
kymmenien	kymmenien	kymmenien	733
lappeenranta	lɑppeenrɑntɑ	lɑppeenrɑntɑ	705
järjestystä	jærjestUstA	jærjestystæ	680
torstaisin	torstɑisin	torstɑisin	667
urheilua	urheilUA	urheiluɑ	607
daniel	dɑniel	dɑniel	565
kuolla	kuollA	kuollɑ	538
vaikutusvaltaa	vɑikutUsvɑltɑA	vɑikutusvɑltɑɑ	531
kestävyys	kestævUUs	kestævyys	518
bryssel	bryssel	bryssel	483
eduskuntaryhmän	eduskuntɑryhmæn	eduskuntɑryhmæn	482
pahat	pɑhɑt	pɑhɑt	457
ajoilta	ɑjoiltA	ɑjoiltɑ	444
kertomalla	kertomAllA	kertomɑllɑ	417
pitämistä	pitæmistA	pitæmistæ	400
rakennusluvan	rɑkennUsluvɑn	rɑkennusluvɑn	375
ainuttakaan	ɑinuttAkAAn	ɑinuttɑkɑɑn	364
sillanpää	sillɑnpææ	sillɑnpææ	360
hävitä	hævitA	hævitæ	353
tilastollisesti	tilɑstollisesti	tilɑstollisesti	345
myöhemmässä	myøhemmAssA	myøhemmæssæ	342
yllättäviä	yllættAviA	yllættæviæ	307
laude	lɑude	lɑude	305
istuin	istuin	istuin	298
tarjoaisi	tɑrjoɑisi	tɑrjoɑisi	281
teoista	teoistA	teoistɑ	275
luettavaksi	luettAvAksi	luettɑvɑksi	270
korkeakoulusta	korkeɑkoulustA	korkeɑkoulustɑ	262
puhdistamon	puhdistɑmon	puhdistɑmon	241
kokeisiin	kokeisiin	kokeisiin	233
veronmaksajille	veronmɑksɑjille	veronmɑksɑjille	232
ostovoimaa	ostovoimɑɑ	ostovoimɑɑ	227
verrattiin	verrɑttiin	verrɑttiin	222
nettiin	nettiin	nettiin	215
jerry	jerry	jerry	209
poimittu	poimittU	poimittu	191
näytteillä	næytteillA	næytteillæ	185
kana	kɑnɑ	kɑnɑ	182
poltettiin	poltettiin	poltettiin	181
pukeutua	pukeUtUA	pukeutuɑ	178
collins	kollins	kollins	175
elämäntapaan	elæmAntɑpɑAn	elæmæntɑpɑɑn	174
rekisteriä	rekisteriA	rekisteriæ	173
elvis	elvis	elvis	167
liikenneväylien	liikennevæylien	liikennevæylien	166
kokoelmaa	kokoelmɑA	kokoelmɑɑ	165
varmemmin	vɑrmemmin	vɑrmemmin	162
terveyspalveluja	terveUspɑlvelUjA	terveyspɑlvelujɑ	158
hakemuksesi	hɑkemuksesi	hɑkemuksesi	157
nykytilan	nykytilɑn	nykytilɑn	153
talvesta	tɑlvestA	tɑlvestɑ	151
estämistä	estæmistA	estæmistæ	150
seuransa	seurɑnsA	seurɑnsɑ	148
milligrammaa	milligrɑmmɑA	milligrɑmmɑɑ	144
collinsin	kollinsin	kollinsin	143
menetelmänä	menetelmænA	menetelmænæ	139
voitelu	voitelU	voitelu	138
viimeaikainen	viimeɑikɑinen	viimeɑikɑinen	137
eno	eno	eno	136
karhunen	kɑrhunen	kɑrhunen	134
monikansallisia	monikɑnsɑllisiA	monikɑnsɑllisiɑ	134
kaatuvat	kɑɑtuvAt	kɑɑtuvɑt	126
vaimoaan	vɑimoAAn	vɑimoɑɑn	124
virtaava	virtɑɑvA	virtɑɑvɑ	120
ruuhka	ruuhkɑ	ruuhkɑ	119
yksilöille	yksiløille	yksiløille	119
myynnillä	myynnillA	myynnillæ	113
henkivakuutusyhtiö	henkivɑkuutUsyhtiø	henkivɑkuutusyhtiø	112
rentouttaa	rentouttɑA	rentouttɑɑ	110
valmistaudumme	vɑlmistɑudumme	vɑlmistɑudumme	110
katsellen	kɑtsellen	kɑtsellen	107
murtamaan	murtɑmAAn	murtɑmɑɑn	104
pukeutuu	pukeUtUU	pukeutuu	103
ympäristömerkin	ympæristømerkin	ympæristømerkin	103
löytäneensä	løytæneensA	løytæneensæ	102
olympiajoukkueen	olympiɑjoukkueen	olympiɑjoukkueen	101
tunnelia	tunneliA	tunneliɑ	100
koulutettavien	koulutettAvien	koulutettɑvien	99
junia	juniA	juniɑ	98
matkakulujen	mɑtkɑkulujen	mɑtkɑkulujen	97
ideologisia	ideologisiA	ideologisiɑ	96
kilpailutetaan	kilpɑilUtetAAn	kilpɑilutetɑɑn	96
sotarikoksista	sotɑrikoksistA	sotɑrikoksistɑ	96
pyöritetään	pyøritetAAn	pyøritetææn	95
joosefin	joosefin	joosefin	94
eduskuntavaaleja	eduskuntɑvɑɑlejA	eduskuntɑvɑɑlejɑ	92
hetkellinen	hetkellinen	hetkellinen	90
helmassa	helmɑssA	helmɑssɑ	88
kuvana	kuvɑnA	kuvɑnɑ	88
omistautua	omistɑutuA	omistɑutuɑ	88
sinetti	sinetti	sinetti	88
viimeistelyssä	viimeistelUssA	viimeistelyssæ	88
venäläisjoukkojen	venælæisjoukkojen	venælæisjoukkojen	87
päinvastaiseksi	pæinvɑstɑiseksi	pæinvɑstɑiseksi	85
vanhenemiseen	vɑnhenemiseen	vɑnhenemiseen	84
luontotyypin	luontotyypin	luontotyypin	82
loukkuun	loukkuUn	loukkuun	81
sipoossa	sipoossA	sipoossɑ	81
tilaansa	tilɑAnsA	tilɑɑnsɑ	81
mongolian	mongoliɑn	mongoliɑn	79
kokkolasta	kokkolɑstA	kokkolɑstɑ	78
suojele	suojele	suojele	77
kemiaan	kemiɑAn	kemiɑɑn	76
alakanttiin	ɑlɑkɑnttiin	ɑlɑkɑnttiin	75
oikeampi	oikeɑmpi	oikeɑmpi	75
yhdeksättä	yhdeksættA	yhdeksættæ	75
rotko	rotko	rotko	74
ehdotuksiamme	ehdotUksiAmme	ehdotuksiɑmme	73
selviämme	selviAmme	selviæmme	71
helppoutta	helppoUttA	helppouttɑ	69
kyproksessa	kyproksessA	kyproksessɑ	67
lopputuloksissa	lopputuloksissA	lopputuloksissɑ	67
yrityskohtaiset	yritUskohtɑiset	yrityskohtɑiset	67
erikoisjoukot	erikoisjoukot	erikoisjoukot	66
hammashoitoon	hɑmmɑshoitoOn	hɑmmɑshoitoon	63
sarparanta	sɑrpɑrɑntɑ	sɑrpɑrɑntɑ	62
katselemme	kɑtselemme	kɑtselemme	61
kultamitali	kultɑmitɑli	kultɑmitɑli	61
kummasteli	kummɑsteli	kummɑsteli	61
pätevänä	pætevAnA	pætevænæ	61
ruoppauksen	ruoppɑUksen	ruoppɑuksen	61
palkatut	pɑlkɑtUt	pɑlkɑtut	60
totuuksien	totuuksien	totuuksien	60
kapteenina	kɑpteeninA	kɑpteeninɑ	59
siveltimen	siveltimen	siveltimen	59
neuvonnalla	neuvonnɑllA	neuvonnɑllɑ	57
mediatapahtuma	mediɑtɑpɑhtumɑ	mediɑtɑpɑhtumɑ	56
osioista	osioistA	osioistɑ	56
tulkitsemme	tulkitsemme	tulkitsemme	56
kara	kɑrɑ	kɑrɑ	55
käytännöllisyyttä	kæytænnøllisUUttA	kæytænnøllisyyttæ	54
lukiolaisen	lukiolɑisen	lukiolɑisen	54
lämmitin	læmmitin	læmmitin	54
pressin	pressin	pressin	54
aikuisväestöstä	ɑikuisvæestøstA	ɑikuisvæestøstæ	53
jumbo	jumbo	jumbo	53
jäänevät	jæænevAt	jæænevæt	53
kaatuisi	kɑɑtuisi	kɑɑtuisi	53
huippukokouksia	huippukokouksiA	huippukokouksiɑ	52
nuoruustyypin	nuorUUstyypin	nuoruustyypin	51
reumaa	reumɑA	reumɑɑ	50
uhkasta	uhkɑstA	uhkɑstɑ	50
budjettivaroista	budjettivɑroistA	budjettivɑroistɑ	49
puheenjohtajakokoukselle	puheenjohtɑjAkokoukselle	puheenjohtɑjɑkokoukselle	49
skitsofrenia	skitsofreniɑ	skitsofreniɑ	49
keraaminen	kerɑɑminen	kerɑɑminen	48
kuuntelisi	kuuntelisi	kuuntelisi	48
turvallisuusneuvostoon	turvɑllisUUsneuvostoOn	turvɑllisuusneuvostoon	48
katolilaiset	kɑtolilɑiset	kɑtolilɑiset	47
olki	olki	olki	47
tartumme	tɑrtumme	tɑrtumme	47
estäjä	estæjA	estæjæ	46
kovempaan	kovempAAn	kovempɑɑn	46
moosekselle	moosekselle	moosekselle	46
shanghaissa	shɑnghɑissA	shɑnghɑissɑ	46
ajojen	ɑjojen	ɑjojen	45
katoilla	kɑtoillA	kɑtoillɑ	45
peitellään	peitellAAn	peitellææn	45
roomalaiskirjeen	roomɑlɑiskirjeen	roomɑlɑiskirjeen	45
kenraalieversti	kenrɑɑlieversti	kenrɑɑlieversti	44
määrittelisi	mæærittelisi	mæærittelisi	44
pienennettiin	pienennettiin	pienennettiin	44
folk	folk	folk	43
tulojaan	tulojAAn	tulojɑɑn	43
työttömiin	tyøttOmiin	tyøttømiin	43
ylhäältäpäin	ylhææltApæin	ylhææltæpæin	43
tilinpäätöstietojen	tilinpæætøstietojen	tilinpæætøstietojen	42
avausraita	ɑvɑUsrɑitɑ	ɑvɑusrɑitɑ	41
euroseteleiden	euroseteleiden	euroseteleiden	41
joulukorttien	joulukorttien	joulukorttien	41
musiikissaan	musiikissAAn	musiikissɑɑn	41
naapurikuntiin	nɑɑpurikuntiin	nɑɑpurikuntiin	41
palkansaajilla	pɑlkɑnsɑɑjillA	pɑlkɑnsɑɑjillɑ	41
rippikirjat	rippikirjɑt	rippikirjɑt	41
mongoliassa	mongoliɑssA	mongoliɑssɑ	40
saumaa	sɑumɑA	sɑumɑɑ	40
lomituksen	lomitUksen	lomituksen	39
dortmundissa	dortmundissA	dortmundissɑ	37
iltalehdessä	iltɑlehdessA	iltɑlehdessæ	37
korjausavustukset	korjɑUsɑvustUkset	korjɑusɑvustukset	37
liikuntavammaisille	liikuntAvɑmmɑisille	liikuntɑvɑmmɑisille	37
pituisiksi	pituisiksi	pituisiksi	37
sidottuina	sidottUinA	sidottuinɑ	37
vähistä	væhistA	væhistæ	37
keräämän	kerææmAn	kerææmæn	36
rokotetut	rokotetUt	rokotetut	35
sotarikolliset	sotɑrikolliset	sotɑrikolliset	35
sumea	sumeɑ	sumeɑ	35
uudenaikaistaa	uudenɑikɑistɑA	uudenɑikɑistɑɑ	35
varmuudesta	vɑrmUUdestA	vɑrmuudestɑ	35
kaatopaikkajätteen	kɑɑtopɑikkɑjætteen	kɑɑtopɑikkɑjætteen	34
kansallispuolueen	kɑnsɑllispuolueen	kɑnsɑllispuolueen	34
purjehtinut	purjehtinUt	purjehtinut	34
tarjoavaa	tɑrjoɑvAA	tɑrjoɑvɑɑ	34
vapaaehtoistyöntekijät	vɑpɑAehtoistyøntekijæt	vɑpɑɑehtoistyøntekijæt	34
aikoneet	ɑikoneet	ɑikoneet	33
tehdyiksi	tehdUiksi	tehdyiksi	33
erimielisyytemme	erimielisUUtemme	erimielisyytemme	32
liittoutunut	liittoutunUt	liittoutunut	32
meriliikenteessä	meriliikenteessA	meriliikenteessæ	32
mielenterveyspalveluja	mielenterveUspɑlvelUjA	mielenterveyspɑlvelujɑ	32
ääninäytteitä	ææninæytteitA	ææninæytteitæ	32
ambulanssia	ɑmbulɑnssiA	ɑmbulɑnssiɑ	31
hankkimia	hɑnkkimiA	hɑnkkimiɑ	31
huolellisuudella	huolellisUUdellA	huolellisuudellɑ	31
ikaalislainen	ikɑɑlislAinen	ikɑɑlislɑinen	31
kitkettävä	kitkettAvA	kitkettævæ	31
otetaankin	otetAAnkin	otetɑɑnkin	31
uhkaillaan	uhkɑillAAn	uhkɑillɑɑn	31
kasvuennusteet	kɑsvuennusteet	kɑsvuennusteet	30
kuppiin	kuppiin	kuppiin	30
raamien	rɑɑmien	rɑɑmien	30
tihkusadetta	tihkusɑdettA	tihkusɑdettɑ	30
uhista	uhistA	uhistɑ	30
viljatuotteet	viljɑtuotteet	viljɑtuotteet	30
muistonsa	muistonsA	muistonsɑ	29
sovelluksien	sovellUksien	sovelluksien	29
juoksutetaan	juoksutetAAn	juoksutetɑɑn	28
korottaisi	korottɑisi	korottɑisi	28
kuvistaan	kuvistAAn	kuvistɑɑn	28
käsitettiin	kæsitettiin	kæsitettiin	28
luulevan	luulevAn	luulevɑn	28
kovettaa	kovettɑA	kovettɑɑ	27
lainmuutokset	lɑinmuutokset	lɑinmuutokset	27
vastustajamme	vɑstustɑjAmme	vɑstustɑjɑmme	27
vuokrattavista	vuokrɑttAvistA	vuokrɑttɑvistɑ	27
ratian	rɑtiɑn	rɑtiɑn	26
sytyttämään	sytyttAmAAn	sytyttæmææn	26
terroristiryhmä	terroristiryhmæ	terroristiryhmæ	26
turkulaisessa	turkulAisessA	turkulɑisessɑ	26
karhunpalvelus	kɑrhunpɑlvelus	kɑrhunpɑlvelus	25
kelpoisuusvaatimuksia	kelpoisUUsvɑɑtimuksiA	kelpoisuusvɑɑtimuksiɑ	25
kirkkoherranviraston	kirkkoherrɑnvirɑston	kirkkoherrɑnvirɑston	25
kohteliaisuuksia	kohteliɑisUUksiA	kohteliɑisuuksiɑ	25
manchesterissa	mɑnkhesterissA	mɑnkhesterissɑ	25
edustajanaan	edustAjɑnɑAn	edustɑjɑnɑɑn	24
erotetulla	erotetUllA	erotetullɑ	24
monikulttuuriseen	monikulttuuriseen	monikulttuuriseen	24
multimediaesitys	multimediɑesitUs	multimediɑesitys	24
murentua	murentuA	murentuɑ	24
parhaimmasta	pɑrhɑimmAstA	pɑrhɑimmɑstɑ	24
poijut	poijut	poijut	24
teollisuudenaloista	teollisUUdenɑloistA	teollisuudenɑloistɑ	24
työllisyyskehityksen	tyøllisUUskehitUksen	tyøllisyyskehityksen	24
vaativimmista	vɑɑtivimmistA	vɑɑtivimmistɑ	24
varaedustaja	vɑrɑedustɑjA	vɑrɑedustɑjɑ	24
verokiilan	verokiilɑn	verokiilɑn	24
erorahaston	erorɑhɑston	erorɑhɑston	23
foorumille	foorumille	foorumille	23
huntua	huntuA	huntuɑ	23
jäsenkuntaan	jæsenkuntɑAn	jæsenkuntɑɑn	23
pakolaisasema	pɑkolɑisɑsemɑ	pɑkolɑisɑsemɑ	23
asianosaisena	ɑsiɑnosɑisenA	ɑsiɑnosɑisenɑ	22
avaamasta	ɑvɑɑmAstA	ɑvɑɑmɑstɑ	22
erityistehtäviin	erityistehtæviin	erityistehtæviin	22
harrastuksessaan	hɑrrɑstUksessAAn	hɑrrɑstuksessɑɑn	22
heikkouksistaan	heikkoUksistAAn	heikkouksistɑɑn	22
hienostuneesti	hienostuneesti	hienostuneesti	22
höystää	høystæA	høystææ	22
ilmaisulle	ilmɑisUlle	ilmɑisulle	22
listautuminen	listɑutuminen	listɑutuminen	22
purjehtijan	purjehtijAn	purjehtijɑn	22
rauhankehityksen	rɑuhɑnkehitUksen	rɑuhɑnkehityksen	22
sikanen	sikɑnen	sikɑnen	22
toimintasuunnitelmassaan	toimintAsuunnitelmɑssAAn	toimintɑsuunnitelmɑssɑɑn	22
toteutusaika	toteutUsɑikɑ	toteutusɑikɑ	22
valitusoikeuden	vɑlitUsoikeUden	vɑlitusoikeuden	22
kohtamaan	kohtɑmɑɑn	kohtɑmɑɑn	21
laboratorioinsinööri	lɑborɑtorioinsinøøri	lɑborɑtorioinsinøøri	21
luutunut	luutunUt	luutunut	21
meluhaitta	meluhɑittA	meluhɑittɑ	21
näsijärvestä	næsijærvestA	næsijærvestæ	21
ostamat	ostɑmAt	ostɑmɑt	21
piikkiöläisen	piikkiølAisen	piikkiølæisen	21
piiraita	piirɑitɑ	piirɑitɑ	21
poikastuotanto	poikɑstuotɑnto	poikɑstuotɑnto	21
röntgenlaitteen	røntgenlɑitteen	røntgenlɑitteen	21
santarmien	sɑntɑrmien	sɑntɑrmien	21
stipendeistä	stipendeistA	stipendeistæ	21
tuuraa	tuurɑA	tuurɑɑ	21
harkitsemattomia	hɑrkitsemAttOmiA	hɑrkitsemɑttomiɑ	20
honkahovin	honkɑhovin	honkɑhovin	20
irrotettavan	irrotettAvAn	irrotettɑvɑn	20
merkkituotteiden	merkkituotteiden	merkkituotteiden	20
noudatellen	noudɑtellen	noudɑtellen	20
näkemyksistämme	nækemyksistAmme	nækemyksistæmme	20
päivitettyjä	pæivitettUjA	pæivitettyjæ	20
surivat	surivAt	surivɑt	20
talouspaperit	tɑlouspɑperit	tɑlouspɑperit	20
teollistuneet	teollistUneet	teollistuneet	20
tiedonsaantioikeuden	tiedonsɑɑntioikeUden	tiedonsɑɑntioikeuden	20
täpötäysi	tæpøtæysi	tæpøtæysi	20
vehkeitä	vehkeitA	vehkeitæ	20
housun	housun	housun	19
kulkeeko	kulkeekO	kulkeeko	19
leikkaussaliin	leikkɑUssɑliin	leikkɑussɑliin	19
peittoaa	peittoɑA	peittoɑɑ	19
silfverberg	silfverberg	silfverberg	19
suomenruotsalaisia	suomenruotsɑlɑisiA	suomenruotsɑlɑisiɑ	19
syyteharkinta	syytehɑrkintA	syytehɑrkintɑ	19
toimitustyöhön	toimitUstyøhOn	toimitustyøhøn	19
ulospäinsuuntautunut	ulospæinsuuntɑutunut	ulospæinsuuntɑutunut	19
hongalle	hongɑlle	hongɑlle	18
kehittäjiin	kehittæjiin	kehittæjiin	18
kumoutuu	kumoutuU	kumoutuu	18
neuvontapalveluihin	neuvontɑpɑlvelUihin	neuvontɑpɑlveluihin	18
nimiroolin	nimiroolin	nimiroolin	18
nostavaa	nostɑvAA	nostɑvɑɑ	18
odotuksille	odotUksille	odotuksille	18
virheeni	virheeni	virheeni	18
yllättävässä	yllættAvAssA	yllættævæssæ	18
arvonmääritys	ɑrvonmææritUs	ɑrvonmææritys	17
boori	boori	boori	17
henkäyksen	henkæyksen	henkæyksen	17
istumapaikka	istumApɑikkɑ	istumɑpɑikkɑ	17
kerrosneliömetrin	kerrosneliømetrin	kerrosneliømetrin	17
kokeilevia	kokeileviA	kokeileviɑ	17
liittovaltioiden	liittovɑltioiden	liittovɑltioiden	17
lumikko	lumikko	lumikko	17
luutuneita	luutuneitA	luutuneitɑ	17
pikkusiskonsa	pikkusiskonsA	pikkusiskonsɑ	17
rauhasten	rɑuhɑsten	rɑuhɑsten	17
tapaukselle	tɑpɑUkselle	tɑpɑukselle	17
toimintavuottaan	toimintAvuottAAn	toimintɑvuottɑɑn	17
ammattiauttajia	ɑmmɑttiɑuttɑjiA	ɑmmɑttiɑuttɑjiɑ	16
aurausta	ɑurɑUstA	ɑurɑustɑ	16
haudutettu	hɑudutettU	hɑudutettu	16
hylsyihin	hylsyihin	hylsyihin	16
kali	kɑli	kɑli	16
oraat	orɑɑt	orɑɑt	16
otettavalle	otettAvAlle	otettɑvɑlle	16
raidoista	rɑidoistA	rɑidoistɑ	16
rokottamalla	rokottɑmAllA	rokottɑmɑllɑ	16
sotasaaliiksi	sotɑsɑɑliiksi	sotɑsɑɑliiksi	16
valitusosoituksen	vɑlitUsosoitUksen	vɑlitusosoituksen	16
vastaantuloa	vɑstɑAntuloA	vɑstɑɑntuloɑ	16
äänestäneeni	æænestæneeni	æænestæneeni	16
jumbona	jumbonA	jumbonɑ	15
lonkkamurtuman	lonkkɑmurtumɑn	lonkkɑmurtumɑn	15
psykoottisia	psykoottisiA	psykoottisiɑ	15
seikaksi	seikɑksi	seikɑksi	15
särkikalojen	særkikɑlojen	særkikɑlojen	15
äärioikeistolaisuuden	æærioikeistolɑisUUden	æærioikeistolɑisuuden	15
eliölajeille	eliølɑjeille	eliølɑjeille	14
intohimoisena	intohimoisenA	intohimoisenɑ	14
jäänmurtajien	jæænmurtɑjien	jæænmurtɑjien	14
kansainvälisenkin	kɑnsɑinvælisenkin	kɑnsɑinvælisenkin	14
kuusituntinen	kuusituntinen	kuusituntinen	14
motivoivaksi	motivoivAksi	motivoivɑksi	14
palvelumuodon	pɑlvelUmuodon	pɑlvelumuodon	14
pelastustehtäviin	pelɑstUstehtæviin	pelɑstustehtæviin	14
päätyyppiin	pæætyyppiin	pæætyyppiin	14
raportoinnilla	rɑportoinnillA	rɑportoinnillɑ	14
rentouttamaan	rentouttɑmAAn	rentouttɑmɑɑn	14
söderholmin	søderholmin	søderholmin	14
tulkkipalvelu	tulkkipɑlvelU	tulkkipɑlvelu	14
työssäkin	tyøssAkin	tyøssækin	14
vaellan	vɑellɑn	vɑellɑn	14
valjastamista	vɑljɑstɑmistA	vɑljɑstɑmistɑ	14
vastaanottonsa	vɑstɑAnottonsA	vɑstɑɑnottonsɑ	14
vähimmäistasoja	væhimmæistɑsojA	væhimmæistɑsojɑ	14
yleispätevän	yleispætevAn	yleispætevæn	14
aiottuja	ɑiottUjA	ɑiottujɑ	13
humussa	humussA	humussɑ	13
inkarnaatio	inkɑrnɑɑtio	inkɑrnɑɑtio	13
kaunotarta	kɑunotɑrtA	kɑunotɑrtɑ	13
keskuskirjastona	keskuskirjɑstonA	keskuskirjɑstonɑ	13
kohentamalla	kohentAmAllA	kohentɑmɑllɑ	13
kokonaisratkaisuihin	kokonɑisrɑtkɑisUihin	kokonɑisrɑtkɑisuihin	13
laatijaksi	lɑɑtijAksi	lɑɑtijɑksi	13
lapsuusmuistot	lɑpsuusmuistot	lɑpsuusmuistot	13
loiskis	loiskis	loiskis	13
lomarakennusta	lomɑrɑkennUstA	lomɑrɑkennustɑ	13
mitalisijoista	mitɑlisijoistA	mitɑlisijoistɑ	13
peltinen	peltinen	peltinen	13
saaliisiin	sɑɑliisiin	sɑɑliisiin	13
sivuseinät	sivuseinæt	sivuseinæt	13
sopimuskorotuksista	sopimuskorotUksistA	sopimuskorotuksistɑ	13
terveyspäivän	terveUspæivæn	terveyspæivæn	13
toteutuskelpoisia	toteutUskelpoisiA	toteutuskelpoisiɑ	13
väestönlaskennan	væestønlɑskennAn	væestønlɑskennɑn	13
ajanmukaisuudesta	ɑjɑnmukɑisUUdestA	ɑjɑnmukɑisuudestɑ	12
alalajia	ɑlɑlɑjiA	ɑlɑlɑjiɑ	12
hameeseen	hɑmeeseen	hɑmeeseen	12
hovinheimon	hovinheimon	hovinheimon	12
hyvitettävä	hyvitettAvA	hyvitettævæ	12
höyrykattila	høyrykɑttilɑ	høyrykɑttilɑ	12
jokavuotisia	jokAvuotisiA	jokɑvuotisiɑ	12
jouluruoat	jouluruoɑt	jouluruoɑt	12
kalaniemen	kɑlɑniemen	kɑlɑniemen	12
kiimassa	kiimɑssA	kiimɑssɑ	12
kohenemisen	kohenemisen	kohenemisen	12
kristiinankaupungista	kristiinɑnkɑupungistA	kristiinɑnkɑupungistɑ	12
kylpyhuoneesta	kylpyhuoneestA	kylpyhuoneestɑ	12
kyyjärveltä	kyyjærveltA	kyyjærveltæ	12
lastenteatteri	lɑstenteɑtteri	lɑstenteɑtteri	12
lehterin	lehterin	lehterin	12
luonnehdittava	luonnehdittAvA	luonnehdittɑvɑ	12
mielipidekyselyyn	mielipidekyselUUn	mielipidekyselyyn	12
minimivaatimusten	minimivɑɑtimusten	minimivɑɑtimusten	12
neuvontatoimistoon	neuvontɑtoimistoOn	neuvontɑtoimistoon	12
opiskelijamääriä	opiskelijAmææriA	opiskelijɑmææriæ	12
rintamasotilastunnusta	rintɑmɑsotilɑstunnustA	rintɑmɑsotilɑstunnustɑ	12
sähkönsaanti	sæhkønsɑɑnti	sæhkønsɑɑnti	12
taistelukoneiden	tɑistelUkoneiden	tɑistelukoneiden	12
tarttuvaan	tɑrttuvAAn	tɑrttuvɑɑn	12
tasokkuus	tɑsokkUUs	tɑsokkuus	12
tipin	tipin	tipin	12
vaalikeskustelua	vɑɑlikeskustelUA	vɑɑlikeskusteluɑ	12
villasukkia	villɑsukkiA	villɑsukkiɑ	12
epäuskottavan	epæuskottAvAn	epæuskottɑvɑn	11
hokemia	hokemiA	hokemiɑ	11
huolisi	huolisi	huolisi	11
huoltotöihin	huoltotøihin	huoltotøihin	11
kalanviljelylaitoksissa	kɑlɑnviljelUlɑitoksissA	kɑlɑnviljelylɑitoksissɑ	11
kunnianarvoisalle	kunniɑnɑrvoisɑlle	kunniɑnɑrvoisɑlle	11
käytösrangaistuksen	kæytøsrɑngɑistuksen	kæytøsrɑngɑistuksen	11
langetettujen	lɑngetettUjen	lɑngetettujen	11
luomisvoiman	luomisvoimɑn	luomisvoimɑn	11
metsämannut	metsæmɑnnut	metsæmɑnnut	11
oikeaoppisuuden	oikeɑoppisUUden	oikeɑoppisuuden	11
ongelmaluotot	ongelmɑluotot	ongelmɑluotot	11
otsasta	otsɑstA	otsɑstɑ	11
paikallisjunalla	pɑikɑllisjunɑllA	pɑikɑllisjunɑllɑ	11
peitetyksi	peitetUksi	peitetyksi	11
syliisi	syliisi	syliisi	11
teatterisalin	teɑtterisɑlin	teɑtterisɑlin	11
verillä	verillA	verillæ	11
verrokkeja	verrokkejA	verrokkejɑ	11
vesikon	vesikon	vesikon	11
vihollisiamme	vihollisiAmme	vihollisiɑmme	11
allergisuus	ɑllergisUUs	ɑllergisuus	10
arabiemiirikunnissa	ɑrɑbiemiirikunnissA	ɑrɑbiemiirikunnissɑ	10
efedriinin	efedriinin	efedriinin	10
eilat	eilɑt	eilɑt	10
hallinnonaloja	hɑllinnonɑlojA	hɑllinnonɑlojɑ	10
hypoteettisia	hypoteettisiA	hypoteettisiɑ	10
irrotettavaa	irrotettAvAA	irrotettɑvɑɑ	10
juoksuttivat	juoksuttivAt	juoksuttivɑt	10
kattaneen	kɑttɑneen	kɑttɑneen	10
keräämäni	kerææmAni	kerææmæni	10
kestävyydestään	kestævUUdestAAn	kestævyydestææn	10
kimpale	kimpɑle	kimpɑle	10
kotioloista	kotioloistA	kotioloistɑ	10
kuljetusmäärät	kuljetUsmææræt	kuljetusmææræt	10
laukkaamaan	lɑukkɑɑmAAn	lɑukkɑɑmɑɑn	10
metsäkauriin	metsækɑuriin	metsækɑuriin	10
naamiota	nɑɑmiotA	nɑɑmiotɑ	10
nettoaa	nettoɑA	nettoɑɑ	10
osastonaan	osɑstonAAn	osɑstonɑɑn	10
pengerkatu	pengerkɑtu	pengerkɑtu	10
pesimärauha	pesimArɑuhɑ	pesimærɑuhɑ	10
päätynee	pæætynee	pæætynee	10
rauhallisempaan	rɑuhɑllisempAAn	rɑuhɑllisempɑɑn	10
rekisterinpitäjät	rekisterinpitæjAt	rekisterinpitæjæt	10
savilahdentie	sɑvilɑhdentie	sɑvilɑhdentie	10
sekajätteiden	sekɑjætteiden	sekɑjætteiden	10
siimasta	siimɑstA	siimɑstɑ	10
säästöistään	sææstøistAAn	sææstøistææn	10
teheraniin	teherɑniin	teherɑniin	10
tekijöineen	tekijøineen	tekijøineen	10
trooppiseen	trooppiseen	trooppiseen	10
valmistusvaiheissa	vɑlmistUsvɑiheissA	vɑlmistusvɑiheissɑ	10
varastohallin	vɑrɑstohɑllin	vɑrɑstohɑllin	10
yksityisautoja	yksityisɑutojA	yksityisɑutojɑ	10
ympäristömerkinnät	ympæristømerkinnAt	ympæristømerkinnæt	10
ahdistetun	ɑhdistetUn	ɑhdistetun	9
ajosuuntaa	ɑjosuuntɑA	ɑjosuuntɑɑ	9
elämänkertoja	elæmAnkertojA	elæmænkertojɑ	9
hiiriin	hiiriin	hiiriin	9
kaakkoisrajan	kɑɑkkoisrɑjɑn	kɑɑkkoisrɑjɑn	9
kaksinaisen	kɑksinɑisen	kɑksinɑisen	9
karkottavan	kɑrkottɑvAn	kɑrkottɑvɑn	9
kestosuosikit	kestosuosikit	kestosuosikit	9
kuluttajaliitosta	kuluttAjAliitostA	kuluttɑjɑliitostɑ	9
laskijoiden	lɑskijOiden	lɑskijoiden	9
lattiakaivo	lɑttiɑkɑivo	lɑttiɑkɑivo	9
mäkikotkat	mækikotkɑt	mækikotkɑt	9
opiskelutapojen	opiskelUtɑpojen	opiskelutɑpojen	9
puimuria	puimuriA	puimuriɑ	9
päivätyökeräyksen	pæivætyøkeræUksen	pæivætyøkeræyksen	9
päällekkäisiltä	pæællekkæisiltA	pæællekkæisiltæ	9
ruohosipulilla	ruohosipulillA	ruohosipulillɑ	9
sulkijan	sulkijAn	sulkijɑn	9
talouskomissiossa	tɑlouskomissiossA	tɑlouskomissiossɑ	9
taustatietona	tɑustAtietonA	tɑustɑtietonɑ	9
tupsahtanut	tupsɑhtɑnUt	tupsɑhtɑnut	9
työmääränsä	tyømæærænsA	tyømæærænsæ	9
urissa	urissA	urissɑ	9
vinoutumista	vinoutUmistA	vinoutumistɑ	9
ylistalo	ylistɑlo	ylistɑlo	9
elbe	elbe	elbe	8
galluppien	gɑlluppien	gɑlluppien	8
hankintatukku	hɑnkintAtukku	hɑnkintɑtukku	8
haurastumiseen	hɑurɑstumiseen	hɑurɑstumiseen	8
katetuotto	kɑtetuotto	kɑtetuotto	8
kehnoimmin	kehnoimmin	kehnoimmin	8
kielelliselle	kielelliselle	kielelliselle	8
kipeimmät	kipeimmAt	kipeimmæt	8
kokeiltavissa	kokeiltAvissA	kokeiltɑvissɑ	8
kosketat	kosketɑt	kosketɑt	8
kotiradan	kotirɑdɑn	kotirɑdɑn	8
laivaväylät	lɑivɑvæylæt	lɑivɑvæylæt	8
letkautus	letkɑutUs	letkɑutus	8
mitalitoivo	mitɑlitoivo	mitɑlitoivo	8
niskavillat	niskɑvillɑt	niskɑvillɑt	8
pakkassää	pɑkkɑssææ	pɑkkɑssææ	8
perheneuvonnassa	perheneuvonnɑssA	perheneuvonnɑssɑ	8
pikkuseikkoja	pikkuseikkojA	pikkuseikkojɑ	8
presidenteille	presidenteille	presidenteille	8
projektiavustusta	projektiɑvustUstA	projektiɑvustustɑ	8
puutuoteteollisuus	puutuoteteollisUUs	puutuoteteollisuus	8
päiväkirjamerkintöjen	pæivækirjɑmerkintOjen	pæivækirjɑmerkintøjen	8
pälkähti	pælkæhti	pælkæhti	8
rankkareilla	rɑnkkɑreillA	rɑnkkɑreillɑ	8
salamointia	sɑlɑmointiA	sɑlɑmointiɑ	8
sukupuolivalistus	sukupuolivɑlistUs	sukupuolivɑlistus	8
suolattuna	suolɑttUnA	suolɑttunɑ	8
tarinailta	tɑrinɑiltɑ	tɑrinɑiltɑ	8
tomaattisosetta	tomɑɑttisosettA	tomɑɑttisosettɑ	8
tourula	tourulɑ	tourulɑ	8
tuontioluiden	tuontioluiden	tuontioluiden	8
vaalikierroksella	vɑɑlikierroksellA	vɑɑlikierroksellɑ	8
voimaantuleva	voimɑɑntulevA	voimɑɑntulevɑ	8
öljytankkerin	øljytɑnkkerin	øljytɑnkkerin	8
anttilainen	ɑnttilɑinen	ɑnttilɑinen	7
avustajakoiran	ɑvustɑjAkoirɑn	ɑvustɑjɑkoirɑn	7
britannialaisten	britɑnniɑlAisten	britɑnniɑlɑisten	7
diplomaattiseksi	diplomɑɑttiseksi	diplomɑɑttiseksi	7
hameisiin	hɑmeisiin	hɑmeisiin	7
heinäpään	heinApææn	heinæpææn	7
hellepäivä	hellepæivæ	hellepæivæ	7
hosumista	hosumistA	hosumistɑ	7
imusta	imustA	imustɑ	7
juhanille	juhɑnille	juhɑnille	7
julkaisuiksi	julkɑisUiksi	julkɑisuiksi	7
jäädytettäisiin	jæædytettAisiin	jæædytettæisiin	7
jäätyisi	jæætyisi	jæætyisi	7
kanssakilpailijoiden	kɑnssɑkilpɑilijOiden	kɑnssɑkilpɑilijoiden	7
kasinopelurit	kɑsinopelurit	kɑsinopelurit	7
keynes	keynes	keynes	7
läänikohtaiset	læænikohtɑiset	læænikohtɑiset	7
maalisvaaleihin	mɑɑlisvɑɑleihin	mɑɑlisvɑɑleihin	7
messulla	messullA	messullɑ	7
mukaanoton	mukɑAnoton	mukɑɑnoton	7
nimikysymys	nimikysymys	nimikysymys	7
oikeaoppisia	oikeɑoppisiA	oikeɑoppisiɑ	7
osakkaitten	osɑkkɑitten	osɑkkɑitten	7
palveluasunnon	pɑlvelUɑsunnon	pɑlveluɑsunnon	7
pettymystäni	pettymystAni	pettymystæni	7
plussasta	plussɑstA	plussɑstɑ	7
puuhiinsa	puuhiinsA	puuhiinsɑ	7
päiväuni	pæivæuni	pæivæuni	7
rakastajana	rɑkɑstɑjAnA	rɑkɑstɑjɑnɑ	7
ravintolisistä	rɑvintolisistA	rɑvintolisistæ	7
riskeeraamaan	riskeerɑɑmAAn	riskeerɑɑmɑɑn	7
roolihenkilö	roolihenkilø	roolihenkilø	7
sanoudun	sɑnoudun	sɑnoudun	7
selkiytymätön	selkiytUmAtOn	selkiytymætøn	7
sotilaspolitiikkaan	sotilɑspolitiikkɑAn	sotilɑspolitiikkɑɑn	7
talvikengät	tɑlvikengæt	tɑlvikengæt	7
tarinoillaan	tɑrinoillAAn	tɑrinoillɑɑn	7
tieosakkaiden	tieosɑkkɑiden	tieosɑkkɑiden	7
tietoväylä	tietovæylæ	tietovæylæ	7
tipautti	tipɑutti	tipɑutti	7
tuontikiintiöistä	tuontikiintiøistA	tuontikiintiøistæ	7
työllisyyskehityksestä	tyøllisUUskehitUksestA	tyøllisyyskehityksestæ	7
vaasankadun	vɑɑsɑnkɑdun	vɑɑsɑnkɑdun	7
vaatinevat	vɑɑtinevAt	vɑɑtinevɑt	7
veit	veit	veit	7
verohelpotusta	verohelpotUstA	verohelpotustɑ	7
virtausmittari	virtɑUsmittɑri	virtɑusmittɑri	7
vuokrattuun	vuokrɑttUUn	vuokrɑttuun	7
vähimmäissuojan	væhimmæissuojAn	væhimmæissuojɑn	7
aatteilla	ɑɑtteillA	ɑɑtteillɑ	6
alamaisiksi	ɑlɑmAisiksi	ɑlɑmɑisiksi	6
arkityylissä	ɑrkityylissA	ɑrkityylissæ	6
asettamastaan	ɑsettɑmAstAAn	ɑsettɑmɑstɑɑn	6
avantgardistit	ɑvɑntgɑrdistit	ɑvɑntgɑrdistit	6
ballistisia	bɑllistisiA	bɑllistisiɑ	6
barbados	bɑrbɑdos	bɑrbɑdos	6
dealer	deɑler	deɑler	6
dramaturgit	drɑmɑturgit	drɑmɑturgit	6
elämässänne	elæmAssAnne	elæmæssænne	6
emäkiinteistön	emækiinteistøn	emækiinteistøn	6
energiantuottajana	energiɑntuottɑjAnA	energiɑntuottɑjɑnɑ	6
epätäsmällisen	epætæsmællisen	epætæsmællisen	6
filosofoiva	filosofoivA	filosofoivɑ	6
hampaissaan	hɑmpɑissAAn	hɑmpɑissɑɑn	6
hankintaansa	hɑnkintAAnsA	hɑnkintɑɑnsɑ	6
hotelliinsa	hotelliinsA	hotelliinsɑ	6
housunlahkeet	housunlɑhkeet	housunlɑhkeet	6
ihmeissämme	ihmeissAmme	ihmeissæmme	6
irrottelun	irrottelUn	irrottelun	6
istuneille	istuneille	istuneille	6
kaameudessaan	kɑɑmeUdessAAn	kɑɑmeudessɑɑn	6
kappalevalikoima	kɑppɑlevɑlikoimɑ	kɑppɑlevɑlikoimɑ	6
kassakaapit	kɑssɑkɑɑpit	kɑssɑkɑɑpit	6
kehitysuskon	kehitUsuskon	kehitysuskon	6
kesäjuhlista	kesæjuhlistA	kesæjuhlistɑ	6
kiedottiin	kiedottiin	kiedottiin	6
kuollutkin	kuollUtkin	kuollutkin	6
kuvakudoksissa	kuvɑkudoksissA	kuvɑkudoksissɑ	6
kysyisivät	kysyisivAt	kysyisivæt	6
laulunsanoja	lɑulunsɑnojA	lɑulunsɑnojɑ	6
leikkauttamaan	leikkɑuttɑmAAn	leikkɑuttɑmɑɑn	6
liikuntavammojen	liikuntAvɑmmojen	liikuntɑvɑmmojen	6
loukuilla	loukuillA	loukuillɑ	6
lukemalta	lukemAltA	lukemɑltɑ	6
maanpäällisillä	mɑɑnpæællisillA	mɑɑnpæællisillæ	6
mielipidevangin	mielipidevɑngin	mielipidevɑngin	6
moralismia	morɑlismiA	morɑlismiɑ	6
myymälöitään	myymæløitAAn	myymæløitææn	6
myyntikatteella	myyntikɑtteellA	myyntikɑtteellɑ	6
myötäjäisten	myøtæjæisten	myøtæjæisten	6
niemeke	niemeke	niemeke	6
nimityksestään	nimitUksestAAn	nimityksestææn	6
nähdessä	næhdessA	næhdessæ	6
omistautuneina	omistɑutuneinA	omistɑutuneinɑ	6
painuneita	pɑinuneitA	pɑinuneitɑ	6
palloiluun	pɑlloilUUn	pɑlloiluun	6
petunia	petuniɑ	petuniɑ	6
piirtäisi	piirtæisi	piirtæisi	6
pimennysverhot	pimennUsverhot	pimennysverhot	6
poikastuotannosta	poikɑstuotɑnnostA	poikɑstuotɑnnostɑ	6
psykoottista	psykoottistA	psykoottistɑ	6
puolimaista	puolimɑistA	puolimɑistɑ	6
päänkivistystä	pæænkivistUstA	pæænkivistystæ	6
päätösprosessiin	pæætøsprosessiin	pæætøsprosessiin	6
rahamääräinen	rɑhɑmææræinen	rɑhɑmææræinen	6
ropinaa	ropinAA	ropinɑɑ	6
rypäälle	rypæælle	rypæælle	6
sekaannutaan	sekɑɑnnutAAn	sekɑɑnnutɑɑn	6
sopeutuvuudesta	sopeutUvUUdestA	sopeutuvuudestɑ	6
säestettiin	sæestettiin	sæestettiin	6
takaisinmaksuaikaa	tɑkɑisinmɑksuɑikɑA	tɑkɑisinmɑksuɑikɑɑ	6
talitintin	tɑlitintin	tɑlitintin	6
terästäytyä	teræstæytyA	teræstæytyæ	6
tielaki	tielɑki	tielɑki	6
tsekkaan	tsekkɑɑn	tsekkɑɑn	6
tuorejuuston	tuorejuuston	tuorejuuston	6
tuovana	tuovAnA	tuovɑnɑ	6
tutkimussopimusten	tutkimussopimusten	tutkimussopimusten	6
ulosmarssin	ulosmɑrssin	ulosmɑrssin	6
valmennuskurssien	vɑlmennUskurssien	vɑlmennuskurssien	6
vastustanutta	vɑstustɑnUttA	vɑstustɑnuttɑ	6
viimepäivinä	viimepæivinA	viimepæivinæ	6
viriä	viriA	viriæ	6
voimantuoton	voimɑntuoton	voimɑntuoton	6
yhtiösopimuksen	yhtiøsopimuksen	yhtiøsopimuksen	6
ärsyttämällä	ærsyttæmAllA	ærsyttæmællæ	6
ansaitsevatko	ɑnsɑitsevAtkO	ɑnsɑitsevɑtko	5
avaruustutkimuskeskus	ɑvɑrUUstutkimuskeskus	ɑvɑruustutkimuskeskus	5
eleensä	eleensA	eleensæ	5
epiteetti	epiteetti	epiteetti	5
hakuominaisuuksia	hɑkuominɑisUUksiA	hɑkuominɑisuuksiɑ	5
hankaliinkin	hɑnkɑliinkin	hɑnkɑliinkin	5
helppoudelle	helppoUdelle	helppoudelle	5
ilmapuolustusliiton	ilmɑpuolustUsliiton	ilmɑpuolustusliiton	5
improvisoimme	improvisoimme	improvisoimme	5
iskupaikka	iskupɑikkɑ	iskupɑikkɑ	5
japsien	jɑpsien	jɑpsien	5
jousituksesta	jousitUksestA	jousituksestɑ	5
jumalanpilkan	jumɑlɑnpilkɑn	jumɑlɑnpilkɑn	5
keskiaikaiseksi	keskiɑikɑiseksi	keskiɑikɑiseksi	5
kieppeille	kieppeille	kieppeille	5
kippurin	kippurin	kippurin	5
kirkkoherranvaali	kirkkoherrɑnvɑɑli	kirkkoherrɑnvɑɑli	5
kohdissaan	kohdissAAn	kohdissɑɑn	5
kokkareinen	kokkɑreinen	kokkɑreinen	5
konetyyppiä	konetyyppiA	konetyyppiæ	5
koreografiakilpailun	koreogrɑfiAkilpɑilUn	koreogrɑfiɑkilpɑilun	5
koripallofinaalit	koripɑllofinɑɑlit	koripɑllofinɑɑlit	5
kujanpäälle	kujɑnpæælle	kujɑnpæælle	5
kuluttajahintaindeksistä	kuluttAjAhintɑindeksistA	kuluttɑjɑhintɑindeksistæ	5
kuullulla	kuullUllA	kuullullɑ	5
kuusinkertaiset	kuusinkertɑiset	kuusinkertɑiset	5
kännykkämies	kænnykkæmies	kænnykkæmies	5
laihempia	lɑihempiA	lɑihempiɑ	5
lohkona	lohkonA	lohkonɑ	5
luokkataistelu	luokkɑtɑistelU	luokkɑtɑistelu	5
lähentymisehdoista	læhentymisehdoistA	læhentymisehdoistɑ	5
lähestyttävän	læhestyttAvAn	læhestyttævæn	5
maahantunkeutumista	mɑɑhAntunkeutumistA	mɑɑhɑntunkeutumistɑ	5
maataloustyöntekijät	mɑɑtɑloustyøntekijæt	mɑɑtɑloustyøntekijæt	5
manttelinperijöitä	mɑnttelinperijOitA	mɑnttelinperijøitæ	5
materiaalivalikoima	mɑteriɑɑlivɑlikoimɑ	mɑteriɑɑlivɑlikoimɑ	5
matkailijayhdistyksen	mɑtkɑilijAyhdistUksen	mɑtkɑilijɑyhdistyksen	5
metsälautakunnat	metsælɑutɑkunnɑt	metsælɑutɑkunnɑt	5
minuuttiaikataulua	minuuttiɑikɑtɑuluA	minuuttiɑikɑtɑuluɑ	5
moralismiin	morɑlismiin	morɑlismiin	5
musiikkielämys	musiikkielæmys	musiikkielæmys	5
musiikkimajuri	musiikkimɑjuri	musiikkimɑjuri	5
oireiksi	oireiksi	oireiksi	5
orasta	orɑstA	orɑstɑ	5
pankkivirkailijana	pɑnkkivirkɑilijɑnA	pɑnkkivirkɑilijɑnɑ	5
perinnetietoinen	perinnetietoinen	perinnetietoinen	5
perinteitten	perinteitten	perinteitten	5
pienoissukellusvene	pienoissukellUsvene	pienoissukellusvene	5
pienosakkaille	pienosɑkkɑille	pienosɑkkɑille	5
polyfonista	polyfonistA	polyfonistɑ	5
puhallukset	puhɑllUkset	puhɑllukset	5
puolisotilaalliseen	puolisotilɑɑlliseen	puolisotilɑɑlliseen	5
pureeko	pureekO	pureeko	5
rahastuslaite	rɑhɑstUslɑite	rɑhɑstuslɑite	5
rantakurvi	rɑntɑkurvi	rɑntɑkurvi	5
raportoiden	rɑportoiden	rɑportoiden	5
retkeilyvarusteita	retkeilUvɑrusteitA	retkeilyvɑrusteitɑ	5
riippunee	riippunee	riippunee	5
roju	roju	roju	5
romaaniensa	romɑɑniensA	romɑɑniensɑ	5
ruokapakettien	ruokɑpɑkettien	ruokɑpɑkettien	5
röntgensäteillä	røntgensæteillA	røntgensæteillæ	5
saastuttamassa	sɑɑstuttAmAssA	sɑɑstuttɑmɑssɑ	5
sinilippu	sinilippu	sinilippu	5
sotatantereelta	sotɑtɑntereeltA	sotɑtɑntereeltɑ	5
sotilasjoukon	sotilɑsjoukon	sotilɑsjoukon	5
säteilyttämällä	sæteilUttAmAllA	sæteilyttæmællæ	5
taivalluksen	tɑivɑllUksen	tɑivɑlluksen	5
talousuutisissa	tɑlousuutisissA	tɑlousuutisissɑ	5
taustajoukoissa	tɑustAjoukoissA	tɑustɑjoukoissɑ	5
tiedenaiset	tiedenɑiset	tiedenɑiset	5
tuotantosuunnissa	tuotɑntosuunnissA	tuotɑntosuunnissɑ	5
tuurata	tuurɑtA	tuurɑtɑ	5
täysipainoiset	tæysipɑinoiset	tæysipɑinoiset	5
valokuvataiteesta	vɑlokuvɑtɑiteestA	vɑlokuvɑtɑiteestɑ	5
ykkösohjelmarahaa	ykkøsohjelmɑrɑhɑA	ykkøsohjelmɑrɑhɑɑ	5
akrobaattiset	ɑkrobɑɑttiset	ɑkrobɑɑttiset	4
aluehälytyskeskukselle	ɑluehælytUskeskukselle	ɑluehælytyskeskukselle	4
amerikkalaiskuluttajan	ɑmerikkɑlɑiskuluttAjAn	ɑmerikkɑlɑiskuluttɑjɑn	4
analysoidut	ɑnɑlysoidUt	ɑnɑlysoidut	4
asukaskokouksessa	ɑsukɑskokouksessA	ɑsukɑskokouksessɑ	4
berberiä	berberiA	berberiæ	4
delegaationsa	delegɑɑtionsA	delegɑɑtionsɑ	4
edellytettyjen	edellytettUjen	edellytettyjen	4
erikoisryhmille	erikoisryhmille	erikoisryhmille	4
erikoisvarusteet	erikoisvɑrusteet	erikoisvɑrusteet	4
erotumme	erotUmme	erotumme	4
etsintäkuulutukset	etsintAkuulutUkset	etsintækuulutukset	4
filosofioista	filosofioistA	filosofioistɑ	4
finanssikeskus	finɑnssikeskus	finɑnssikeskus	4
hagströmin	hɑgstrømin	hɑgstrømin	4
hallinnonhaarat	hɑllinnonhɑɑrɑt	hɑllinnonhɑɑrɑt	4
hallintoihmisiä	hɑllintoihmisiA	hɑllintoihmisiæ	4
hengenvaarallisessa	hengenvɑɑrɑllisessA	hengenvɑɑrɑllisessɑ	4
hienostuneeksi	hienostuneeksi	hienostuneeksi	4
huojuivat	huojuivAt	huojuivɑt	4
islantilaisesta	islɑntilAisestA	islɑntilɑisestɑ	4
juniorityössä	juniorityøssA	juniorityøssæ	4
kaavoineen	kɑɑvoineen	kɑɑvoineen	4
kaksinapaisuus	kɑksinɑpɑisUUs	kɑksinɑpɑisuus	4
kamarimusiikkisarja	kɑmɑrimusiikkisɑrjɑ	kɑmɑrimusiikkisɑrjɑ	4
kansanosia	kɑnsɑnosiA	kɑnsɑnosiɑ	4
katsotuissa	kɑtsotUissA	kɑtsotuissɑ	4
kehuisi	kehuisi	kehuisi	4
kiireaikoina	kiireɑikoinA	kiireɑikoinɑ	4
kirjailee	kirjɑilee	kirjɑilee	4
kolmikkona	kolmikkonA	kolmikkonɑ	4
koulukiusatuksi	koulukiusɑtUksi	koulukiusɑtuksi	4
koulutettavina	koulutettAvinA	koulutettɑvinɑ	4
koulutovereiltaan	koulutovereiltAAn	koulutovereiltɑɑn	4
koulutusavun	koulutUsɑvun	koulutusɑvun	4
kudosnäytteistä	kudosnæytteistA	kudosnæytteistæ	4
käytönkin	kæytønkin	kæytønkin	4
lainattuihin	lɑinɑttUihin	lɑinɑttuihin	4
lajistollista	lɑjistollistA	lɑjistollistɑ	4
lakkautusuhkaa	lɑkkɑutUsuhkɑA	lɑkkɑutusuhkɑɑ	4
lattialämmityksestä	lɑttiɑlæmmitUksestA	lɑttiɑlæmmityksestæ	4
latuihin	lɑtuihin	lɑtuihin	4
lauluhetket	lɑuluhetket	lɑuluhetket	4
lihallisesta	lihɑllisestA	lihɑllisestɑ	4
liikuntajohtajaksi	liikuntAjohtɑjAksi	liikuntɑjohtɑjɑksi	4
maisemakuviin	mɑisemɑkuviin	mɑisemɑkuviin	4
maksunsaantijärjestyksestä	mɑksunsɑɑntijærjestUksestA	mɑksunsɑɑntijærjestyksestæ	4
moosekseksi	moosekseksi	moosekseksi	4
moraalimme	morɑɑlimme	morɑɑlimme	4
muodostavasta	muodostɑvAstA	muodostɑvɑstɑ	4
musiikkilajien	musiikkilɑjien	musiikkilɑjien	4
myötäjäisistä	myøtæjæisistA	myøtæjæisistæ	4
natseihin	nɑtseihin	nɑtseihin	4
natsirikolliset	nɑtsirikolliset	nɑtsirikolliset	4
neuvottelukokoukseen	neuvottelUkokoukseen	neuvottelukokoukseen	4
näytösoikeudenkäynti	næytøsoikeUdenkæynti	næytøsoikeudenkæynti	4
oivallettavaksi	oivɑllettAvAksi	oivɑllettɑvɑksi	4
osakkeenomistajiaan	osɑkkeenomistɑjiAAn	osɑkkeenomistɑjiɑɑn	4
osuuspankkikeskuksessa	osuuspɑnkkikeskuksessA	osuuspɑnkkikeskuksessɑ	4
otsatukka	otsɑtukkɑ	otsɑtukkɑ	4
paljastatte	pɑljɑstɑtte	pɑljɑstɑtte	4
palkkaakaan	pɑlkkɑAkAAn	pɑlkkɑɑkɑɑn	4
paperimiehen	pɑperimiehen	pɑperimiehen	4
paroselle	pɑroselle	pɑroselle	4
pirstoutuneiden	pirstoUtUneiden	pirstoutuneiden	4
pistetyt	pistetUt	pistetyt	4
polvipituus	polvipituus	polvipituus	4
populaariksi	populɑɑriksi	populɑɑriksi	4
puske	puske	puske	4
pälkähtänyt	pælkæhtænUt	pælkæhtænyt	4
päärautatieasema	pæærɑutɑtieɑsemɑ	pæærɑutɑtieɑsemɑ	4
rahasotkut	rɑhɑsotkut	rɑhɑsotkut	4
rakennetyöttömyys	rɑkennetyøttOmUUs	rɑkennetyøttømyys	4
ristiinnaulitsemalla	ristiinnɑulitsemAllA	ristiinnɑulitsemɑllɑ	4
roomalaiskirjeeseen	roomɑlɑiskirjeeseen	roomɑlɑiskirjeeseen	4
ryppyiseksi	ryppyiseksi	ryppyiseksi	4
sadeojat	sɑdeojɑt	sɑdeojɑt	4
sarparannan	sɑrpɑrɑnnɑn	sɑrpɑrɑnnɑn	4
satulakatto	sɑtulɑkɑtto	sɑtulɑkɑtto	4
sekarotuisen	sekɑrotuisen	sekɑrotuisen	4
selviytymistaistelu	selviytymistɑistelU	selviytymistɑistelu	4
siistimmäksi	siistimmAksi	siistimmæksi	4
suhteutetulla	suhteutetUllA	suhteutetullɑ	4
syntyajoilta	syntyɑjoiltA	syntyɑjoiltɑ	4
säestämistä	sæestæmistA	sæestæmistæ	4
sähkösaunan	sæhkøsɑunɑn	sæhkøsɑunɑn	4
taivallettiin	tɑivɑllettiin	tɑivɑllettiin	4
tarjousmenettelyä	tɑrjousmenettelUA	tɑrjousmenettelyæ	4
tautiperintö	tɑutiperintø	tɑutiperintø	4
tietokantasovelluksissa	tietokɑntɑsovellUksissA	tietokɑntɑsovelluksissɑ	4
tikkarin	tikkɑrin	tikkɑrin	4
tuoduksi	tuodUksi	tuoduksi	4
turistikohteista	turistikohteistA	turistikohteistɑ	4
urheilutiloja	urheilUtilojA	urheilutilojɑ	4
uuhien	uuhien	uuhien	4
vahingoittamien	vɑhingoittɑmien	vɑhingoittɑmien	4
vaikeakäyttöinen	vɑikeɑkæyttøinen	vɑikeɑkæyttøinen	4
vajaatehoisia	vɑjɑAtehoisiA	vɑjɑɑtehoisiɑ	4
valtamerentakaisia	vɑltɑmerentɑkɑisiA	vɑltɑmerentɑkɑisiɑ	4
velkoa	velkoA	velkoɑ	4
velkojaksi	velkojAksi	velkojɑksi	4
verovapaina	verovɑpɑinA	verovɑpɑinɑ	4
vertailuarvoon	vertɑilUɑrvoOn	vertɑiluɑrvoon	4
vialliseen	viɑlliseen	viɑlliseen	4
viherrakentajien	viherrɑkentɑjien	viherrɑkentɑjien	4
vilkaiskaapa	vilkɑiskAApA	vilkɑiskɑɑpɑ	4
vuosipäivänään	vuosipæivænAAn	vuosipæivænææn	4
väestöongelmat	væestøongelmɑt	væestøongelmɑt	4
yhteisostojen	yhteisostojen	yhteisostojen	4
ylikorostuneen	ylikorostUneen	ylikorostuneen	4
ylioppilasmatrikkeli	ylioppilɑsmɑtrikkeli	ylioppilɑsmɑtrikkeli	4
ylpeydenaiheemme	ylpeUdenɑiheemme	ylpeydenɑiheemme	4
ylähirrestä	ylæhirrestA	ylæhirrestæ	4
äänialansa	ææniɑlɑnsA	ææniɑlɑnsɑ	4
ainekseltaan	ɑinekseltAAn	ɑinekseltɑɑn	3
alushame	ɑlushɑme	ɑlushɑme	3
arvostellutta	ɑrvostellUttA	ɑrvostelluttɑ	3
asuntokortteleita	ɑsuntokortteleitA	ɑsuntokortteleitɑ	3
aukioon	ɑukioOn	ɑukioon	3
autokauppiaalle	ɑutokɑuppiɑɑlle	ɑutokɑuppiɑɑlle	3
autovaraosat	ɑutovɑrɑosɑt	ɑutovɑrɑosɑt	3
beetakaroteenilla	beetɑkɑroteenillA	beetɑkɑroteenillɑ	3
dramaturgiassa	drɑmɑturgiɑssA	drɑmɑturgiɑssɑ	3
epäsopivana	epæsopivAnA	epæsopivɑnɑ	3
erikoiskomission	erikoiskomission	erikoiskomission	3
erillisinäkin	erillisinAkin	erillisinækin	3
erkaantuivat	erkɑɑntuivAt	erkɑɑntuivɑt	3
eräkämppä	erækæmppæ	erækæmppæ	3
esittämispaikka	esittæmispɑikkɑ	esittæmispɑikkɑ	3
etuvetoisella	etuvetoisellA	etuvetoisellɑ	3
etäopettaja	etæopettɑjA	etæopettɑjɑ	3
hanskojen	hɑnskojen	hɑnskojen	3
hienostuneessa	hienostuneessA	hienostuneessɑ	3
hoikkuuden	hoikkUUden	hoikkuuden	3
hulttiot	hulttiot	hulttiot	3
huulesta	huulestA	huulestɑ	3
hyvityksinä	hyvitUksinA	hyvityksinæ	3
hätävarjelu	hætævɑrjelU	hætævɑrjelu	3
ilmarevolveri	ilmɑrevolveri	ilmɑrevolveri	3
iltajuhlasta	iltɑjuhlɑstA	iltɑjuhlɑstɑ	3
imusolmukesyöpää	imusolmukesyøpæA	imusolmukesyøpææ	3
jakoviiva	jɑkoviivɑ	jɑkoviivɑ	3
jalkapallokartalla	jɑlkɑpɑllokɑrtɑllA	jɑlkɑpɑllokɑrtɑllɑ	3
joulunalusaikana	joulunɑlusɑikɑnA	joulunɑlusɑikɑnɑ	3
junavaunu	junɑvɑunu	junɑvɑunu	3
jälkijättöiseltä	jælkijættøiseltA	jælkijættøiseltæ	3
jäseneltään	jæseneltAAn	jæseneltææn	3
kaikenkokoisissa	kɑikenkokoisissA	kɑikenkokoisissɑ	3
kalkinpoistoaineen	kɑlkinpoistoɑineen	kɑlkinpoistoɑineen	3
kansainliitossa	kɑnsɑinliitossA	kɑnsɑinliitossɑ	3
kauhuromantiikka	kɑuhuromɑntiikkɑ	kɑuhuromɑntiikkɑ	3
kerrostalokorttelin	kerrostɑlokorttelin	kerrostɑlokorttelin	3
keskushenkilöt	keskushenkiløt	keskushenkiløt	3
kimpaleen	kimpɑleen	kimpɑleen	3
kinkkusuikaleita	kinkkusuikɑleitA	kinkkusuikɑleitɑ	3
korkeakoulujärjestelmät	korkeɑkoulujærjestelmæt	korkeɑkoulujærjestelmæt	3
kotivaltiossaan	kotivɑltiossAAn	kotivɑltiossɑɑn	3
kulttuuriharrastus	kulttuurihɑrrɑstUs	kulttuurihɑrrɑstus	3
kuluneelle	kuluneelle	kuluneelle	3
kylmenevässä	kylmenevAssA	kylmenevæssæ	3
lehtikeli	lehtikeli	lehtikeli	3
leikkautunut	leikkɑutUnUt	leikkɑutunut	3
leiriydymme	leiriydymme	leiriydymme	3
lettiä	lettiA	lettiæ	3
leukemiatapaukset	leukemiɑtɑpɑUkset	leukemiɑtɑpɑukset	3
liikenneruuhkassa	liikenneruuhkɑssA	liikenneruuhkɑssɑ	3
linssille	linssille	linssille	3
luvattaisiin	luvɑttAisiin	luvɑttɑisiin	3
lyhtypylväissä	lyhtypylvæissA	lyhtypylvæissæ	3
lähitaloista	læhitɑloistA	læhitɑloistɑ	3
manipuloitiin	mɑnipuloitiin	mɑnipuloitiin	3
masokismin	mɑsokismin	mɑsokismin	3
mataluutta	mɑtɑlUUttA	mɑtɑluuttɑ	3
merenkulkuelinkeinon	merenkulkuelinkeinon	merenkulkuelinkeinon	3
metsäseudulla	metsæseudullA	metsæseudullɑ	3
millimetripaperille	millimetripɑperille	millimetripɑperille	3
minikoossa	minikoossA	minikoossɑ	3
mullistamista	mullistɑmistA	mullistɑmistɑ	3
musiikkilehdistö	musiikkilehdistø	musiikkilehdistø	3
myrkkysäiliöitä	myrkkysæiliøitA	myrkkysæiliøitæ	3
myyntiehdoista	myyntiehdoistA	myyntiehdoistɑ	3
määräaikaistileillä	mææræɑikɑistileillA	mææræɑikɑistileillæ	3
määräisinä	mææræisinA	mææræisinæ	3
nauhakaupungin	nɑuhɑkɑupungin	nɑuhɑkɑupungin	3
neuroradiologian	neurorɑdiologiɑn	neurorɑdiologiɑn	3
niemekkeellä	niemekkeellA	niemekkeellæ	3
nummijärvelle	nummijærvelle	nummijærvelle	3
olympiavuotta	olympiɑvuottA	olympiɑvuottɑ	3
oppimistani	oppimistAni	oppimistɑni	3
orkesterisäestyksen	orkesterisæestUksen	orkesterisæestyksen	3
palkintopallia	pɑlkintopɑlliA	pɑlkintopɑlliɑ	3
pelastusliittojen	pelɑstUsliittojen	pelɑstusliittojen	3
pelihalliin	pelihɑlliin	pelihɑlliin	3
peltiseen	peltiseen	peltiseen	3
pianojen	piɑnojen	piɑnojen	3
pidettykään	pidettUkAAn	pidettykææn	3
piirakoista	piirɑkoistA	piirɑkoistɑ	3
piirtämistään	piirtæmistAAn	piirtæmistææn	3
povellaan	povellAAn	povellɑɑn	3
puhdistamourakka	puhdistɑmourɑkkɑ	puhdistɑmourɑkkɑ	3
pukeutumistiloissa	pukeUtUmistiloissA	pukeutumistiloissɑ	3
pyllyt	pyllyt	pyllyt	3
quijoteksi	kuijoteksi	kuijoteksi	3
reformaatiota	reformɑɑtiotA	reformɑɑtiotɑ	3
rentoutuneeksi	rentoutUneeksi	rentoutuneeksi	3
riskeeraamatta	riskeerɑɑmAttA	riskeerɑɑmɑttɑ	3
ryöppyyn	ryøppyUn	ryøppyyn	3
sairastuttuani	sɑirɑstuttuAni	sɑirɑstuttuɑni	3
saksipotku	sɑksipotku	sɑksipotku	3
seurustelet	seurustelet	seurustelet	3
sijoittajasta	sijoittɑjAstA	sijoittɑjɑstɑ	3
sokeripitoisuuteen	sokeripitoisUUteen	sokeripitoisuuteen	3
suksitehtaan	suksitehtɑɑn	suksitehtɑɑn	3
suomalaismenestykseen	suomɑlɑismenestykseen	suomɑlɑismenestykseen	3
suomestahan	suomestAhAn	suomestɑhɑn	3
suunnittelupuolen	suunnittelUpuolen	suunnittelupuolen	3
teatterinukkien	teɑtterinukkien	teɑtterinukkien	3
tehdaskiinteistöt	tehdɑskiinteistøt	tehdɑskiinteistøt	3
tenttiajat	tenttiɑjɑt	tenttiɑjɑt	3
tiedonsirujen	tiedonsirujen	tiedonsirujen	3
tipautettu	tipɑutettU	tipɑutettu	3
toimenpiteenään	toimenpiteenAAn	toimenpiteenææn	3
toinin	toinin	toinin	3
toistumassa	toistumAssA	toistumɑssɑ	3
tuomiojalta	tuomiojɑltA	tuomiojɑltɑ	3
tuontitavaroille	tuontitɑvɑroille	tuontitɑvɑroille	3
tähtikultti	tæhtikultti	tæhtikultti	3
umpikaivolietteiden	umpikɑivolietteiden	umpikɑivolietteiden	3
uratie	urɑtie	urɑtie	3
uudistumisprosessin	uudistUmisprosessin	uudistumisprosessin	3
uutislähteenä	uutislæhteenA	uutislæhteenæ	3
vaihtopisteitä	vɑihtopisteitA	vɑihtopisteitæ	3
vajarakennus	vɑjɑrɑkennUs	vɑjɑrɑkennus	3
vakoniemi	vɑkoniemi	vɑkoniemi	3
valitusaste	vɑlitUsɑste	vɑlitusɑste	3
valtapoliittinen	vɑltɑpoliittinen	vɑltɑpoliittinen	3
velkajärjestelyllä	velkɑjærjestelUllA	velkɑjærjestelyllæ	3
venäläislähteet	venælæislæhteet	venælæislæhteet	3
veromarkkojaan	veromɑrkkojAAn	veromɑrkkojɑɑn	3
vetäjäpula	vetæjApulɑ	vetæjæpulɑ	3
viljelytiloja	viljelUtilojA	viljelytilojɑ	3
vuorokone	vuorokone	vuorokone	3
vähempäänkin	væhempAAnkin	væhempæænkin	3
väliinputoajaryhmä	væliinputoɑjAryhmæ	væliinputoɑjɑryhmæ	3
yhteysupseerin	yhteysupseerin	yhteysupseerin	3
yksityiskäytöstä	yksityiskæytøstA	yksityiskæytøstæ	3
yleisurheilujoukkueen	yleisurheilUjoukkueen	yleisurheilujoukkueen	3
yönäytöksenä	yønæytøksenA	yønæytøksenæ	3
yöuniani	yøuniAni	yøuniɑni	3
ärsyttääkö	ærsyttæAkO	ærsyttæækø	3
ääniharavoina	æænihɑrɑvoinA	æænihɑrɑvoinɑ	3
äärimuodossaan	æærimuodossAAn	æærimuodossɑɑn	3
alamäkivauhtiaan	ɑlɑmækivɑuhtiAAn	ɑlɑmækivɑuhtiɑɑn	2
alaspäinkin	ɑlɑspæinkin	ɑlɑspæinkin	2
alusvaate	ɑlusvɑɑte	ɑlusvɑɑte	2
antamattomuus	ɑntɑmAttOmUUs	ɑntɑmɑttomuus	2
arvomerkkinsä	ɑrvomerkkinsA	ɑrvomerkkinsæ	2
arvosanojensa	ɑrvosɑnojensA	ɑrvosɑnojensɑ	2
arvostelijoilla	ɑrvostelijOillA	ɑrvostelijoillɑ	2
aseteltaessa	ɑseteltAessA	ɑseteltɑessɑ	2
asettajista	ɑsettɑjistA	ɑsettɑjistɑ	2
asfalttitiet	ɑsfɑlttitiet	ɑsfɑlttitiet	2
autoistumisaste	ɑutoistumisɑste	ɑutoistumisɑste	2
avaintermejä	ɑvɑintermejA	ɑvɑintermejæ	2
avaruusviraston	ɑvɑrUUsvirɑston	ɑvɑruusvirɑston	2
avuntarjouksen	ɑvuntɑrjouksen	ɑvuntɑrjouksen	2
brittisotilaista	brittisotilɑistA	brittisotilɑistɑ	2
countrylaulaja	kountrylɑulɑjA	kountrylɑulɑjɑ	2
edustuskysymyksessä	edustUskysymyksessA	edustuskysymyksessæ	2
eksotiikkaakin	eksotiikkɑAkin	eksotiikkɑɑkin	2
elokuvarahasto	elokuvɑrɑhɑsto	elokuvɑrɑhɑsto	2
elämyspuistossa	elæmyspuistossA	elæmyspuistossɑ	2
elämöineet	elæmøineet	elæmøineet	2
ennennäkemättömäksi	ennennækemættømæksi	ennennækemættømæksi	2
epätäsmälliseksi	epætæsmælliseksi	epætæsmælliseksi	2
eripituisina	eripituisinA	eripituisinɑ	2
esiintymispaikkaa	esiintymispɑikkɑA	esiintymispɑikkɑɑ	2
euroveteraani	euroveterɑɑni	euroveterɑɑni	2
finanssikonserni	finɑnssikonserni	finɑnssikonserni	2
fortissimo	fortissimo	fortissimo	2
fortissimossa	fortissimossA	fortissimossɑ	2
haasteltu	hɑɑsteltU	hɑɑsteltu	2
hagströmien	hɑgstrømien	hɑgstrømien	2
halpamyyntiä	hɑlpɑmyyntiA	hɑlpɑmyyntiæ	2
halventaisi	hɑlventAisi	hɑlventɑisi	2
haydnista	hɑydnistA	hɑydnistɑ	2
heikkoselta	heikkoseltA	heikkoseltɑ	2
heinäkankaantie	heinAkɑnkɑɑntie	heinækɑnkɑɑntie	2
henkilöhaastatteluilla	henkiløhɑɑstɑttelUillA	henkiløhɑɑstɑtteluillɑ	2
herraseuraa	herrɑseurɑA	herrɑseurɑɑ	2
heteroseksuaalit	heteroseksuɑɑlit	heteroseksuɑɑlit	2
hingusta	hingustA	hingustɑ	2
houkuttimiin	houkuttimiin	houkuttimiin	2
huippukorkeiden	huippukorkeiden	huippukorkeiden	2
hulttio	hulttio	hulttio	2
informaatioähkyn	informɑɑtioæhkyn	informɑɑtioæhkyn	2
insinöörimajuri	insinøørimɑjuri	insinøørimɑjuri	2
iskunvaimentimia	iskunvɑimentimiA	iskunvɑimentimiɑ	2
iskuteho	iskuteho	iskuteho	2
itähelsinkiläiset	itæhelsinkilAiset	itæhelsinkilæiset	2
jalkapallovuosi	jɑlkɑpɑllovuosi	jɑlkɑpɑllovuosi	2
jannehan	jɑnnehAn	jɑnnehɑn	2
johtojuoksun	johtojuoksun	johtojuoksun	2
jokeripelaaja	jokeripelɑɑjA	jokeripelɑɑjɑ	2
joulunaluskiireiden	joulunɑluskiireiden	joulunɑluskiireiden	2
joulutontuille	joulutOntuille	joulutontuille	2
järkeenkäyvältä	jærkeenkæyvæltA	jærkeenkæyvæltæ	2
kahdeksaansataan	kɑhdeksɑAnsɑtɑAn	kɑhdeksɑɑnsɑtɑɑn	2
kalastusrekisteriin	kɑlɑstUsrekisteriin	kɑlɑstusrekisteriin	2
kanelipuun	kɑnelipuun	kɑnelipuun	2
kansalliseläimen	kɑnsɑlliselæimen	kɑnsɑlliselæimen	2
kansanryhmissä	kɑnsɑnryhmissA	kɑnsɑnryhmissæ	2
kassamagneettien	kɑssɑmɑgneettien	kɑssɑmɑgneettien	2
kasvintarkastajilla	kɑsvintɑrkɑstɑjillA	kɑsvintɑrkɑstɑjillɑ	2
kehuttavasti	kehuttAvAsti	kehuttɑvɑsti	2
keksintöarsenaaliin	keksintøɑrsenɑɑliin	keksintøɑrsenɑɑliin	2
keynesiläiset	keynesilAiset	keynesilæiset	2
kiilautuneet	kiilɑutuneet	kiilɑutuneet	2
kirjoittaahan	kirjoittɑAhAn	kirjoittɑɑhɑn	2
kirvesmiesporukka	kirvesmiesporukkɑ	kirvesmiesporukkɑ	2
komppaniamme	komppɑniɑmme	komppɑniɑmme	2
koroin	koroin	koroin	2
korruptoinut	korruptoinUt	korruptoinut	2
kotimaisemiinsa	kotimɑisemiinsA	kotimɑisemiinsɑ	2
koulukkaan	koulukkɑɑn	koulukkɑɑn	2
koulukysymykset	koulukysymykset	koulukysymykset	2
koulupohjalla	koulupohjɑllA	koulupohjɑllɑ	2
kulkuyhteydestä	kulkuyhteydestA	kulkuyhteydestæ	2
kuntarajalla	kuntɑrɑjɑllA	kuntɑrɑjɑllɑ	2
kuoppasi	kuoppɑsi	kuoppɑsi	2
kuriositeettia	kuriositeettiA	kuriositeettiɑ	2
kuuloaistimuksen	kuuloɑistimuksen	kuuloɑistimuksen	2
kuurille	kuurille	kuurille	2
kyyhöttävän	kyyhøttævAn	kyyhøttævæn	2
käyttövaatteiden	kæyttøvɑɑtteiden	kæyttøvɑɑtteiden	2
kööriä	køøriA	køøriæ	2
laadunparannuksen	lɑɑdunpɑrɑnnUksen	lɑɑdunpɑrɑnnuksen	2
laboratoriokulut	lɑborɑtoriokulut	lɑborɑtoriokulut	2
laiturinnokassa	lɑiturinnokɑssA	lɑiturinnokɑssɑ	2
lakkaamattomat	lɑkkɑɑmAttOmAt	lɑkkɑɑmɑttomɑt	2
lasitie	lɑsitie	lɑsitie	2
laskosten	lɑskosten	lɑskosten	2
lastenhuollosta	lɑstenhuollostA	lɑstenhuollostɑ	2
latteat	lɑtteɑt	lɑtteɑt	2
lauteitten	lɑuteitten	lɑuteitten	2
lintulajistostaan	lintulɑjistostAAn	lintulɑjistostɑɑn	2
lipunhinnan	lipunhinnɑn	lipunhinnɑn	2
lisävesiä	lisævesiA	lisævesiæ	2
loiskiva	loiskivA	loiskivɑ	2
loiskivat	loiskivAt	loiskivɑt	2
lomitustehtäviä	lomitUstehtæviA	lomitustehtæviæ	2
lukuiloa	lukuiloA	lukuiloɑ	2
luonnosmainen	luonnosmAinen	luonnosmɑinen	2
lähialueitten	læhiɑlueitten	læhiɑlueitten	2
lähitaloille	læhitɑloille	læhitɑloille	2
lämäämän	læmææmAn	læmææmæn	2
lämäämään	læmææmAAn	læmææmææn	2
länsimäessä	lænsimæessA	lænsimæessæ	2
maailmanstandardiksi	mɑɑilmɑnstɑndɑrdiksi	mɑɑilmɑnstɑndɑrdiksi	2
maalaako	mɑɑlɑɑkO	mɑɑlɑɑko	2
maanpäällisille	mɑɑnpæællisille	mɑɑnpæællisille	2
maestrolle	mɑestrolle	mɑestrolle	2
maidontuotantokykyä	mɑidontuotɑntokykyA	mɑidontuotɑntokykyæ	2
mainostauluilla	mɑinostɑuluillA	mɑinostɑuluillɑ	2
maitojunan	mɑitojunɑn	mɑitojunɑn	2
materiaalivaraston	mɑteriɑɑlivɑrɑston	mɑteriɑɑlivɑrɑston	2
mechelininkatua	mekhelininkɑtuA	mekhelininkɑtuɑ	2
miinoitetut	miinoitetUt	miinoitetut	2
mikkeihin	mikkeihin	mikkeihin	2
millimetrintarkasti	millimetrintɑrkɑsti	millimetrintɑrkɑsti	2
mordvalaista	mordvɑlɑistA	mordvɑlɑistɑ	2
mosaiikkitöitä	mosɑiikkitøitA	mosɑiikkitøitæ	2
muinaismuistoalueeksi	muinɑismuistoɑlueeksi	muinɑismuistoɑlueeksi	2
muotoseikoilla	muotoseikoillA	muotoseikoillɑ	2
murtautujia	murtɑutujiA	murtɑutujiɑ	2
muutoksenhakuasteissa	muutoksenhɑkuɑsteissA	muutoksenhɑkuɑsteissɑ	2
normaalivartaloisia	normɑɑlivɑrtɑloisiA	normɑɑlivɑrtɑloisiɑ	2
nousukunnosta	nousukunnostA	nousukunnostɑ	2
nyrkkirauta	nyrkkirɑutɑ	nyrkkirɑutɑ	2
näreneva	nærenevɑ	nærenevɑ	2
ohjailemista	ohjɑilemistA	ohjɑilemistɑ	2
oluelta	olueltA	olueltɑ	2
oppisuuntien	oppisuuntien	oppisuuntien	2
osiolta	osioltA	osioltɑ	2
paksunsuolensyövässä	pɑksunsuolensyøvAssA	pɑksunsuolensyøvæssæ	2
palatsiaukio	pɑlɑtsiɑukio	pɑlɑtsiɑukio	2
palestiinalaisaktivistin	pɑlestiinɑlɑisɑktivistin	pɑlestiinɑlɑisɑktivistin	2
palkankorotusvaatimusta	pɑlkɑnkorotUsvɑɑtimustA	pɑlkɑnkorotusvɑɑtimustɑ	2
palvelusetelikokeilun	pɑlvelUsetelikokeilUn	pɑlvelusetelikokeilun	2
panttioikeuteen	pɑnttioikeUteen	pɑnttioikeuteen	2
perinteitäkään	perinteitAkAAn	perinteitækææn	2
pidättämisessä	pidættæmisessA	pidættæmisessæ	2
pienimäelle	pienimæelle	pienimæelle	2
pikkuleivistä	pikkuleivistA	pikkuleivistæ	2
pilvenmäki	pilvenmæki	pilvenmæki	2
pitäjänkarttaan	pitæjAnkɑrttAAn	pitæjænkɑrttɑɑn	2
plakaatteineen	plɑkɑɑtteineen	plɑkɑɑtteineen	2
poliisijärjestelmän	poliisijærjestelmæn	poliisijærjestelmæn	2
poltellut	poltellUt	poltellut	2
pompottelussa	pompottelUssA	pompottelussɑ	2
postinjakoalueittain	postinjɑkoɑlueittAin	postinjɑkoɑlueittɑin	2
pudotukseksi	pudotUkseksi	pudotukseksi	2
punamultamaalia	punɑmultɑmɑɑliA	punɑmultɑmɑɑliɑ	2
purkakaa	purkɑkAA	purkɑkɑɑ	2
pyrkimyksillämme	pyrkimyksillAmme	pyrkimyksillæmme	2
päivätansseja	pæivætɑnssejA	pæivætɑnssejɑ	2
pärjänneitä	pærjænneitA	pærjænneitæ	2
päähenkilöissä	pææhenkiløissA	pææhenkiløissæ	2
pöytäniemi	pøytæniemi	pøytæniemi	2
rahankäyttöönsä	rɑhɑnkæyttøOnsA	rɑhɑnkæyttøønsæ	2
raipparangaistukseen	rɑippɑrɑngɑistUkseen	rɑippɑrɑngɑistukseen	2
rakennuspuiksi	rɑkennUspuiksi	rɑkennuspuiksi	2
rangaistustulli	rɑngɑistustulli	rɑngɑistustulli	2
rippikouluikään	rippikouluikæAn	rippikouluikææn	2
sankarimytologiaa	sɑnkɑrimytologiɑA	sɑnkɑrimytologiɑɑ	2
saviselle	sɑviselle	sɑviselle	2
selviäisikö	selviæisikO	selviæisikø	2
seurojamme	seurojAmme	seurojɑmme	2
shampootiimin	shɑmpootiimin	shɑmpootiimin	2
siirtolaispolitiikkaan	siirtolɑispolitiikkɑAn	siirtolɑispolitiikkɑɑn	2
silfverbergin	silfverbergin	silfverbergin	2
sillifileet	sillifileet	sillifileet	2
sisustuksenkin	sisustUksenkin	sisustuksenkin	2
syöpäyhdistysten	syøpæyhdistUsten	syøpæyhdistysten	2
sädehoidot	sædehoidot	sædehoidot	2
sädekehänä	sædekehænA	sædekehænæ	2
säilytellä	sæilytellA	sæilytellæ	2
sätkynukkeina	sætkynukkeinA	sætkynukkeinɑ	2
säästösummat	sææstøsummɑt	sææstøsummɑt	2
tajuttomaan	tɑjuttOmAAn	tɑjuttomɑɑn	2
takaisinmaksuna	tɑkɑisinmɑksunA	tɑkɑisinmɑksunɑ	2
talletusvakuutusten	tɑlletUsvɑkuutUsten	tɑlletusvɑkuutusten	2
talouskomissiota	tɑlouskomissiotA	tɑlouskomissiotɑ	2
tankkeriin	tɑnkkeriin	tɑnkkeriin	2
tavarahuolto	tɑvɑrɑhuolto	tɑvɑrɑhuolto	2
teatteritilat	teɑtteritilɑt	teɑtteritilɑt	2
teatterityöntekijät	teɑtterityøntekijæt	teɑtterityøntekijæt	2
todentuntuisena	todentuntuisenA	todentuntuisenɑ	2
toivottamalta	toivottAmAltA	toivottɑmɑltɑ	2
tukkurilta	tukkuriltA	tukkuriltɑ	2
tunkeuduimme	tunkeUdUimme	tunkeuduimme	2
tuomioistuinkäsittelyjä	tuomioistuinkæsittelUjA	tuomioistuinkæsittelyjæ	2
tuontimaksut	tuontimɑksut	tuontimɑksut	2
tuoreemmalta	tuoreemmAltA	tuoreemmɑltɑ	2
tuotantovaikeuksista	tuotɑntovɑikeUksistA	tuotɑntovɑikeuksistɑ	2
tuotepalkintoja	tuotepɑlkintOjA	tuotepɑlkintojɑ	2
turistikohteessa	turistikohteessA	turistikohteessɑ	2
tutkimuskohteella	tutkimuskohteellA	tutkimuskohteellɑ	2
tärkeimpiäkin	tærkeimpiAkin	tærkeimpiækin	2
tärkeämmiltä	tærkeæmmiltA	tærkeæmmiltæ	2
tärvelemästä	tærvelemAstA	tærvelemæstæ	2
vakuutusmarkka	vɑkuutUsmɑrkkɑ	vɑkuutusmɑrkkɑ	2
valuuttaliittoon	vɑluuttɑliittoOn	vɑluuttɑliittoon	2
vanhentaneet	vɑnhentAneet	vɑnhentɑneet	2
vastaanottaessani	vɑstɑɑnottɑessAni	vɑstɑɑnottɑessɑni	2
vastaanottoaikojaan	vɑstɑAnottoɑikojAAn	vɑstɑɑnottoɑikojɑɑn	2
vastaanottokeskuksien	vɑstɑAnottokeskuksien	vɑstɑɑnottokeskuksien	2
venetelineiden	venetelineiden	venetelineiden	2
venäläisjoukoilla	venælæisjoukoillA	venælæisjoukoillɑ	2
verotuksiin	verotUksiin	verotuksiin	2
vesirakentamisesta	vesirɑkentɑmisestA	vesirɑkentɑmisestɑ	2
vesitankkia	vesitɑnkkiA	vesitɑnkkiɑ	2
veturitalleihin	veturitɑlleihin	veturitɑlleihin	2
vitsikkäät	vitsikkææt	vitsikkææt	2
voittopokaalin	voittopokɑɑlin	voittopokɑɑlin	2
vuoriseen	vuoriseen	vuoriseen	2
välieräkamppailussa	vælierækɑmppɑilUssA	vælierækɑmppɑilussɑ	2
ydinvaltojen	ydinvɑltojen	ydinvɑltojen	2
yhdisteryhmiä	yhdisteryhmiA	yhdisteryhmiæ	2
yrttikylpyjä	yrttikylpyjA	yrttikylpyjæ	2
yöpakkanen	yøpɑkkɑnen	yøpɑkkɑnen	2
ääniärsykkeille	ææniærsykkeille	ææniærsykkeille	2
