UF	SF
piʃaSu	piʃaʃu
poʃeSu	poʃeʃu
peʃuSu	peʃuʃu
tiʃoSu	tiʃoʃu
tuʃaSu	tuʃaʃu
toʃiSu	toʃiʃu
koʃaSu	koʃaʃu
kuʃoSu	kuʃoʃu
kiʃeSu	kiʃeʃu
biʃoSu	biʃoʃu
boʃaSu	boʃaʃu
beʃaSu	beʃaʃu
dasoSu	dasosu
dusiSu	dusisu
disoSu	disosu
gosaSu	gosasu
gesuSu	gesusu
gasoSu	gasosu
musoSu	musosu
maseSu	masesu
mesuSu	mesusu
nasuSu	nasusu
nesiSu	nesisu
nesoSu	nesosu
