UF	SF
sugeSu	sugesu
soneSu	sonesu
ʃupeSu	ʃupeʃu
ʃokuSu	ʃokuʃu
sunaSu	sunasu
sogaSu	sogasu
ʃakoSu	ʃakoʃu
sumeSu	sumesu
ʃobiSu	ʃobiʃu
ʃitoSu	ʃitoʃu
sodiSu	sodisu
somuSu	somusu
ʃepoSu	ʃepoʃu
ʃaboSu	ʃaboʃu
ʃapiSu	ʃapiʃu
sagoSu	sagosu
siduSu	sidusu
soduSu	sodusu
semaSu	semasu
ʃotiSu	ʃotiʃu
sineSu	sinesu
ʃabeSu	ʃabeʃu
ʃekiSu	ʃekiʃu
ʃatuSu	ʃatuʃu
