uf	pred	sf
gynH	gyni	gyny
gerekAn	gerekɑn	gereken
geʧAn	geʧɑn	geʧen
sizA	sizɑ	size
bizA	bizɑ	bize
bølymH	bølymɯ	bølymy
durumH	durumɯ	durumu
sɑtHʃ	sɑtiʃ	sɑtɯʃ
dynjɑDA	dynjɑte	dynjɑdɑ
bilimsAl	bilimsɑl	bilimsel
jerDA	jerdɑ	jerde
ɑrɑDA	ɑrɑde	ɑrɑdɑ
yʧnʤH	yʧnʤi	yʧnʤy
ɑdlH	ɑdli	ɑdlɯ
jɯlDA	jɯlde	jɯldɑ
gørmA	gørmɑ	gørme
mydyrH	mydyri	mydyry
tipH	tipɯ	tipi
isteAn	isteɑn	isteen
deɰerlendirmA	deɰerlendirmɑ	deɰerlendirme
dyzenlAnAn	dyzenlɑnɑn	dyzenlenen
durumlArDA	durumlerdɑ	durumlɑrdɑ
birAr	birɑr	birer
ølʧyDA	ølʧydɑ	ølʧyde
kurumH	kurumɯ	kurumu
kodH	kodi	kodu
jɑdA	jɑde	jɑdɑ
ortɑDAn	ortɑden	ortɑdɑn
sorumlH	sorumli	sorumlu
olDHklArH	oldiklɑrɯ	olduklɑrɯ
syreDA	syrete	syrede
kiʃisAl	kiʃisɑl	kiʃisel
geliʃmA	geliʃmɑ	geliʃme
kɑnunHn	kɑnunin	kɑnunun
ylkeDA	ylkete	ylkede
yrynlAr	yrynlɑr	yrynler
sonuʧlArH	sonuʧleri	sonuʧlɑrɯ
hɑlkHn	hɑlkin	hɑlkɯn
bɑʃDA	bɑʃte	bɑʃtɑ
toplumHn	toplumin	toplumun
ermAnH	ermɑnɯ	ermeni
orɑDA	orɑde	orɑdɑ
progrɑmlArH	progrɑmleri	progrɑmlɑrɯ
birejsAl	birejsɑl	birejsel
jerlArDA	jerlɑrdɑ	jerlerde
hizmetlAr	hizmetlɑr	hizmetler
ɑrtHʃ	ɑrtiʃ	ɑrtɯʃ
ylkelArDA	ylkelerdɑ	ylkelerde
sɯrɑDA	sɯrɑde	sɯrɑdɑ
gynDA	gyndɑ	gynde
hepH	hepɯ	hepi
jukɑrɯDAki	jukɑrɯtɑki	jukɑrɯdɑki
bølymDA	bølymdɑ	bølymde
tyrH	tyri	tyry
burɑDAn	burɑden	burɑdɑn
jolA	jole	jolɑ
geliʃmAlAr	geliʃmɑlɑr	geliʃmeler
olmADAn	olmɑden	olmɑdɑn
jønDA	jøndɑ	jønde
deɰerlArH	deɰerlɑrɯ	deɰerleri
etmAH	etmɑɯ	etmei
kurulHHn	kuruliin	kuruluun
detɑjlH	detɑjli	detɑjlɯ
kuruluʃlArH	kuruluʃleri	kuruluʃlɑrɯ
ujɑrHnʤA	ujɑrɯnʤe	ujɑrɯnʤɑ
etmAA	etmɑɑ	etmee
kontrolH	kontrolu	kontroly
byjymA	byjymɑ	byjyme
ʧɯkHʃ	ʧɯkiʃ	ʧɯkɯʃ
tɑrihDAn	tɑrihtɑn	tɑrihten
sektørH	sektøri	sektøry
belirtAn	belirtɑn	belirten
dɑnɯʃmɑnlHk	dɑnɯʃmɑnlik	dɑnɯʃmɑnlɯk
hɑlkH	hɑlki	hɑlkɯ
ɑnlɑmlH	ɑnlɑmli	ɑnlɑmlɯ
dɯʃɯnDAki	dɯʃɯnteki	dɯʃɯndɑki
jɑpDHklArH	jɑptiklɑrɯ	jɑptɯklɑrɯ
bojH	boji	boju
uzmɑnlHk	uzmɑnlik	uzmɑnlɯk
hɑlkA	hɑlke	hɑlkɑ
ʧɑlɯʃmAlArnA	ʧɑlɯʃmɑlɑrne	ʧɑlɯʃmɑlɑrnɑ
kuruluʃlAr	kuruluʃler	kuruluʃlɑr
ɑjDA	ɑjde	ɑjdɑ
ʃɑrtlArH	ʃɑrtleri	ʃɑrtlɑrɯ
søzH	søzi	søzy
jɑrɑrlH	jɑrɑrli	jɑrɑrlɯ
øɰrenmA	øɰrenmɑ	øɰrenme
deɰerlAr	deɰerlɑr	deɰerler
kurumlAr	kurumler	kurumlɑr
hɑjɑtH	hɑjɑtu	hɑjɑtɯ
kɑjɯtlH	kɑjɯtli	kɑjɯtlɯ
gynHn	gynin	gynyn
øzellHklAr	øzelliklɑr	øzellikler
yrynH	yryni	yryny
noktɑDA	noktɑde	noktɑdɑ
nereDA	nerete	nerede
jerlArH	jerlɑrɯ	jerleri
ɑʧɯkʧA	ɑʧɯkʧe	ɑʧɯkʧɑ
inʤelAnmAH	inʤelɑnmɑɯ	inʤelenmei
sɯnɑvH	sɯnɑvi	sɯnɑvɯ
ønDA	øndɑ	ønde
koruHʤH	koruiʤi	koruuʤu
getirmA	getirmɑ	getirme
olɑjlAr	olɑjler	olɑjlɑr
yrynlArHn	yrynlɑrɯn	yrynlerin
gynlArH	gynlɑrɯ	gynleri
kɑrʃɯlɯklH	kɑrʃɯlɯkli	kɑrʃɯlɯklɯ
kuruluʃH	kuruluʃɯ	kuruluʃu
bɑkHʃ	bɑkiʃ	bɑkɯʃ
vermAA	vermɑɑ	vermee
verArAk	verɑrɑk	vererek
ɑrɑʧlArH	ɑrɑʧleri	ɑrɑʧlɑrɯ
sektørHn	sektørɯn	sektøryn
kuruluʃlArHn	kuruluʃlerin	kuruluʃlɑrɯn
rolH	rolu	roly
kurumHn	kurumin	kurumun
dynjɑDAki	dynjɑtɑki	dynjɑdɑki
yrynHn	yrynin	yrynyn
gynDAn	gyndɑn	gynden
evDA	evdɑ	evde
jerlAr	jerlɑr	jerler
sektørDA	sektørdɑ	sektørde
ɑjɑkDA	ɑjɑkte	ɑjɑktɑ
etDHklArH	ettiklɑrɯ	ettikleri
fɑrkH	fɑrki	fɑrkɯ
esɑslArH	esɑsleri	esɑslɑrɯ
ørneklAr	ørneklɑr	ørnekler
konuHn	konuin	konuun
burɑDAki	burɑtɑki	burɑdɑki
ryjɑDA	ryjɑte	ryjɑdɑ
gørmA	gørmɑ	gørme
sektørHHn	sektøriin	sektøryyn
kurumlArH	kurumleri	kurumlɑrɯ
sɑjeDA	sɑjete	sɑjede
kɑnunHHn	kɑnuniin	kɑnunuun
ʤinsAl	ʤinsɑl	ʤinsel
bɑʃɑrɯsHz	bɑʃɑrɯsiz	bɑʃɑrɯsɯz
sonuʧDA	sonuʧdɑ	sonuʧtɑ
kɑpsɑmlH	kɑpsɑmli	kɑpsɑmlɯ
ʧɑlɯʃmADA	ʧɑlɯʃmɑde	ʧɑlɯʃmɑdɑ
hɑberleʃmA	hɑberleʃmɑ	hɑberleʃme
kyltyrH	kyltyri	kyltyry
jɯlA	jɯle	jɯlɑ
ɑɰɯrlɯklH	ɑɰɯrlɯkli	ɑɰɯrlɯklɯ
herkesA	herkesɑ	herkese
ɑʃɑmɑDA	ɑʃɑmɑde	ɑʃɑmɑdɑ
hɑlH	hɑlɯ	hɑli
toplumH	toplumɯ	toplumu
silɑhlH	silɑhli	silɑhlɯ
jerlArA	jerlɑrɑ	jerlere
hɑberlAr	hɑberlɑr	hɑberler
devɑmlH	devɑmli	devɑmlɯ
bɑkɯmDAn	bɑkɯmden	bɑkɯmdɑn
jolDA	jolde	joldɑ
køjH	køji	køjy
sɑɑtH	sɑɑtu	sɑɑti
durumHn	durumin	durumun
bølgelArDA	bølgelerdɑ	bølgelerde
konuDAki	konutɑki	konudɑki
gelmAH	gelmɑɯ	gelmei
iʃitmA	iʃitmɑ	iʃitme
gøryʃH	gøryʃɯ	gøryʃy
hɑftɑDA	hɑftɑde	hɑftɑdɑ
tyrlArH	tyrlɑrɯ	tyrleri
esɑslAr	esɑsler	esɑslɑr
teʃkilɑtH	teʃkilɑtu	teʃkilɑtɯ
tɑbɑnlH	tɑbɑnli	tɑbɑnlɯ
sɑhiplArH	sɑhiplɑrɯ	sɑhipleri
jɯlDAn	jɯlden	jɯldɑn
milletlAr	milletlɑr	milletler
uluslAr	ulusler	uluslɑr
dønemlArDA	dønemlerdɑ	dønemlerde
genʧlAr	genʧlɑr	genʧler
døkymH	døkymɯ	døkymy
bɑʃkɑnlHk	bɑʃkɑnlik	bɑʃkɑnlɯk
dønHʃ	døniʃ	dønyʃ
etkinlHklAr	etkinliklɑr	etkinlikler
olɑjlArH	olɑjleri	olɑjlɑrɯ
girmA	girmɑ	girme
sɯʤɑklHk	sɯʤɑklik	sɯʤɑklɯk
sempozjumH	sempozjumɯ	sempozjumu
tymH	tymɯ	tymy
ʃirketlArHn	ʃirketlɑrɯn	ʃirketlerin
øɰrenmA	øɰrenmɑ	øɰrenme
sɯnɑvA	sɯnɑve	sɯnɑvɑ
ɑlDHklArH	ɑldiklɑrɯ	ɑldɯklɑrɯ
hususlAr	hususler	hususlɑr
gynlAr	gynlɑr	gynler
seʧmA	seʧmɑ	seʧme
dyzenlAnmAH	dyzenlɑnmɑɯ	dyzenlenmei
zɑrɑrlH	zɑrɑrli	zɑrɑrlɯ
hɑlkHHn	hɑlkiin	hɑlkɯɯn
ɑrtHʃH	ɑrtiʃi	ɑrtɯʃɯ
etmADA	etmɑde	etmete
jønDAn	jøndɑn	jønden
sistemDA	sistemdɑ	sistemde
dyzenlemAlAr	dyzenlemɑlɑr	dyzenlemeler
geliʃmAH	geliʃmɑɯ	geliʃmei
kɑjɯtlArH	kɑjɯtleri	kɑjɯtlɑrɯ
ørneklArH	ørneklɑrɯ	ørnekleri
fɑɑlijetlAr	fɑɑlijetlɑr	fɑɑlijetler
ɑdɑjlAr	ɑdɑjler	ɑdɑjlɑr
beklAnAn	beklɑnɑn	beklenen
gøstermA	gøstermɑ	gøsterme
fijɑtlArH	fijɑtleri	fijɑtlɑrɯ
mutlulHk	mutlulik	mutluluk
rɑhɑtsHz	rɑhɑtsiz	rɑhɑtsɯz
isteDHklArH	istetiklɑrɯ	istedikleri
eɰitimA	eɰitimɑ	eɰitime
tɑrɑfH	tɑrɑfi	tɑrɑfɯ
progrɑmHHn	progrɑmiin	progrɑmɯɯn
bølgeDAki	bølgeteki	bølgedeki
usulH	usulu	usuly
fijɑtH	fijɑtu	fijɑtɯ
geliʃmAlArH	geliʃmɑlɑrɯ	geliʃmeleri
ødylH	ødyli	ødyly
hizmetlArHn	hizmetlɑrɯn	hizmetlerin
gitmA	gitmɑ	gitme
jyzjɯlDA	jyzjɯlde	jyzjɯldɑ
bojutlH	bojutli	bojutlu
nedenlArH	nedenlɑrɯ	nedenleri
devletlAr	devletlɑr	devletler
deɰiʃiklHklArH	deɰiʃikliklɑrɯ	deɰiʃiklikleri
ʧɑlɯʃmAlArHHn	ʧɑlɯʃmɑleriin	ʧɑlɯʃmɑlɑrɯɯn
hukukH	hukuki	hukuku
tɑrihsAl	tɑrihsɑl	tɑrihsel
fɑktørlAr	fɑktørlɑr	fɑktørler
kɑblosHz	kɑblosiz	kɑblosuz
kurtulHʃ	kurtuliʃ	kurtuluʃ
kurumlArHn	kurumlerin	kurumlɑrɯn
hɑjɑtHn	hɑjɑtin	hɑjɑtɯn
notH	noti	notu
mesɑʒH	mesɑʒi	mesɑʒɯ
vermAH	vermɑɯ	vermei
eserlArH	eserlɑrɯ	eserleri
tedbirlAr	tedbirlɑr	tedbirler
ɑkɯllH	ɑkɯlli	ɑkɯllɯ
eserlAr	eserlɑr	eserler
bulunDHklArH	bulundiklɑrɯ	bulunduklɑrɯ
edebijɑtH	edebijɑtu	edebijɑtɯ
ʧevreA	ʧevreɑ	ʧevree
hɑstɑDA	hɑstɑde	hɑstɑdɑ
kesmA	kesmɑ	kesme
orɑDAn	orɑden	orɑdɑn
hɑftɑlHk	hɑftɑlik	hɑftɑlɯk
bɑʃlɑngɯʧDA	bɑʃlɑngɯʧte	bɑʃlɑngɯʧtɑ
øɰretmenlAr	øɰretmenlɑr	øɰretmenler
ujgulɑmɑDA	ujgulɑmɑde	ujgulɑmɑdɑ
rɑporDA	rɑportɑ	rɑpordɑ
okulDA	okulde	okuldɑ
durumlAr	durumler	durumlɑr
sɑtHʃH	sɑtiʃi	sɑtɯʃɯ
ɑʧɯklɑmADA	ɑʧɯklɑmɑde	ɑʧɯklɑmɑdɑ
denizA	denizɑ	denize
insɑnlHk	insɑnlik	insɑnlɯk
tɑrihA	tɑrihɑ	tɑrihe
ɑvukɑtlHk	ɑvukɑtlik	ɑvukɑtlɯk
giderlArH	giderlɑrɯ	giderleri
kɑtlH	kɑtli	kɑtlɯ
mɑlHn	mɑlin	mɑlɯn
nyfusH	nyfusi	nyfusu
sɯnɯfH	sɯnɯfi	sɯnɯfɯ
etmAH	etmɑɯ	etmei
tɑrɑfDA	tɑrɑfte	tɑrɑftɑ
ihtijɑʧlArH	ihtijɑʧleri	ihtijɑʧlɑrɯ
jønlH	jønli	jønly
øzgyrlHk	øzgyrlik	øzgyrlyk
modellArH	modellɑrɯ	modelleri
ɑrkɑdɑʃlArH	ɑrkɑdɑʃleri	ɑrkɑdɑʃlɑrɯ
tedbirlArH	tedbirlɑrɯ	tedbirleri
kuruluʃlArHHn	kuruluʃleriin	kuruluʃlɑrɯɯn
jolDAn	jolden	joldɑn
grupDA	grupte	gruptɑ
bɑkɑnlɯkʧA	bɑkɑnlɯkʧe	bɑkɑnlɯkʧɑ
sɑnɑtʧH	sɑnɑtʧi	sɑnɑtʧɯ
sevijeDA	sevijete	sevijede
ɑdɑjlArHn	ɑdɑjlerin	ɑdɑjlɑrɯn
ønlAnmAH	ønlɑnmɑɯ	ønlenmei
stɑndɑrtlArH	stɑndɑrtleri	stɑndɑrtlɑrɯ
bilmA	bilmɑ	bilme
geʧmiʃDA	geʧmiʃdɑ	geʧmiʃte
geliʃmADA	geliʃmɑde	geliʃmete
memurH	memuri	memuru
jyzH	jyzi	jyzy
seʧeneklArH	seʧeneklɑrɯ	seʧenekleri
esɑslArA	esɑslere	esɑslɑrɑ
girmAH	girmɑɯ	girmei
ujgunlHk	ujgunlik	ujgunluk
jønH	jønɯ	jøny
hɑjɑtDA	hɑjɑtte	hɑjɑttɑ
ortɑDA	ortɑde	ortɑdɑ
gerʧeklAʃAn	gerʧeklɑʃɑn	gerʧekleʃen
olHnʤA	olinʤe	olunʤɑ
noktɑDAn	noktɑden	noktɑdɑn
genʧlArHn	genʧlɑrɯn	genʧlerin
kuruluʃHn	kuruluʃin	kuruluʃun
geʧArAk	geʧɑrɑk	geʧerek
fɑrklHlHk	fɑrklilik	fɑrklɯlɯk
tɑleplArH	tɑleplɑrɯ	tɑlepleri
yʧDA	yʧdɑ	yʧte
eɰitimDA	eɰitimdɑ	eɰitimde
pijɑsɑDA	pijɑsɑde	pijɑsɑdɑ
bɑʃbɑkɑnlHk	bɑʃbɑkɑnlik	bɑʃbɑkɑnlɯk
tiplArH	tiplɑrɯ	tipleri
dyzeltmA	dyzeltmɑ	dyzeltme
etmAlArH	etmɑlɑrɯ	etmeleri
bɑʃlɯklH	bɑʃlɯkli	bɑʃlɯklɯ
belirtmA	belirtmɑ	belirtme
sɯnɯrsHz	sɯnɯrsiz	sɯnɯrsɯz
iʃDAn	iʃden	iʃten
kuruluʃlArA	kuruluʃlere	kuruluʃlɑrɑ
hɑklArHHn	hɑkleriin	hɑklɑrɯɯn
gørynAn	gørynɑn	gørynen
girArAk	girɑrɑk	girerek
kɑjnɑklArHHn	kɑjnɑkleriin	kɑjnɑklɑrɯɯn
ølymH	ølymɯ	ølymy
ʤihɑzlAr	ʤihɑzler	ʤihɑzlɑr
progrɑmlArHHn	progrɑmleriin	progrɑmlɑrɯɯn
filmH	filmɯ	filmi
kɑrtlArH	kɑrtleri	kɑrtlɑrɯ
jɑtɯrɯmlAr	jɑtɯrɯmler	jɑtɯrɯmlɑr
ɑmɑʧlArH	ɑmɑʧleri	ɑmɑʧlɑrɯ
kuʃkusHz	kuʃkusiz	kuʃkusuz
oluʃumH	oluʃumɯ	oluʃumu
imɑlɑtH	imɑlɑtu	imɑlɑtɯ
olɑjlArHn	olɑjlerin	olɑjlɑrɯn
ʧekmA	ʧekmɑ	ʧekme
ɑjDAn	ɑjden	ɑjdɑn
ʤihɑzlArH	ʤihɑzleri	ʤihɑzlɑrɯ
diɰerlArH	diɰerlɑrɯ	diɰerleri
sɑjfɑDA	sɑjfɑde	sɑjfɑdɑ
engellAr	engellɑr	engeller
ɑrkɑdɑʃlAr	ɑrkɑdɑʃler	ɑrkɑdɑʃlɑr
dyzenlAnAʤAk	dyzenlɑnɑʤɑk	dyzenleneʤek
devletlArHn	devletlɑrɯn	devletlerin
ølʧmA	ølʧmɑ	ølʧme
gelirlArH	gelirlɑrɯ	gelirleri
gørHnʤA	gørinʤe	gørynʤe
gerʧekʧH	gerʧekʧu	gerʧekʧi
hɑksHz	hɑksiz	hɑksɯz
ruhsɑtH	ruhsɑtu	ruhsɑtɯ
desteklAAn	desteklɑɑn	destekleen
ɑrkɑdɑʃlArm	ɑrkɑdɑʃlerm	ɑrkɑdɑʃlɑrm
geʧmA	geʧmɑ	geʧme
tɯklAArAk	tɯkleerek	tɯklɑɑrɑk
tɑrzH	tɑrzi	tɑrzɯ
ʃejA	ʃejɑ	ʃeje
ortɑmlArDA	ortɑmlerdɑ	ortɑmlɑrdɑ
sonsHz	sonsiz	sonsuz
jɑpmADA	jɑpmɑde	jɑpmɑtɑ
jɑtɯrɯmlArH	jɑtɯrɯmleri	jɑtɯrɯmlɑrɯ
sɑnɑtH	sɑnɑtu	sɑnɑtɯ
fɯrsɑtH	fɯrsɑtu	fɯrsɑtɯ
niteliklArH	niteliklɑrɯ	nitelikleri
kɑvrɑmlAr	kɑvrɑmler	kɑvrɑmlɑr
kɑvrɑmlArH	kɑvrɑmleri	kɑvrɑmlɑrɯ
deɰerlendirmA	deɰerlendirmɑ	deɰerlendirme
fɑrklHlHklAr	fɑrkliliklɑr	fɑrklɯlɯklɑr
dikkɑtH	dikkɑtu	dikkɑti
øzellHklArA	øzelliklɑrɑ	øzelliklere
geʧmAH	geʧmɑɯ	geʧmei
konumH	konumɯ	konumu
jɑpmAnHz	jɑpmeniz	jɑpmɑnɯz
doɰumlH	doɰumli	doɰumlu
dɑvrɑnHʃlArH	dɑvrɑniʃleri	dɑvrɑnɯʃlɑrɯ
ʧoʤuklHk	ʧoʤuklik	ʧoʤukluk
hedeflArH	hedeflɑrɯ	hedefleri
uʧHʃ	uʧiʃ	uʧuʃ
erkeklAr	erkeklɑr	erkekler
isteklArH	isteklɑrɯ	istekleri
jolHn	jolin	jolun
ʃɑnsH	ʃɑnsi	ʃɑnsɯ
dolɑrlHk	dolɑrlik	dolɑrlɯk
ʧɯkHp	ʧɯkip	ʧɯkɯp
gelirlAr	gelirlɑr	gelirler
kɑrɑrlH	kɑrɑrli	kɑrɑrlɯ
bølymHn	bølymin	bølymyn
sɑtHʃA	sɑtiʃe	sɑtɯʃɑ
jykH	jyki	jyky
kɑjnɑklH	kɑjnɑkli	kɑjnɑklɯ
tɑbloH	tɑbloi	tɑblou
progrɑmlArHn	progrɑmlerin	progrɑmlɑrɯn
syreʧDA	syreʧdɑ	syreʧte
iʧmA	iʧmɑ	iʧme
tɑrɑflH	tɑrɑfli	tɑrɑflɯ
tɑmɑmlAAn	tɑmɑmleen	tɑmɑmlɑɑn
yretimA	yretimɑ	yretime
bølymHHn	bølymiin	bølymyyn
hɑvɑDA	hɑvɑde	hɑvɑdɑ
rɑporHn	rɑporɯn	rɑporun
tytynHn	tytynin	tytynyn
sɯkʧA	sɯkʧe	sɯkʧɑ
zɑmɑnlH	zɑmɑnli	zɑmɑnlɯ
plɑnlH	plɑnli	plɑnlɯ
vermADAn	vermɑden	vermeden
jyklH	jykli	jykly
bɑʃlɑmADAn	bɑʃlɑmɑden	bɑʃlɑmɑdɑn
kyresAllAʃmA	kyresellɑʃmɑ	kyreselleʃme
dolɑjlH	dolɑjli	dolɑjlɯ
kɑliteDA	kɑlitete	kɑlitede
bulunmADA	bulunmɑde	bulunmɑtɑ
hukukHn	hukukin	hukukun
nyfusHn	nyfusin	nyfusun
kɑplH	kɑpli	kɑplɯ
sɑklH	sɑkli	sɑklɯ
ʧoklH	ʧokli	ʧoklu
derneklAr	derneklɑr	dernekler
geʤikmA	geʤikmɑ	geʤikme
yjeDAn	yjetɑn	yjeden
ɑlmADAn	ɑlmɑden	ɑlmɑdɑn
hɑtlArH	hɑtleri	hɑtlɑrɯ
kurumlArA	kurumlere	kurumlɑrɑ
dinlenmA	dinlenmɑ	dinlenme
øɰretmenlArHn	øɰretmenlɑrɯn	øɰretmenlerin
dyzejA	dyzejɑ	dyzeje
gøndermA	gøndermɑ	gønderme
bølymA	bølymɑ	bølyme
duruʃmɑDA	duruʃmɑde	duruʃmɑdɑ
hɑberlArH	hɑberlɑrɯ	hɑberleri
hɑstɑneDA	hɑstɑnete	hɑstɑnede
listeDA	listete	listede
tytynlAr	tytynlɑr	tytynler
ɑjdɯnlHk	ɑjdɯnlik	ɑjdɯnlɯk
bojutlArH	bojutleri	bojutlɑrɯ
hedeflAr	hedeflɑr	hedefler
ɑdɑmlArH	ɑdɑmleri	ɑdɑmlɑrɯ
kitɑpDA	kitɑpte	kitɑptɑ
byjyAn	byjyɑn	byjyen
deɰerlendirmAH	deɰerlendirmɑɯ	deɰerlendirmei
kiʃilArDA	kiʃilerdɑ	kiʃilerde
bɑɰɯmsɯzlHk	bɑɰɯmsɯzlik	bɑɰɯmsɯzlɯk
stɑndɑrtlArA	stɑndɑrtlere	stɑndɑrtlɑrɑ
jyryHʃ	jyryiʃ	jyryyʃ
gøzH	gøzi	gøzy
køjHn	køjɯn	køjyn
ɑkHʃH	ɑkiʃi	ɑkɯʃɯ
modellAr	modellɑr	modeller
etmADAn	etmɑden	etmeden
fotoɰrɑfH	fotoɰrɑfi	fotoɰrɑfɯ
ølAn	ølɑn	ølen
byroH	byroi	byrou
desteklAr	desteklɑr	destekler
silmA	silmɑ	silme
gøsterArAk	gøsterɑrɑk	gøstererek
kolɑjlHk	kolɑjlik	kolɑjlɯk
birliklArH	birliklɑrɯ	birlikleri
kɑbulH	kɑbulu	kɑbuly
kurulmHz	kurulmiz	kurulmuz
ʃɑrtlArA	ʃɑrtlere	ʃɑrtlɑrɑ
ɑlɑnlArHHn	ɑlɑnleriin	ɑlɑnlɑrɯɯn
vermAH	vermɑɯ	vermei
sɯrɑDAn	sɯrɑden	sɯrɑdɑn
testlAr	testlɑr	testler
getirArAk	getirɑrɑk	getirerek
kurumlArHHn	kurumleriin	kurumlɑrɯɯn
dyʃynmA	dyʃynmɑ	dyʃynme
gerʧeklAʃmAH	gerʧeklɑʃmɑɯ	gerʧekleʃmei
tɑʃɯHʤH	tɑʃɯiʤi	tɑʃɯɯʤɯ
ʃekillArH	ʃekillɑrɯ	ʃekilleri
yʤretlAr	yʤretlɑr	yʤretler
yniversiteDA	yniversitete	yniversitede
gɑzeteDA	gɑzetete	gɑzetede
ɑslH	ɑsli	ɑslɯ
gølH	gøli	gøly
gørynymH	gørynymɯ	gørynymy
siteDA	sitete	sitede
tɑsɑrrufH	tɑsɑrrufi	tɑsɑrrufu
ʃehirDA	ʃehirdɑ	ʃehirde
tɑnɯmlAr	tɑnɯmler	tɑnɯmlɑr
dɑkikɑDA	dɑkikɑde	dɑkikɑdɑ
tɑrihlArDA	tɑrihlɑrdɑ	tɑrihlerde
kendimA	kendimɑ	kendime
ʧɯkHʃH	ʧɯkiʃi	ʧɯkɯʃɯ
kendinHzA	kendinizɑ	kendinize
ʧekmA	ʧekmɑ	ʧekme
ɑrɑDAn	ɑrɑden	ɑrɑdɑn
deɰerlArHn	deɰerlɑrɯn	deɰerlerin
dostlHk	dostlik	dostluk
kursH	kursi	kursu
metinlAr	metinlɑr	metinler
geliʃmAlArHn	geliʃmɑlɑrɯn	geliʃmelerin
sɯnɯfDA	sɯnɯfdɑ	sɯnɯftɑ
erkeklArDA	erkeklɑrdɑ	erkeklerde
hɑreketlAr	hɑreketlɑr	hɑreketler
kɑdroH	kɑdroi	kɑdrou
kurumHHn	kurumiin	kurumuun
topDAn	topden	toptɑn
geliʃmAlArA	geliʃmɑlɑrɑ	geliʃmelere
giderlAr	giderlɑr	giderler
onɑjlH	onɑjli	onɑjlɯ
jɑzɯlɯmlArH	jɑzɯlɯmleri	jɑzɯlɯmlɑrɯ
gelmA	gelmɑ	gelme
seklHnDA	seklindɑ	seklinde
elemɑnlArHHn	elemɑnleriin	elemɑnlɑrɯɯn
geʧirmA	geʧirmɑ	geʧirme
kontrollH	kontrolli	kontrolly
jɑpmADAn	jɑpmɑden	jɑpmɑdɑn
jɯllArDAn	jɯllɑrden	jɯllɑrdɑn
olAbilmA	olɑbilmɑ	olɑbilme
ɑltDA	ɑltte	ɑlttɑ
kɑjnɑklArDAn	kɑjnɑklɑrden	kɑjnɑklɑrdɑn
ʧoʤuklArHHn	ʧoʤukleriin	ʧoʤuklɑrɯɯn
motorlH	motorli	motorlu
jɑʃDA	jɑʃte	jɑʃtɑ
rɑkɑmlAr	rɑkɑmler	rɑkɑmlɑr
sorunlArHHn	sorunleriin	sorunlɑrɯɯn
renklArH	renklɑrɯ	renkleri
notlArH	notleri	notlɑrɯ
olmAnHz	olmɑniz	olmɑnɯz
sɯnɑvlArH	sɯnɑvleri	sɯnɑvlɑrɯ
ʧøzymA	ʧøzymɑ	ʧøzyme
dɑvɑDA	dɑvɑde	dɑvɑdɑ
modylH	modyli	modyly
tɑrɑfHn	tɑrɑfin	tɑrɑfɯn
tɑrzDA	tɑrzde	tɑrzdɑ
sɑnɑtlArH	sɑnɑtleri	sɑnɑtlɑrɯ
seminerlAr	seminerlɑr	seminerler
dillAr	dillɑr	diller
sendromH	sendromi	sendromu
unsurH	unsuri	unsuru
ylkeDAn	ylketɑn	ylkeden
ylkelArDAki	ylkelerdɑki	ylkelerdeki
durumHHn	durumiin	durumuun
sonuʧlArHHn	sonuʧleriin	sonuʧlɑrɯɯn
teminɑtH	teminɑtu	teminɑtɯ
jykselAn	jykselɑn	jykselen
sɯnɑvlAr	sɯnɑvler	sɯnɑvlɑr
ɑlmADA	ɑlmɑde	ɑlmɑtɑ
penʤereDA	penʤerete	penʤerede
plɑtformH	plɑtformi	plɑtformu
gørmAH	gørmɑɯ	gørmei
sorumlHlHklArH	sorumliliklɑrɯ	sorumluluklɑrɯ
tɑnɯmlArH	tɑnɯmleri	tɑnɯmlɑrɯ
denejsAl	denejsɑl	denejsel
prensiplArH	prensiplɑrɯ	prensipleri
olDHkDAn	oldiktɑn	olduktɑn
ylkemHzA	ylkemizɑ	ylkemize
ɑvɑntɑʒH	ɑvɑntɑʒi	ɑvɑntɑʒɯ
deɰiʃiklHklArHn	deɰiʃikliklɑrɯn	deɰiʃikliklerin
seʧArAk	seʧɑrɑk	seʧerek
bojutDA	bojutte	bojuttɑ
gerʧeklArH	gerʧeklɑrɯ	gerʧekleri
girmA	girmɑ	girme
zihinsAl	zihinsɑl	zihinsel
ʧɑlɯʃmAlArmHz	ʧɑlɯʃmɑlɑrmiz	ʧɑlɯʃmɑlɑrmɯz
bɑjɯndɯrlHk	bɑjɯndɯrlik	bɑjɯndɯrlɯk
ørgytHn	ørgytin	ørgytyn
ɑʧɯklHk	ɑʧɯklik	ɑʧɯklɯk
bildirmA	bildirmɑ	bildirme
deɰiʃmAH	deɰiʃmɑɯ	deɰiʃmei
fotoɰrɑfHn	fotoɰrɑfin	fotoɰrɑfɯn
tuʃA	tuʃe	tuʃɑ
sonuʧlArA	sonuʧlere	sonuʧlɑrɑ
ɑmɑʧlAAn	ɑmɑʧleen	ɑmɑʧlɑɑn
firmɑmHz	firmɑmiz	firmɑmɯz
hedefA	hedefɑ	hedefe
tutArAk	tuterek	tutɑrɑk
gøndermA	gøndermɑ	gønderme
gøstermAH	gøstermɑɯ	gøstermei
jyrytAn	jyrytɑn	jyryten
kentsAl	kentsɑl	kentsel
sigortɑlHHn	sigortɑliin	sigortɑlɯɯn
suʧH	suʧi	suʧu
yretimDA	yretimdɑ	yretimde
konferɑnsH	konferɑnsi	konferɑnsɯ
kriterlArH	kriterlɑrɯ	kriterleri
mydyrlyklArH	mydyrlyklɑrɯ	mydyrlykleri
olɑjDA	olɑjde	olɑjdɑ
jyrytmA	jyrytmɑ	jyrytme
ɑdɯmlAr	ɑdɯmler	ɑdɯmlɑr
deɰerlendirmAA	deɰerlendirmɑɑ	deɰerlendirmee
ojunHn	ojunin	ojunun
sorunHHn	soruniin	sorunuun
topH	topɯ	topu
ujgulɑmɑlArHHn	ujgulɑmɑleriin	ujgulɑmɑlɑrɯɯn
ylkeDAki	ylketeki	ylkedeki
ɑkHʃ	ɑkiʃ	ɑkɯʃ
hɑlkmHzHn	hɑlkmizin	hɑlkmɯzɯn
engellAmA	engellɑmɑ	engelleme
nedenlAr	nedenlɑr	nedenler
kimA	kimɑ	kime
protokolH	protokolu	protokoly
rɑhɑtʧA	rɑhɑtʧe	rɑhɑtʧɑ
sɑnijeDA	sɑnijete	sɑnijede
jerlArHn	jerlɑrɯn	jerlerin
bɑzlH	bɑzli	bɑzlɯ
gørHp	gørup	gøryp
hɑvuzH	hɑvuzi	hɑvuzu
olHʃH	olɯʃɯ	oluʃu
ɑrkɑdɑʃlArmHz	ɑrkɑdɑʃlermiz	ɑrkɑdɑʃlɑrmɯz
olAbilmAH	olɑbilmɑɯ	olɑbilmei
ihtimɑlH	ihtimɑlɯ	ihtimɑli
kɯsɯtlH	kɯsɯtli	kɯsɯtlɯ
kɑnlH	kɑnli	kɑnlɯ
temellArH	temellɑrɯ	temelleri
ʧɑlɯʃɑnlArHHn	ʧɑlɯʃɑnleriin	ʧɑlɯʃɑnlɑrɯɯn
dønHp	dønup	dønyp
dønmA	dønmɑ	dønme
renklAr	renklɑr	renkler
sɑhɑDA	sɑhɑde	sɑhɑdɑ
ɑvɑntɑʒlArH	ɑvɑntɑʒleri	ɑvɑntɑʒlɑrɯ
kurulDA	kurulde	kuruldɑ
nyfusHHn	nyfusiin	nyfusuun
formlArH	formleri	formlɑrɯ
sɑnɑtDA	sɑnɑtte	sɑnɑttɑ
jɑpAbilmA	jɑpɑbilmɑ	jɑpɑbilme
seneDA	senete	senede
vermADA	vermɑde	vermete
durumDAn	durumden	durumdɑn
geʧmADAn	geʧmɑden	geʧmeden
køjA	køjɑ	køje
solA	sole	solɑ
vɑtɑndɑʃlArHn	vɑtɑndɑʃlerin	vɑtɑndɑʃlɑrɯn
hedeflArA	hedeflɑrɑ	hedeflere
kurumlArDA	kurumlerdɑ	kurumlɑrdɑ
jykymlH	jykymli	jykymly
ɑlDHkDAn	ɑldiktɑn	ɑldɯktɑn
hɑjɑtHHn	hɑjɑtiin	hɑjɑtɯɯn
kɑrʃɯlɑAʤAk	kɑrʃɯlɑeʤɑk	kɑrʃɯlɑɑʤɑk
jɑtɯrɯmlArHn	jɑtɯrɯmlerin	jɑtɯrɯmlɑrɯn
jɑzɯlɯmlAr	jɑzɯlɯmler	jɑzɯlɯmlɑr
zorlHk	zorlik	zorluk
bɯrɑkHp	bɯrɑkip	bɯrɑkɯp
dyʃynmA	dyʃynmɑ	dyʃynme
seʧeneklAr	seʧeneklɑr	seʧenekler
uzɑkDA	uzɑkte	uzɑktɑ
dyʃmAH	dyʃmɑɯ	dyʃmei
inʃɑɑtH	inʃɑɑtu	inʃɑɑtɯ
kullɑnDHklArH	kullɑndiklɑrɯ	kullɑndɯklɑrɯ
fɑɑlijetlArHn	fɑɑlijetlɑrɯn	fɑɑlijetlerin
geʧmA	geʧmɑ	geʧme
odɑDA	odɑde	odɑdɑ
seʧmA	seʧmɑ	seʧme
sistemlArDA	sistemlerdɑ	sistemlerde
joksullHk	joksullik	joksulluk
ʤihɑzlArHn	ʤihɑzlerin	ʤihɑzlɑrɯn
dyʃynAn	dyʃynɑn	dyʃynen
ekiplArH	ekiplɑrɯ	ekipleri
eserlArHn	eserlɑrɯn	eserlerin
hedeflAAn	hedeflɑɑn	hedefleen
derslArDA	derslerdɑ	derslerde
dostH	dosti	dostu
fɑktørH	fɑktøri	fɑktøry
dyʃHʃ	dyʃiʃ	dyʃyʃ
desteklAmA	desteklɑmɑ	destekleme
dersDAn	derstɑn	dersten
getirmAA	getirmɑɑ	getirmee
izlAnmAH	izlɑnmɑɯ	izlenmei
ruhH	ruhi	ruhu
binɑDA	binɑde	binɑdɑ
uzɑklɯkDA	uzɑklɯkte	uzɑklɯktɑ
jykselmA	jykselmɑ	jykselme
ʧekilmAH	ʧekilmɑɯ	ʧekilmei
ølymA	ølymɑ	ølyme
bitkisAl	bitkisɑl	bitkisel
dɑvrɑnHʃlAr	dɑvrɑniʃler	dɑvrɑnɯʃlɑr
sɑvɑʃDA	sɑvɑʃte	sɑvɑʃtɑ
seʧimA	seʧimɑ	seʧime
ʧɑplH	ʧɑpli	ʧɑplɯ
illArDA	illɑrdɑ	illerde
kɑlmADAn	kɑlmɑden	kɑlmɑdɑn
kɑrlH	kɑrli	kɑrlɯ
olɑjlArA	olɑjlere	olɑjlɑrɑ
tedɑviDA	tedɑvite	tedɑvide
jenilHklAr	jeniliklɑr	jenilikler
ʃekillArDA	ʃekillɑrdɑ	ʃekillerde
inʤelemAH	inʤelemɑɯ	inʤelemei
kuvvetlAr	kuvvetlɑr	kuvvetler
mevzuɑtH	mevzuɑtu	mevzuɑtɯ
ønʤylHk	ønʤylik	ønʤylyk
etkilAnAn	etkilɑnɑn	etkilenen
etmAnHz	etmɑniz	etmeniz
kyltyrHHn	kyltyriin	kyltyryyn
jɑklɑʃɯmlAr	jɑklɑʃɯmler	jɑklɑʃɯmlɑr
yniversitelArDA	yniversitelerdɑ	yniversitelerde
ekonomiDA	ekonomite	ekonomide
hykymlH	hykymli	hykymly
menyDA	menydɑ	menyde
olɑjDAn	olɑjden	olɑjdɑn
sektørDAki	sektørtɑki	sektørdeki
tutɑrlH	tutɑrli	tutɑrlɯ
gørmAA	gørmɑɑ	gørmee
geʧDHkʧA	geʧdikʧe	geʧtikʧe
tekniklAr	tekniklɑr	teknikler
jɑpDHkDAn	jɑptiktɑn	jɑptɯktɑn
jeteneklArH	jeteneklɑrɯ	jetenekleri
hukuksAl	hukuksel	hukuksɑl
kɯsɯmlArH	kɯsɯmleri	kɯsɯmlɑrɯ
konuʃmADA	konuʃmɑde	konuʃmɑdɑ
myʤɑdeleDA	myʤɑdelete	myʤɑdelede
etmAAn	etmɑɑn	etmeen
sɑɑtlAr	sɑɑtlɑr	sɑɑtler
sokɑkDA	sokɑkte	sokɑktɑ
ʧɑlɯʃmADA	ʧɑlɯʃmɑde	ʧɑlɯʃmɑtɑ
kendimHzA	kendimizɑ	kendimize
kurslAr	kursler	kurslɑr
sɑɑtlArDA	sɑɑtlɑrdɑ	sɑɑtlerde
ɑdresA	ɑdresɑ	ɑdrese
ɑlAbilmA	ɑlɑbilmɑ	ɑlɑbilme
bɑʃkɑnmHz	bɑʃkɑnmyz	bɑʃkɑnmɯz
esɑslH	esɑsli	esɑslɯ
gørDHklArH	gørdiklɑrɯ	gørdykleri
koʃullArHHn	koʃulleriin	koʃullɑrɯɯn
okuHʤH	okuiʤi	okuuʤu
ɑjlArDA	ɑjlerdɑ	ɑjlɑrdɑ
hykymetlAr	hykymetlɑr	hykymetler
kurulumH	kurulumɯ	kurulumu
sorunsHz	sorunsiz	sorunsuz
ɑrɑʃtɯrmADA	ɑrɑʃtɯrmɑde	ɑrɑʃtɯrmɑdɑ
getirmA	getirmɑ	getirme
menyDAn	menydɑn	menyden
geliʃmAA	geliʃmɑɑ	geliʃmee
ɑrɑʧlArHHn	ɑrɑʧleriin	ɑrɑʧlɑrɯɯn
orɑDAki	orɑtɑki	orɑdɑki
ɑlɯnDHkDAn	ɑlɯndiktɑn	ɑlɯndɯktɑn
desteklAnmAH	desteklɑnmɑɯ	desteklenmei
edinmA	edinmɑ	edinme
fɑktørlArH	fɑktørlɑrɯ	fɑktørleri
kriterlAr	kriterlɑr	kriterler
olmADHkʧA	olmɑdikʧe	olmɑdɯkʧɑ
proʒelArDA	proʒelerdɑ	proʒelerde
tuzlH	tuzli	tuzlu
ɑrtDHkʧA	ɑrttikʧe	ɑrttɯkʧɑ
deɰerlArA	deɰerlɑrɑ	deɰerlere
geliʃmAHn	geliʃmɑɯn	geliʃmein
linklAr	linklɑr	linkler
olmADA	olmɑde	olmɑtɑ
dillArH	dillɑrɯ	dilleri
gruplArHHn	grupleriin	gruplɑrɯɯn
okulDAn	okulden	okuldɑn
sɑjɯsHz	sɑjɯsiz	sɑjɯsɯz
ʧɑpDA	ʧɑpte	ʧɑptɑ
øzellHklArHn	øzelliklɑrɯn	øzelliklerin
yniversitelArɑrɑsɯ	yniversitelɑrɑrɑsɯ	yniversitelerɑrɑsɯ
erkeklArHn	erkeklɑrɯn	erkeklerin
konuHHn	konuiin	konuuun
vermAAn	vermɑɑn	vermeen
jemeklArH	jemeklɑrɯ	jemekleri
ɑjlAr	ɑjler	ɑjlɑr
bedellArH	bedellɑrɯ	bedelleri
kuruluʃlArDA	kuruluʃlerdɑ	kuruluʃlɑrdɑ
mesɑʒlArH	mesɑʒleri	mesɑʒlɑrɯ
progrɑmlArA	progrɑmlere	progrɑmlɑrɑ
ʤihɑzHn	ʤihɑzin	ʤihɑzɯn
gøzlAnAn	gøzlɑnɑn	gøzlenen
kuruluʃHHn	kuruluʃiin	kuruluʃuun
kutlH	kutli	kutlu
jyzjɯlA	jyzjɯle	jyzjɯlɑ
ɑskerlAr	ɑskerlɑr	ɑskerler
byjymAH	byjymɑɯ	byjymei
hususDA	hususte	husustɑ
jønlArH	jønlɑrɯ	jønleri
jerlArDAn	jerlɑrden	jerlerden
deɰiʃimA	deɰiʃimɑ	deɰiʃime
geʧDHkDAn	geʧdiktɑn	geʧtikten
bɑɰɯʃɯklHk	bɑɰɯʃɯklik	bɑɰɯʃɯklɯk
dønemDAki	dønemdɑki	dønemdeki
kyltyrHn	kyltyrɯn	kyltyryn
odɑklH	odɑkli	odɑklɯ
tɑmɑmHHn	tɑmɑmiin	tɑmɑmɯɯn
jyzejA	jyzejɑ	jyzeje
jɑɰHʃ	jɑɰiʃ	jɑɰɯʃ
bugynHn	bugynin	bugynyn
bulAʃHʤH	bulɑʃiʤi	bulɑʃɯʤɯ
køjlArDA	køjlerdɑ	køjlerde
jønetmeliklAr	jønetmeliklɑr	jønetmelikler
zorunlulHk	zorunlulik	zorunluluk
iʃlAnmAH	iʃlɑnmɑɯ	iʃlenmei
tɑbiplArH	tɑbiplɑrɯ	tɑbipleri
jenilHkʧH	jenilikʧu	jenilikʧi
ɑtArAk	ɑterek	ɑtɑrɑk
deɰerlendirmAlAr	deɰerlendirmɑlɑr	deɰerlendirmeler
deɰiʃmA	deɰiʃmɑ	deɰiʃme
kɑlkAn	kɑlken	kɑlkɑn
jerDAki	jerdɑki	jerdeki
eklAnAn	eklɑnɑn	eklenen
durumDAki	durumtɑki	durumdɑki
etmAHn	etmɑɯn	etmein
gøstermAA	gøstermɑɑ	gøstermee
gɑzetelArDA	gɑzetelerdɑ	gɑzetelerde
odɑmHz	odɑmiz	odɑmɯz
hekimA	hekimɑ	hekime
iptɑlH	iptɑlɯ	iptɑli
rɑhɑtsHzlHk	rɑhɑtsizlik	rɑhɑtsɯzlɯk
tɑnɯmlH	tɑnɯmli	tɑnɯmlɯ
ɑɰɯzDAn	ɑɰɯzden	ɑɰɯzdɑn
ɑɰɑʧlArH	ɑɰɑʧleri	ɑɰɑʧlɑrɯ
ɑnlɑjɯʃHHn	ɑnlɑjɯʃiin	ɑnlɑjɯʃɯɯn
doɰɑDA	doɰɑde	doɰɑdɑ
gynmHzHn	gynmizin	gynmyzyn
ojH	oji	oju
suʧlH	suʧlɯ	suʧlu
tɑzminɑtH	tɑzminɑtu	tɑzminɑtɯ
jøreDA	jørete	jørede
øɰretmenlArH	øɰretmenlɑrɯ	øɰretmenleri
vɑtɑndɑʃlAr	vɑtɑndɑʃler	vɑtɑndɑʃlɑr
jɑpAlHm	jɑpɑlim	jɑpɑlɯm
dyʃmA	dyʃmɑ	dyʃme
inʤelemAlAr	inʤelemɑlɑr	inʤelemeler
kurslArH	kursleri	kurslɑrɯ
tɑrɑfsHz	tɑrɑfsiz	tɑrɑfsɯz
øzH	øzi	øzy
binDA	bindɑ	binde
dønmAH	dønmɑɯ	dønmei
fikirlAr	fikirlɑr	fikirler
isteAnlArHn	isteɑnlɑrɯn	isteenlerin
mɑlijetlAr	mɑlijetlɑr	mɑlijetler
olɑnɑklH	olɑnɑkli	olɑnɑklɯ
dɑkikɑlHk	dɑkikɑlik	dɑkikɑlɯk
kɑvrɑmHHn	kɑvrɑmiin	kɑvrɑmɯɯn
tɑmɑmlAmHʃ	tɑmɑmlemiʃ	tɑmɑmlɑmɯʃ
dyzenlemAlArHn	dyzenlemɑlɑrɯn	dyzenlemelerin
gidermA	gidermɑ	giderme
hususH	hususi	hususu
huzurlH	huzurli	huzurlu
søzleʃmeDA	søzleʃmete	søzleʃmede
suʧHn	suʧin	suʧun
tekliflAr	tekliflɑr	teklifler
toplumHHn	toplumiin	toplumuun
tutumH	tutumɯ	tutumu
jɑʃlArDA	jɑʃlerdɑ	jɑʃlɑrdɑ
etmADAn	etmɑden	etmeten
firmɑlArHHn	firmɑleriin	firmɑlɑrɯɯn
turH	turi	turu
usullArH	usullɑrɯ	usulleri
jollArDAn	jollɑrden	jollɑrdɑn
yrynlArA	yrynlɑrɑ	yrynlere
ystynDAki	ystyndɑki	ystyndeki
fɑktørlArHn	fɑktørlɑrɯn	fɑktørlerin
kuruluʃA	kuruluʃe	kuruluʃɑ
ortɑmHHn	ortɑmiin	ortɑmɯɯn
sɯnɑvlArA	sɯnɑvlere	sɯnɑvlɑrɑ
ɑlkɯʃlAr	ɑlkɯʃler	ɑlkɯʃlɑr
bilgisɑjɑrnHzA	bilgisɑjɑrnizɑ	bilgisɑjɑrnɯzɑ
dyzenlemAH	dyzenlemɑɯ	dyzenlemei
jɑʃlArH	jɑʃleri	jɑʃlɑrɯ
eklAnmAH	eklɑnmɑɯ	eklenmei
ihrɑʤɑtH	ihrɑʤɑtu	ihrɑʤɑtɯ
ilɑʧlArH	ilɑʧleri	ilɑʧlɑrɯ
sebeplArH	sebeplɑrɯ	sebepleri
silmA	silmɑ	silme
jønetimA	jønetimɑ	jønetime
jɑtɑklH	jɑtɑkli	jɑtɑklɯ
ɑrkɑdɑʃmHz	ɑrkɑdɑʃmiz	ɑrkɑdɑʃmɯz
gørArAk	gørɑrɑk	gørerek
jyryrlykDAn	jyryrlyktɑn	jyryrlykten
gønderArAk	gønderɑrɑk	gøndererek
orduHHn	orduiin	orduuun
ujumH	ujumɯ	ujumu
jɑʃɑmHHn	jɑʃɑmiin	jɑʃɑmɯɯn
ørgytlAr	ørgytlɑr	ørgytler
bɑzɯlArHHn	bɑzɯleriin	bɑzɯlɑrɯɯn
dujDHklArH	dujtiklɑrɯ	dujduklɑrɯ
gørevDA	gørevdɑ	gørevde
okulmHz	okulmiz	okulmuz
teʃekkyrlAr	teʃekkyrlɑr	teʃekkyrler
tijɑtroH	tijɑtroi	tijɑtrou
øɰrenmAA	øɰrenmɑɑ	øɰrenmee
ølʧymH	ølʧymɯ	ølʧymy
engellAAn	engellɑɑn	engelleen
progrɑmlArDA	progrɑmlerdɑ	progrɑmlɑrdɑ
bedensAl	bedensɑl	bedensel
girmAA	girmɑɑ	girmee
kesilmAH	kesilmɑɯ	kesilmei
sɑbɑhH	sɑbɑhi	sɑbɑhɯ
ujruklH	ujrukli	ujruklu
ɑrɑziDA	ɑrɑzite	ɑrɑzide
bilgisɑjɑrlH	bilgisɑjɑrli	bilgisɑjɑrlɯ
borʧlH	borʧlɯ	borʧlu
gelmAA	gelmɑɑ	gelmee
hemDA	hemdɑ	hemde
iʃlAnAn	iʃlɑnɑn	iʃlenen
kɯlɑvuzH	kɯlɑvuzi	kɯlɑvuzu
kɑtDA	kɑtte	kɑttɑ
kontrollArH	kontrollɑrɯ	kontrolleri
nedenlArDAn	nedenlɑrden	nedenlerden
sɑjfɑDAn	sɑjfɑden	sɑjfɑdɑn
ɑrkɑdɑʃlArHHn	ɑrkɑdɑʃleriin	ɑrkɑdɑʃlɑrɯɯn
bilmAAn	bilmɑɑn	bilmeen
desteklAnAn	desteklɑnɑn	desteklenen
sɑnɑtʧHHn	sɑnɑtʧiin	sɑnɑtʧɯɯn
sebeplAr	sebeplɑr	sebepler
vyʤutDA	vyʤutte	vyʤuttɑ
jerleʃmA	jerleʃmɑ	jerleʃme
kɑrɑrlArHHn	kɑrɑrleriin	kɑrɑrlɑrɯɯn
kuruluʃlArDAn	kuruluʃlerden	kuruluʃlɑrdɑn
søzʤyklAr	søzʤyklɑr	søzʤykler
turizmH	turizmɯ	turizmi
jykymlHlHklArH	jykymliliklɑrɯ	jykymlylykleri
jemeklAr	jemeklɑr	jemekler
bebeklAr	bebeklɑr	bebekler
dinsAl	dinsɑl	dinsel
sɑnɑtHn	sɑnɑtin	sɑnɑtɯn
fɯkrɑDA	fɯkrɑde	fɯkrɑdɑ
koordinɑtørH	koordinɑtøri	koordinɑtøry
orduHn	orduin	orduun
sunumH	sunumɯ	sunumu
jyrymA	jyrymɑ	jyryme
ʧiʧeklAr	ʧiʧeklɑr	ʧiʧekler
ɑrɑmHzDA	ɑrɑmɯzde	ɑrɑmɯzdɑ
dyzelmA	dyzelmɑ	dyzelme
gyndemDA	gyndemdɑ	gyndemde
hɯzDA	hɯzde	hɯzdɑ
semptomlAr	semptomler	semptomlɑr
bɑrɑʒH	bɑrɑʒi	bɑrɑʒɯ
bitDHkDAn	bittiktɑn	bittikten
etDHkDAn	ettiktɑn	ettikten
hususlArH	hususleri	hususlɑrɯ
mydyrlArH	mydyrlɑrɯ	mydyrleri
tɑlimɑtH	tɑlimɑtu	tɑlimɑtɯ
temizlAnmAH	temizlɑnmɑɯ	temizlenmei
jolHHn	joliin	joluun
benzeAn	benzeɑn	benzeen
gøryʃmelArDA	gøryʃmelerdɑ	gøryʃmelerde
girmADAn	girmɑden	girmeden
iʃlemlArDA	iʃlemlerdɑ	iʃlemlerde
lirɑDAn	lirɑden	lirɑdɑn
virysH	virysi	virysy
ødyllArH	ødyllɑrɯ	ødylleri
ødemAH	ødemɑɯ	ødemei
ʃiʃlH	ʃiʃlɯ	ʃiʃli
yʧlH	yʧlɯ	yʧly
byjyklHkDA	byjyklikte	byjyklykte
dønHʃH	døniʃi	dønyʃy
hepnHzA	hepnizɑ	hepnize
komutlArH	komutleri	komutlɑrɯ
kusursHz	kusursiz	kusursuz
metinlArH	metinlɑrɯ	metinleri
servisA	servisɑ	servise
ɑjlArH	ɑjleri	ɑjlɑrɯ
birɑrɑDA	birɑrɑde	birɑrɑdɑ
milletlArHn	milletlɑrɯn	milletlerin
sɑɰlAHʤH	sɑɰlɑiʤi	sɑɰlɑɯʤɯ
verAbilmA	verebilmɑ	verebilme
dønmA	dønmɑ	dønme
konulArDAn	konulɑrden	konulɑrdɑn
dergilArDA	dergilerdɑ	dergilerde
gøryʃmA	gøryʃmɑ	gøryʃme
gerʧeklAr	gerʧeklɑr	gerʧekler
konferɑnslAr	konferɑnsler	konferɑnslɑr
deɰiʃiklHklArA	deɰiʃikliklɑrɑ	deɰiʃikliklere
evlenmA	evlenmɑ	evlenme
evlArDA	evlerdɑ	evlerde
geliʃmAH	geliʃmɑɯ	geliʃmei
mevzuɑtA	mevzuɑte	mevzuɑtɑ
tedbirlArHn	tedbirlɑrɯn	tedbirlerin
jɯldɯzlAr	jɯldɯzler	jɯldɯzlɑr
dyzenlemAA	dyzenlemɑɑ	dyzenlemee
gelmADAn	gelmɑden	gelmeden
hɑllAr	hɑllɑr	hɑller
mɑsonlHk	mɑsonlik	mɑsonluk
jɯldɯzlH	jɯldɯzli	jɯldɯzlɯ
ɑlkollH	ɑlkolli	ɑlkolly
rektørH	rektøri	rektøry
jenilAnmAH	jenilenmɑɯ	jenilenmei
ɑdɑjlArH	ɑdɑjleri	ɑdɑjlɑrɯ
ɑlmAnHz	ɑlmɑniz	ɑlmɑnɯz
fikirlArH	fikirlɑrɯ	fikirleri
kiʃiDA	kiʃite	kiʃide
lisɑnssHz	lisɑnssiz	lisɑnssɯz
myʃterilArmHzA	myʃterilermizɑ	myʃterilermize
tɑrihlAr	tɑrihlɑr	tɑrihler
jɑpmADAn	jɑpmɑden	jɑpmɑtɑn
joɰunlHk	joɰunlik	joɰunluk
ɑrɑDAki	ɑrɑtɑki	ɑrɑdɑki
ɑteʃlH	ɑteʃlɯ	ɑteʃli
bytynH	bytyni	bytyny
doɰHʃ	doɰiʃ	doɰuʃ
montɑʒH	montɑʒi	montɑʒɯ
pijɑsɑDAki	pijɑsɑdeki	pijɑsɑdɑki
syrymH	syrymɯ	syrymy
tesislArDA	tesislerdɑ	tesislerde
toplumlArHn	toplumlerin	toplumlɑrɯn
ujgɑrlHk	ujgɑrlik	ujgɑrlɯk
jønetmA	jønetmɑ	jønetme
bɑroH	bɑroi	bɑrou
gøzHn	gøzin	gøzyn
tekliflArH	tekliflɑrɯ	teklifleri
jyklAnHʤH	jyklɑnɯʤɯ	jykleniʤi
øɰretimA	øɰretimɑ	øɰretime
bølymlArDA	bølymlerdɑ	bølymlerde
bɑkHp	bɑkip	bɑkɯp
gitmAH	gitmɑɯ	gitmei
progrɑmDAn	progrɑmden	progrɑmdɑn
rektørlHk	rektørlik	rektørlyk
jyzejsAl	jyzejsɑl	jyzejsel
jɑrdɯmlAr	jɑrdɯmler	jɑrdɯmlɑr
ɑlbymH	ɑlbymɯ	ɑlbymy
ɑjɯrAn	ɑjɯren	ɑjɯrɑn
gøsterDHklArH	gøsterdiklɑrɯ	gøsterdikleri
insɑnlArDAn	insɑnlɑrden	insɑnlɑrdɑn
kɑtA	kɑte	kɑtɑ
seʧimlArDA	seʧimlerdɑ	seʧimlerde
toplumlAr	toplumler	toplumlɑr
ørgytHHn	ørgytiin	ørgytyyn
dergiDA	dergite	dergide
gyzellHklArH	gyzelliklɑrɯ	gyzellikleri
hɑreketlArHn	hɑreketlɑrɯn	hɑreketlerin
hɑjɑlH	hɑjɑlɯ	hɑjɑli
søzHn	søzin	søzyn
ɑrkɑdɑʃlArmHzHn	ɑrkɑdɑʃlermizin	ɑrkɑdɑʃlɑrmɯzɯn
doɰumDAn	doɰumden	doɰumdɑn
ønH	ønɯ	øny
bytynlHk	bytynlik	bytynlyk
bozuklHk	bozuklik	bozukluk
dinlAr	dinlɑr	dinler
direnʧlH	direnʧlɯ	direnʧli
durmADAn	durmɑden	durmɑdɑn
etkinlHklArHn	etkinliklɑrɯn	etkinliklerin
fɑɑlijetlArDA	fɑɑlijetlɑrdɑ	fɑɑlijetlerde
hizmetlArDAn	hizmetlɑrden	hizmetlerden
kɑrʃɯlɯksHz	kɑrʃɯlɯksiz	kɑrʃɯlɯksɯz
tɯpDA	tɯpte	tɯptɑ
øɰrenʤilArmHzA	øɰrenʤilermizɑ	øɰrenʤilermize
ɑltɯnʤH	ɑltɯnʤi	ɑltɯnʤɯ
ɑmɑʧlArA	ɑmɑʧlere	ɑmɑʧlɑrɑ
bursH	bursi	bursu
esɑsH	esɑsi	esɑsɯ
iʧmA	iʧmɑ	iʧme
izlAnAn	izlɑnɑn	izlenen
krizA	krizɑ	krize
olmAmHz	olmemiz	olmɑmɯz
gøstermA	gøstermɑ	gøsterme
hɯrsɯzlHk	hɯrsɯzlik	hɯrsɯzlɯk
hizmetDAn	hizmettɑn	hizmetten
iʃlevsAl	iʃlevsɑl	iʃlevsel
mɑkbuzH	mɑkbuzi	mɑkbuzu
ʃɑrtlArHHn	ʃɑrtleriin	ʃɑrtlɑrɯɯn
etkinlHklArA	etkinliklɑrɑ	etkinliklere
komisjonA	komisjone	komisjonɑ
mesleklAr	mesleklɑr	meslekler
tɑbloHn	tɑbloin	tɑbloun
jykselmAH	jykselmɑɯ	jykselmei
elnHzDA	elnɯzde	elnizde
hedeflAnAn	hedeflɑnɑn	hedeflenen
iʧAʤAk	iʧeʤɑk	iʧeʤek
sektørlAr	sektørlɑr	sektørler
senDAn	sendɑn	senden
jyryAn	jyryɑn	jyryen
jɑrdɯmlAʃmA	jɑrdɯmleʃmɑ	jɑrdɯmlɑʃmɑ
jolsuzlHk	jolsuzlik	jolsuzluk
yrynlArDA	yrynlɑrdɑ	yrynlerde
bilgisɑjɑrDAn	bilgisɑjɑrden	bilgisɑjɑrdɑn
depoH	depoi	depou
depremDA	depremdɑ	depremde
getirmAH	getirmɑɯ	getirmei
hɑstɑnelArDA	hɑstɑnelerdɑ	hɑstɑnelerde
kɯzlAr	kɯzler	kɯzlɑr
miljonA	miljone	miljonɑ
syreʧlAr	syreʧlɑr	syreʧler
sektørlArDA	sektørlɑrdɑ	sektørlerde
vekillArH	vekillɑrɯ	vekilleri
jɑrɯʃmɑDA	jɑrɯʃmɑde	jɑrɯʃmɑdɑ
kɑrtHn	kɑrtin	kɑrtɯn
sɑɑtDAn	sɑɑttɑn	sɑɑtten
ødyllAr	ødyllɑr	ødyller
ɑtHʃ	ɑtiʃ	ɑtɯʃ
bojutlArA	bojutlere	bojutlɑrɑ
detɑjlArH	detɑjleri	detɑjlɑrɯ
esnɑDA	esnɑde	esnɑdɑ
jɑklɑʃɯmlArH	jɑklɑʃɯmleri	jɑklɑʃɯmlɑrɯ
ʃiirlArH	ʃiirlɑrɯ	ʃiirleri
ʃikɑjetlAr	ʃikɑjetlɑr	ʃikɑjetler
ɑvɑntɑʒlH	ɑvɑntɑʒli	ɑvɑntɑʒlɯ
denetlAr	denetlɑr	denetler
fɑrklHlHklArH	fɑrkliliklɑrɯ	fɑrklɯlɯklɑrɯ
giriʃimlArDA	giriʃimlerdɑ	giriʃimlerde
istikrɑrlH	istikrɑrli	istikrɑrlɯ
onurlH	onurli	onurlu
jorumlAr	jorumler	jorumlɑr
ɑmelijɑtH	ɑmelijɑtu	ɑmelijɑtɯ
ɑskerlArH	ɑskerlɑrɯ	ɑskerleri
bɑkHʃDA	bɑkiʃdɑ	bɑkɯʃtɑ
bɑslAr	bɑsler	bɑslɑr
etkenlAr	etkenlɑr	etkenler
hɑvɑDAn	hɑvɑden	hɑvɑdɑn
mɑntɯksAl	mɑntɯksel	mɑntɯksɑl
risklArH	risklɑrɯ	riskleri
seminerlArH	seminerlɑrɯ	seminerleri
tørenDA	tørendɑ	tørende
tɑmɑmlADHkDAn	tɑmɑmletiktɑn	tɑmɑmlɑdɯktɑn
ʧekmAA	ʧekmɑɑ	ʧekmee
ɑlɑnlArDAki	ɑlɑnlɑrtɑki	ɑlɑnlɑrdɑki
ellArH	ellɑrɯ	elleri
hɑftɑDAn	hɑftɑden	hɑftɑdɑn
ilʧelArDA	ilʧelerdɑ	ilʧelerde
kɑrtHHn	kɑrtiin	kɑrtɯɯn
kuʃlAr	kuʃler	kuʃlɑr
olmAlArnA	olmɑlɑrne	olmɑlɑrnɑ
politikɑlArHHn	politikɑleriin	politikɑlɑrɯɯn
ɑdɑmlArHHn	ɑdɑmleriin	ɑdɑmlɑrɯɯn
ɑʒɑnsH	ɑʒɑnsi	ɑʒɑnsɯ
dyzenlAnArAk	dyzenlɑnɑrɑk	dyzenlenerek
devletDAn	devlettɑn	devletten
mydyrHn	mydyrɯn	mydyryn
tɑmɑmlAArAk	tɑmɑmleerek	tɑmɑmlɑɑrɑk
ømyrlH	ømyrli	ømyrly
ʃehirlArDA	ʃehirlɑrdɑ	ʃehirlerde
borʧlArH	borʧleri	borʧlɑrɯ
dynjɑDAn	dynjɑtɑn	dynjɑdɑn
evsAl	evsɑl	evsel
kriterlArA	kriterlɑrɑ	kriterlere
ʧiʧeklArH	ʧiʧeklɑrɯ	ʧiʧekleri
yʧH	yʧi	yʧy
ɑrkɑDAn	ɑrkɑden	ɑrkɑdɑn
festivɑlH	festivɑlɯ	festivɑli
fijɑtA	fijɑte	fijɑtɑ
komisjonHHn	komisjoniin	komisjonuun
tɑʃlAr	tɑʃler	tɑʃlɑr
ønerilArDA	ønerilerdɑ	ønerilerde
ɑdɑmlAr	ɑdɑmler	ɑdɑmlɑr
dyʃynmAA	dyʃynmɑɑ	dyʃynmee
ellAr	ellɑr	eller
mydyrHHn	mydyriin	mydyryyn
jollArHHn	jolleriin	jollɑrɯɯn
ødemAH	ødemɑɯ	ødemei
ʃɑhɯslAr	ʃɑhɯsler	ʃɑhɯslɑr
dønyʃymH	dønyʃymɯ	dønyʃymy
derinDAn	derindɑn	derinden
formlAr	formler	formlɑr
hɑstɑlɯklArHHn	hɑstɑlɯkleriin	hɑstɑlɯklɑrɯɯn
inʤelemAA	inʤelemɑɑ	inʤelemee
inAn	inɑn	inen
internetDAn	internettɑn	internetten
pɑnellAr	pɑnellɑr	pɑneller
sembolH	sembolu	semboly
ørgytlH	ørgytli	ørgytly
ɑlɯnmADAn	ɑlɯnmɑden	ɑlɯnmɑdɑn
deɰerlendirmADA	deɰerlendirmɑde	deɰerlendirmede
orɑnlArHHn	orɑnleriin	orɑnlɑrɯɯn
jorgunlHk	jorgunlik	jorgunluk
yjelHkDAn	yjeliktɑn	yjelikten
bozuklHklAr	bozukliklɑr	bozukluklɑr
etɑpDA	etɑpte	etɑptɑ
formylH	formyli	formyly
kylH	kyli	kyly
kentlArDA	kentlɑrdɑ	kentlerde
olɑnɑksHz	olɑnɑksiz	olɑnɑksɯz
rɑkɑmlArH	rɑkɑmleri	rɑkɑmlɑrɯ
sonrɑDA	sonrɑde	sonrɑdɑ
tɑʃlArH	tɑʃleri	tɑʃlɑrɯ
jɑzɯlɯmlArHn	jɑzɯlɯmlerin	jɑzɯlɯmlɑrɯn
ørgytsAl	ørgytsɑl	ørgytsel
ɑnlɑmsHz	ɑnlɑmsiz	ɑnlɑmsɯz
bɑzDA	bɑzde	bɑzdɑ
gitmAA	gitmɑɑ	gitmee
hususlArDA	hususlerdɑ	hususlɑrdɑ
kesAn	kesɑn	kesen
plɑnlArHHn	plɑnleriin	plɑnlɑrɯɯn
sonlH	sonli	sonlu
jønetAn	jønetɑn	jøneten
ʃiirlAr	ʃiirlɑr	ʃiirler
bebeklArHn	bebeklɑrɯn	bebeklerin
gɑzlAr	gɑzler	gɑzlɑr
okulmHzDA	okulmizde	okulmuzdɑ
reformH	reformi	reformu
zorlHklAr	zorliklɑr	zorluklɑr
birikAn	birikɑn	biriken
dosjɑDA	dosjɑte	dosjɑdɑ
ermAH	ermɑɯ	ermei
geʧirArAk	geʧirɑrɑk	geʧirerek
isteAnlArA	isteɑnlɑrɑ	isteenlere
kurullArHHn	kurulleriin	kurullɑrɯɯn
sɑnɑtHHn	sɑnɑtiin	sɑnɑtɯɯn
sɑvɑʃlArH	sɑvɑʃleri	sɑvɑʃlɑrɯ
ulusHn	ulusin	ulusun
ʧɑlɯʃmɑmHzDA	ʧɑlɯʃmɑmɯzde	ʧɑlɯʃmɑmɯzdɑ
ɑdɑjlArA	ɑdɑjlere	ɑdɑjlɑrɑ
birliklAr	birliklɑr	birlikler
dyʃynHp	dyʃynip	dyʃynyp
hykymetlArHn	hykymetlɑrɯn	hykymetlerin
hizmetlArDA	hizmetlɑrdɑ	hizmetlerde
mɑkɑleDA	mɑkɑlete	mɑkɑlede
pɑjlArH	pɑjleri	pɑjlɑrɯ
sɑnɑtʧHlAr	sɑnɑtʧiler	sɑnɑtʧɯlɑr
tymHHn	tymiin	tymyyn
tɑrihinDAki	tɑrihinteki	tɑrihindeki
jenilAnAn	jenilɑnɑn	jenilenen
ɑvukɑtHn	ɑvukɑtin	ɑvukɑtɯn
bɑɰlAHʤH	bɑɰlɑiʤi	bɑɰlɑɯʤɯ
etrɑfH	etrɑfi	etrɑfɯ
formHn	formin	formun
konulArDAki	konulɑrtɑki	konulɑrdɑki
vermAlArH	vermɑlɑrɯ	vermeleri
ɑdɯmlArH	ɑdɯmleri	ɑdɯmlɑrɯ
bɑsDA	bɑste	bɑstɑ
edinmA	edinmɑ	edinme
gynlArA	gynlɑrɑ	gynlere
orgɑnlArHHn	orgɑnleriin	orgɑnlɑrɯɯn
sɑnɑtʧHH	sɑnɑtʧii	sɑnɑtʧɯɯ
uʧlArH	uʧleri	uʧlɑrɯ
jɑpɯlArHHn	jɑpɯleriin	jɑpɯlɑrɯɯn
zeminDA	zemindɑ	zeminde
ʧɯkmADAn	ʧɯkmɑden	ʧɯkmɑdɑn
ɑvukɑtH	ɑvukɑtu	ɑvukɑtɯ
hejeʤɑnlH	hejeʤɑnli	hejeʤɑnlɯ
kɯjmetlAr	kɯjmetlɑr	kɯjmetler
pɑtlAHʤH	pɑtleiʤi	pɑtlɑɯʤɯ
suʧlArH	suʧleri	suʧlɑrɯ
tytynlArDA	tytynlɑrdɑ	tytynlerde
jɑrdɯmlArH	jɑrdɯmleri	jɑrdɯmlɑrɯ
deɰerlendirmAlArH	deɰerlendirmɑlɑrɯ	deɰerlendirmeleri
deɰiʃmAlAr	deɰiʃmɑlɑr	deɰiʃmeler
fijɑtlArHHn	fijɑtleriin	fijɑtlɑrɯɯn
hɯzlArH	hɯzleri	hɯzlɑrɯ
ihtijɑʧlArHHn	ihtijɑʧleriin	ihtijɑʧlɑrɯɯn
metinlArHn	metinlɑrɯn	metinlerin
muɑjeneDA	muɑjenete	muɑjenede
sɑnɑjiDA	sɑnɑjite	sɑnɑjide
tyrDA	tyrdɑ	tyrde
ʧɑlɯʃmAlArDAn	ʧɑlɯʃmɑlɑrden	ʧɑlɯʃmɑlɑrdɑn
ʃehirlAr	ʃehirlɑr	ʃehirler
ɑʃkH	ɑʃki	ɑʃkɯ
ɑrɑjyzH	ɑrɑjyzi	ɑrɑjyzy
byjymAA	byjymɑɑ	byjymee
bojlH	bojli	bojlu
bugynlArDA	bugynlɑrdɑ	bugynlerde
deɰiʃkenlAr	deɰiʃkenlɑr	deɰiʃkenler
devirDA	devirdɑ	devirde
firmɑlArDAn	firmɑlɑrden	firmɑlɑrdɑn
formHHn	formiin	formuun
ilArDA	ilerdɑ	ilerde
iliʃkilArDA	iliʃkilerdɑ	iliʃkilerde
konferɑnsDA	konferɑnste	konferɑnstɑ
ʧoʤuklArmHz	ʧoʤuklɑrmiz	ʧoʤuklɑrmɯz
yʧnʤHH	yʧnʤii	yʧnʤyy
ɑlɑnlArDAn	ɑlɑnlɑrden	ɑlɑnlɑrdɑn
formɑtH	formɑtu	formɑtɯ
geʧirmA	geʧirmɑ	geʧirme
geʧmiʃDAn	geʧmiʃden	geʧmiʃten
hɑlkmHz	hɑlkmiz	hɑlkmɯz
hɑzɯrlAmHʃ	hɑzɯrlemiʃ	hɑzɯrlɑmɯʃ
kulɑkDA	kulɑkte	kulɑktɑ
mɑsrɑfH	mɑsrɑfi	mɑsrɑfɯ
silɑhH	silɑhi	silɑhɯ
ʧoʤukDA	ʧoʤukte	ʧoʤuktɑ
ørtylH	ørtyli	ørtyly
ɑdresnHzA	ɑdresnizɑ	ɑdresnize
ɑskerlArHn	ɑskerlɑrɯn	ɑskerlerin
deɰerlendirArAk	deɰerlendirɑrɑk	deɰerlendirerek
gøtyrmA	gøtyrmɑ	gøtyrme
hɑstɑlɯklArDAn	hɑstɑlɯklɑrden	hɑstɑlɯklɑrdɑn
kɑrɑrlHlHk	kɑrɑrlilik	kɑrɑrlɯlɯk
kɑjdetmA	kɑjdetmɑ	kɑjdetme
ortɑmlAr	ortɑmler	ortɑmlɑr
sɑnɑjilAʃmA	sɑnɑjileʃmɑ	sɑnɑjileʃme
tɑmɑmlɑnDHkDAn	tɑmɑmlɑndiktɑn	tɑmɑmlɑndɯktɑn
telgrɑfH	telgrɑfi	telgrɑfɯ
jyklAmA	jyklɑmɑ	jykleme
ʧoʤuklArmHzHn	ʧoʤuklɑrmizin	ʧoʤuklɑrmɯzɯn
ɑrkɑDA	ɑrkɑde	ɑrkɑdɑ
bilmAH	bilmɑɯ	bilmei
ʤɑnlHlArHn	ʤɑnlilerin	ʤɑnlɯlɑrɯn
gynlArHn	gynlɑrɯn	gynlerin
hɑzɯrlɯklH	hɑzɯrlɯkli	hɑzɯrlɯklɯ
kongreDA	kongrete	kongrede
meʤlisA	meʤlisɑ	meʤlise
temɑsH	temɑsi	temɑsɯ
tuzH	tuzi	tuzu
jyzlH	jyzli	jyzly
jɑpmAmHz	jɑpmemiz	jɑpmɑmɯz
jɑsɑDA	jɑsɑde	jɑsɑdɑ
ɑdɑDA	ɑdɑde	ɑdɑdɑ
birDA	birdɑ	birde
gelHnʤAA	gelinʤɑɑ	gelinʤee
merkeznDAki	merkezndɑki	merkezndeki
performɑnslH	performɑnsli	performɑnslɯ
jurtiʧinDA	jurtiʧindɑ	jurtiʧinde
ʃɑhɯslArA	ʃɑhɯslere	ʃɑhɯslɑrɑ
yʧAr	yʧɑr	yʧer
ɑltDAki	ɑltteki	ɑlttɑki
donɑnɯmlH	donɑnɯmli	donɑnɯmlɯ
dozH	dozi	dozu
durumlArA	durumlere	durumlɑrɑ
eklArH	eklɑrɯ	ekleri
geʧmAmA	geʧmɑmɑ	geʧmeme
inʤelemAlArDA	inʤelemɑlɑrdɑ	inʤelemelerde
milletlArɑrɑsɯ	milletlɑrɑrɑsɯ	milletlerɑrɑsɯ
tyrlAr	tyrlɑr	tyrler
tɑmɑmlAr	tɑmɑmler	tɑmɑmlɑr
tebliɰH	tebliɰɯ	tebliɰi
vɑtɑndɑʃlHk	vɑtɑndɑʃlik	vɑtɑndɑʃlɯk
ørgytlArHn	ørgytlɑrɯn	ørgytlerin
ɑletlAr	ɑletlɑr	ɑletler
bordroH	bordroi	bordrou
polisA	polisɑ	polise
sɯnɯfHn	sɯnɯfin	sɯnɯfɯn
sɯnɑvHn	sɯnɑvin	sɯnɑvɯn
jerjyzynDA	jerjyzyndɑ	jerjyzynde
ekiplAr	ekiplɑr	ekipler
geliʃmAlArDAn	geliʃmɑlɑrden	geliʃmelerden
kɑmpysH	kɑmpysi	kɑmpysy
kɑvrɑmlArHn	kɑvrɑmlerin	kɑvrɑmlɑrɯn
kentlAʃmA	kentlɑʃmɑ	kentleʃme
liderlArH	liderlɑrɯ	liderleri
merkezlArDA	merkezlɑrdɑ	merkezlerde
ortɑmlArH	ortɑmleri	ortɑmlɑrɯ
sɑtHʃlArH	sɑtiʃleri	sɑtɯʃlɑrɯ
tɑbiplAr	tɑbiplɑr	tɑbipler
tɑrɑHʤH	tɑrɑiʤi	tɑrɑɯʤɯ
jorumH	jorumɯ	jorumu
ʧøzmAA	ʧøzmɑɑ	ʧøzmee
yrynlArmHz	yrynlɑrmiz	yrynlermiz
byjymAH	byjymɑɯ	byjymei
gyʧlArHn	gyʧlɑrɯn	gyʧlerin
ihtijɑʧlArA	ihtijɑʧlere	ihtijɑʧlɑrɑ
køsA	køsɑ	køse
kyltyrlArH	kyltyrlɑrɯ	kyltyrleri
kɑrtlArHHn	kɑrtleriin	kɑrtlɑrɯɯn
sunHʃ	suniʃ	sunuʃ
usullAr	usullɑr	usuller
øɰrenmAHn	øɰrenmɑɯn	øɰrenmein
ɑrɑlɯklH	ɑrɑlɯkli	ɑrɑlɯklɯ
doɰHʃDAn	doɰuʃden	doɰuʃtɑn
fɯrsɑtDA	fɯrsɑtte	fɯrsɑttɑ
girDHkDAn	girdiktɑn	girdikten
kusurlH	kusurli	kusurlu
tozH	tozi	tozu
jyrekDAn	jyrektɑn	jyrekten
fotoɰrɑfʧH	fotoɰrɑfʧi	fotoɰrɑfʧɯ
kullɑnmADAn	kullɑnmɑden	kullɑnmɑdɑn
kurumlArDAn	kurumlerden	kurumlɑrdɑn
kuvvetlArHn	kuvvetlɑrɯn	kuvvetlerin
sebepDAn	sebepden	sebepten
teʃkilɑtHHn	teʃkilɑtiin	teʃkilɑtɯɯn
jyrymAA	jyrymɑɑ	jyrymee
ʧoʤuklArmHzA	ʧoʤuklɑrmizɑ	ʧoʤuklɑrmɯzɑ
ʃimdilArDA	ʃimdilerdɑ	ʃimdilerde
yzHʤH	yziʤi	yzyʤy
dyzeltmA	dyzeltmɑ	dyzeltme
emekʧH	emekʧu	emekʧi
hususlArA	hususlere	hususlɑrɑ
kɑrɑnlɯkDA	kɑrɑnlɯkte	kɑrɑnlɯktɑ
kɑjɯtlArHHn	kɑjɯtleriin	kɑjɯtlɑrɯɯn
mɑkɑmlArA	mɑkɑmlere	mɑkɑmlɑrɑ
normɑlA	normɑlɑ	normɑle
olɑjlArDAn	olɑjlerden	olɑjlɑrdɑn
ojlArHn	ojlerin	ojlɑrɯn
sɯʤɑklɯkDA	sɯʤɑklɯkte	sɯʤɑklɯktɑ
sɑnɑtA	sɑnɑte	sɑnɑtɑ
tekliflArHn	tekliflɑrɯn	tekliflerin
jørelArDA	jørelerdɑ	jørelerde
øɰretimDA	øɰretimdɑ	øɰretimde
ɑkɯmlArH	ɑkɯmleri	ɑkɯmlɑrɯ
ɑteʃDA	ɑteʃdɑ	ɑteʃte
bilgisɑjɑrnHzHn	bilgisɑjɑrnizin	bilgisɑjɑrnɯzɯn
detɑjlAr	detɑjler	detɑjlɑr
etmAmA	etmɑmɑ	etmeme
gelDHkDAn	geldiktɑn	geldikten
iʃɑretlAr	iʃɑretlɑr	iʃɑretler
iʃgɑlH	iʃgɑlɯ	iʃgɑli
kurDAn	kurtɑn	kurdɑn
lisɑnslH	lisɑnsli	lisɑnslɯ
toplumDAki	toplumtɑki	toplumdɑki
vɑtɑndɑʃlArmHzHn	vɑtɑndɑʃlermizin	vɑtɑndɑʃlɑrmɯzɯn
jyklAr	jyklɑr	jykler
ʧevreDAki	ʧevreteki	ʧevredeki
ɑileDA	ɑilete	ɑilede
eriʃmA	eriʃmɑ	eriʃme
gøryntyHn	gøryntyin	gøryntyyn
gelDHklArH	geldiklɑrɯ	geldikleri
iʃletmelArDA	iʃletmelerdɑ	iʃletmelerde
illAr	illɑr	iller
operɑtørH	operɑtøri	operɑtøry
søzHHn	søziin	søzyyn
tyrHHn	tyriin	tyryyn
tɑmɑmlAHʤH	tɑmɑmleiʤi	tɑmɑmlɑɯʤɯ
ulɑʃAbilmA	ulɑʃɑbilmɑ	ulɑʃɑbilme
jɑprɑklH	jɑprɑkli	jɑprɑklɯ
yjelArmHzA	yjelermizɑ	yjelermize
bilgisɑjɑrnHzDA	bilgisɑjɑrnizde	bilgisɑjɑrnɯzdɑ
bulHʃ	buliʃ	buluʃ
doɰrulHk	doɰrulik	doɰruluk
fɑkylteDA	fɑkyltete	fɑkyltede
iletiʃimDA	iletiʃimdɑ	iletiʃimde
kɑlkHp	kɑlkip	kɑlkɯp
kɑjɯtlArA	kɑjɯtlere	kɑjɯtlɑrɑ
myrɑʤɑɑtH	myrɑʤɑɑtu	myrɑʤɑɑtɯ
mesɑʒHn	mesɑʒin	mesɑʒɯn
rɑporlArHHn	rɑporleriin	rɑporlɑrɯɯn
syrHp	syrup	syryp
syrmAH	syrmɑɯ	syrmei
tɑsɑrɯmlArH	tɑsɑrɯmleri	tɑsɑrɯmlɑrɯ
jønDAki	jøndɑki	jøndeki
jemekDAn	jemektɑn	jemekten
doktorHn	doktorɯn	doktorun
getirDHklArH	getirdiklɑrɯ	getirdikleri
notHHn	notiin	notuun
ortɑmDAn	ortɑmden	ortɑmdɑn
reformlAr	reformler	reformlɑr
risklAr	risklɑr	riskler
susHz	susiz	susuz
ujgulɑmADAn	ujgulɑmɑden	ujgulɑmɑdɑn
jyryHʃH	jyryiʃi	jyryyʃy
jɑɰHʃlH	jɑɰiʃlɯ	jɑɰɯʃlɯ
øɰretmenlArA	øɰretmenlɑrɑ	øɰretmenlere
bølgelArDAki	bølgelerdɑki	bølgelerdeki
formɑtDA	formɑtte	formɑttɑ
getirmAH	getirmɑɯ	getirmei
gitmADAn	gitmɑden	gitmeden
mensuplArHHn	mensupleriin	mensuplɑrɯɯn
niteliklAr	niteliklɑr	nitelikler
søjlemAA	søjlemɑɑ	søjlemee
jurtDA	jurtte	jurttɑ
ølʧylArDA	ølʧylerdɑ	ølʧylerde
ʃɑhHn	ʃɑhin	ʃɑhɯn
bileʃenlArH	bileʃenlɑrɯ	bileʃenleri
dɑlDA	dɑlde	dɑldɑ
gelmADA	gelmɑde	gelmete
grupDAn	grupden	gruptɑn
hususlArHn	hususlerin	hususlɑrɯn
iʃletmeDA	iʃletmete	iʃletmede
kullɑnmADA	kullɑnmɑde	kullɑnmɑtɑ
jyzjɯlDAn	jyzjɯlden	jyzjɯldɑn
bɑʃlɑDHkDAn	bɑʃlɑtiktɑn	bɑʃlɑdɯktɑn
bɑʃlɑHnʤA	bɑʃlɑɯnʤe	bɑʃlɑɯnʤɑ
bugynDAn	bugyndɑn	bugynden
elmDA	elmdɑ	elmde
gøryntylH	gøryntyli	gøryntyly
kesimDA	kesimdɑ	kesimde
mevzuɑtHn	mevzuɑtin	mevzuɑtɯn
sɯnɑvlArHn	sɯnɑvlerin	sɯnɑvlɑrɯn
syrArAk	syrɑrɑk	syrerek
sɑhneDA	sɑhnete	sɑhnede
sektørlArA	sektørlɑrɑ	sektørlere
bɑslAAn	bɑsleen	bɑslɑɑn
eklAnArAk	eklɑnɑrɑk	eklenerek
kɑrɑkterlArH	kɑrɑkterlɑrɯ	kɑrɑkterleri
rɑhɑtlHk	rɑhɑtlik	rɑhɑtlɯk
øɰrenmAH	øɰrenmɑɯ	øɰrenmei
ʃɑnslH	ʃɑnsli	ʃɑnslɯ
grɑfiklAr	grɑfiklɑr	grɑfikler
istemAAn	istemɑɑn	istemeen
kollHk	kollik	kolluk
okulmHzHn	okulmizin	okulmuzun
sɑnɑtʧHlArHn	sɑnɑtʧilerin	sɑnɑtʧɯlɑrɯn
sorunlArDAn	sorunlɑrden	sorunlɑrdɑn
timA	timɑ	time
ødemAA	ødemɑɑ	ødemee
ɑdɑjlArHHn	ɑdɑjleriin	ɑdɑjlɑrɯɯn
defɑDA	defɑde	defɑdɑ
etmAlH	etmɑlɯ	etmeli
giriʃimDA	giriʃimdɑ	giriʃimde
ihrɑʤɑtʧH	ihrɑʤɑtʧi	ihrɑʤɑtʧɯ
ihrɑʤɑtA	ihrɑʤɑte	ihrɑʤɑtɑ
kɑrɑkterlAr	kɑrɑkterlɑr	kɑrɑkterler
kesmA	kesmɑ	kesme
stɑndɑrtlArHHn	stɑndɑrtleriin	stɑndɑrtlɑrɯɯn
tɑrɑfHHn	tɑrɑfiin	tɑrɑfɯɯn
jɑkɯnlArHHn	jɑkɯnleriin	jɑkɯnlɑrɯɯn
øɰretmA	øɰretmɑ	øɰretme
øzgyrlHklAr	øzgyrliklɑr	øzgyrlykler
ʃekillAr	ʃekillɑr	ʃekiller
dɑvrɑnHʃlArHn	dɑvrɑniʃlerin	dɑvrɑnɯʃlɑrɯn
engellArH	engellɑrɯ	engelleri
gynejA	gynejɑ	gyneje
girAbilmA	girɑbilmɑ	girebilme
hɑrflArH	hɑrflɑrɯ	hɑrfleri
izinlArH	izinlɑrɯ	izinleri
kɑmuHn	kɑmuin	kɑmuun
kurDHklArH	kurdiklɑrɯ	kurduklɑrɯ
mɑntɯklH	mɑntɯkli	mɑntɯklɯ
renklArHn	renklɑrɯn	renklerin
syslH	sysli	sysly
sebeplArDAn	sebeplɑrden	sebeplerden
sulArHHn	suleriin	sulɑrɯɯn
telefonA	telefone	telefonɑ
ɯʃɯklH	ɯʃɯkli	ɯʃɯklɯ
demokrɑtiklAʃmA	demokrɑtiklɑʃmɑ	demokrɑtikleʃme
dilmHzA	dilmyze	dilmize
gøstermADA	gøstermɑde	gøstermete
herkesDAn	herkestɑn	herkesten
kɑrlHlHk	kɑrlilik	kɑrlɯlɯk
mevsimsAl	mevsimsɑl	mevsimsel
silɑhlArH	silɑhleri	silɑhlɑrɯ
tesisɑtH	tesisɑtu	tesisɑtɯ
tonA	tone	tonɑ
jɑtɯrɯmlArA	jɑtɯrɯmlere	jɑtɯrɯmlɑrɑ
jijeʤeklAr	jijeʤeklɑr	jijeʤekler
ødeArAk	ødeɑrɑk	ødeerek
ɑlɑlHm	ɑlɑlim	ɑlɑlɯm
burslH	bursli	burslu
doktornHz	doktorniz	doktornuz
emmA	emmɑ	emme
fedɑkɑrlHk	fedɑkɑrlik	fedɑkɑrlɯk
izlemAA	izlemɑɑ	izlemee
kolɑjlHklAr	kolɑjliklɑr	kolɑjlɯklɑr
liflAr	liflɑr	lifler
mysteʃɑrlHk	mysteʃɑrlik	mysteʃɑrlɯk
sytHn	sytin	sytyn
tuʃlArH	tuʃleri	tuʃlɑrɯ
jɑʃlHlAr	jɑʃliler	jɑʃlɯlɑr
ʧøzymlAnmAH	ʧøzymlɑnmɑɯ	ʧøzymlenmei
bugynH	bugyni	bugyny
direktørH	direktøri	direktøry
gøryʃHn	gøryʃin	gøryʃyn
gitmA	gitmɑ	gitme
konforlH	konforli	konforlu
konserlAr	konserlɑr	konserler
kullɑnmAnHz	kullɑnmɑniz	kullɑnmɑnɯz
mɑddeDAki	mɑddeteki	mɑddedeki
tɑʃɯnmɑzHn	tɑʃɯnmɑzin	tɑʃɯnmɑzɯn
tɑbloH	tɑbloi	tɑblou
tɑkɯmlArH	tɑkɯmleri	tɑkɯmlɑrɯ
toprɑkDA	toprɑkte	toprɑktɑ
ʧɯkHnʤA	ʧɯkinʤe	ʧɯkɯnʤɑ
ɑkɯmlAr	ɑkɯmler	ɑkɯmlɑr
birleʃArAk	birleʃɑrɑk	birleʃerek
deDHklArH	detiklɑrɯ	dedikleri
edilAmAAn	edilemɑɑn	edilemeen
esnɑfH	esnɑfi	esnɑfɯ
gyneʃlH	gyneʃlɯ	gyneʃli
gelAnlArHn	gelɑnlɑrɯn	gelenlerin
girHʃDA	giriʃdɑ	giriʃte
ilerleDHkʧA	ilerletikʧe	ilerledikʧe
motorHn	motorɯn	motorun
otellAr	otellɑr	oteller
ruhHn	ruhin	ruhun
topHn	topin	topun
byjyklHk	byjyklik	byjyklyk
bilmADAn	bilmɑden	bilmeden
bojlArH	bojleri	bojlɑrɯ
edinAn	edinɑn	edinen
fɯrsɑtlArH	fɯrsɑtleri	fɯrsɑtlɑrɯ
gelmA	gelmɑ	gelme
iʧeriklArH	iʧeriklɑrɯ	iʧerikleri
ithɑlɑtH	ithɑlɑtu	ithɑlɑtɯ
lirɑlHk	lirɑlik	lirɑlɯk
mɑnɑDA	mɑnɑde	mɑnɑdɑ
mɑterjɑllAr	mɑterjɑllɑr	mɑterjɑller
resimDA	resimdɑ	resimde
tonlHk	tonlik	tonluk
øzgyrlHklArH	øzgyrliklɑrɯ	øzgyrlykleri
ɑrtHʃlAr	ɑrtiʃler	ɑrtɯʃlɑr
ɑrtmADA	ɑrtmɑde	ɑrtmɑtɑ
bɑhsetmA	bɑhsetmɑ	bɑhsetme
bebeklArDA	bebeklɑrdɑ	bebeklerde
dɑlHHn	dɑliin	dɑlɯɯn
dosjɑlArHHn	dosjɑleriin	dosjɑlɑrɯɯn
grupDAki	grupteki	gruptɑki
kytyphɑneDA	kytyphɑnete	kytyphɑnede
mɑterjɑlH	mɑterjɑlɯ	mɑterjɑli
seʧimDA	seʧimdɑ	seʧimde
temellAr	temellɑr	temeller
topʧH	topʧi	topʧu
ølymHn	ølymin	ølymyn
ørneklArHn	ørneklɑrɯn	ørneklerin
denetlAnmAH	denetlɑnmɑɯ	denetlenmei
emirlArH	emirlɑrɯ	emirleri
eserDA	eserdɑ	eserde
esnɑfHn	esnɑfin	esnɑfɯn
frekɑnsH	frekɑnsi	frekɑnsɯ
gøryʃmeDA	gøryʃmete	gøryʃmede
gyryltylH	gyryltyli	gyryltyly
gɑzHn	gɑzin	gɑzɯn
hɑksHzlHk	hɑksizlik	hɑksɯzlɯk
hɑrflAr	hɑrflɑr	hɑrfler
hɑstɑlɯklH	hɑstɑlɯkli	hɑstɑlɯklɯ
istemAH	istemɑɯ	istemei
lyzumlH	lyzumli	lyzumlu
modellArHn	modellɑrɯn	modellerin
olɑnɑklArHHn	olɑnɑkleriin	olɑnɑklɑrɯɯn
sorunlH	sorunli	sorunlu
jɯllArDAki	jɯllɑrtɑki	jɯllɑrdɑki
dyzenleDHklArH	dyzenletiklɑrɯ	dyzenledikleri
filmDA	filmdɑ	filmde
kɯsɯmlAr	kɯsɯmler	kɯsɯmlɑr
kentlAr	kentlɑr	kentler
konferɑnsHn	konferɑnsin	konferɑnsɯn
kurumDAn	kurumden	kurumdɑn
kuzejA	kuzejɑ	kuzeje
modH	modi	modu
sɑɰlɑmADA	sɑɰlɑmɑde	sɑɰlɑmɑtɑ
sɑkɑtlHk	sɑkɑtlik	sɑkɑtlɯk
sɑvɑʃlAr	sɑvɑʃler	sɑvɑʃlɑr
tyjlH	tyjli	tyjly
terørHn	terørɯn	terøryn
tutulumH	tutulumɯ	tutulumu
zorlHklArH	zorliklɑrɯ	zorluklɑrɯ
ɑvukɑtlArH	ɑvukɑtleri	ɑvukɑtlɑrɯ
etkinliklArDA	etkinliklɑrdɑ	etkinliklerde
gølHn	gølin	gølyn
hɑberDA	hɑberdɑ	hɑberde
hɑtlArHHn	hɑtleriin	hɑtlɑrɯɯn
misɑlH	misɑlɯ	misɑli
numɑrɑnHzH	numɑrɑnizi	numɑrɑnɯzɯ
operɑtørlAr	operɑtørlɑr	operɑtørler
pɑrlɑmentoH	pɑrlɑmentoi	pɑrlɑmentou
referɑnslAr	referɑnsler	referɑnslɑr
sɑɰlAAbilmA	sɑɰlɑɑbilmɑ	sɑɰlɑɑbilme
stɑʒH	stɑʒi	stɑʒɯ
tɑkɯmlAr	tɑkɯmler	tɑkɯmlɑr
verDHkDAn	verdiktɑn	verdikten
vermADAn	vermɑden	vermeten
vermAmA	vermɑmɑ	vermeme
vermAHn	vermɑɯn	vermein
jøntemDA	jøntemdɑ	jøntemde
ʧɑlɯʃmAlArmHzH	ʧɑlɯʃmɑlɑrmizi	ʧɑlɯʃmɑlɑrmɯzɯ
bɑkHnʤA	bɑkinʤe	bɑkɯnʤɑ
edebijɑtHHn	edebijɑtiin	edebijɑtɯɯn
fɑktørlArDAn	fɑktørlɑrden	fɑktørlerden
gørmAH	gørmɑɯ	gørmei
køprylH	køpryli	køpryly
odɑlArHHn	odɑleriin	odɑlɑrɯɯn
sɯnɑvlArDA	sɯnɑvlerdɑ	sɯnɑvlɑrdɑ
søjleDHklArH	søjletiklɑrɯ	søjledikleri
tɑsɑrɯmlAr	tɑsɑrɯmler	tɑsɑrɯmlɑr
toprɑklArHHn	toprɑkleriin	toprɑklɑrɯɯn
ønleAʤAk	ønleeʤɑk	ønleeʤek
yʤretlArHn	yʤretlɑrɯn	yʤretlerin
bɑnkɑmHz	bɑnkɑmiz	bɑnkɑmɯz
biʧimlArDA	biʧimlerdɑ	biʧimlerde
bilimA	bilimɑ	bilime
engellAnmAH	engellɑnmɑɯ	engellenmei
gørynymlH	gørynymli	gørynymly
gørAbilmA	gørebilmɑ	gørebilme
kyrlAʃmA	kyrlɑʃmɑ	kyrleʃme
kɑmpA	kɑmpe	kɑmpɑ
okullArHHn	okulleriin	okullɑrɯɯn
søzʤyklArH	søzʤyklɑrɯ	søzʤykleri
sporHn	sporɯn	sporun
tytynlArH	tytynlɑrɯ	tytynleri
jykymlHlHk	jykymlilik	jykymlylyk
jyklAnmAH	jyklɑnmɑɯ	jyklenmei
ɑmirlArH	ɑmirlɑrɯ	ɑmirleri
ɑtHp	ɑtup	ɑtɯp
bytynlAʃmA	bytynlɑʃmɑ	bytynleʃme
byjyklAr	byjyklɑr	byjykler
distribytørH	distribytøri	distribytøry
durumlArHHn	durumleriin	durumlɑrɯɯn
dujmADAn	dujmɑden	dujmɑdɑn
ekonomiDAki	ekonomiteki	ekonomideki
elnHzDAki	elnɯzdeki	elnizdeki
enstityHn	enstityin	enstityyn
fijɑtlArA	fijɑtlere	fijɑtlɑrɑ
irtibɑtA	irtibɑte	irtibɑtɑ
køklArH	køklɑrɯ	køkleri
kesimA	kesimɑ	kesime
kuruluʃDA	kuruluʃdɑ	kuruluʃtɑ
mɑdenlAr	mɑdenlɑr	mɑdenler
pɑketlAr	pɑketlɑr	pɑketler
petrolHn	petrolin	petrolyn
jɑʃlHlHk	jɑʃlilik	jɑʃlɯlɯk
ʧøzymHn	ʧøzymin	ʧøzymyn
ʃɑhɯslArHn	ʃɑhɯslerin	ʃɑhɯslɑrɯn
ystynlHk	ystynlik	ystynlyk
ɑkʃɑmlArH	ɑkʃɑmleri	ɑkʃɑmlɑrɯ
birimA	birimɑ	birime
gønyllHlArH	gønyllileri	gønyllyleri
geʧmAAn	geʧmɑɑn	geʧmeen
hɑberlArA	hɑberlɑrɑ	hɑberlere
hɑlkmHzA	hɑlkmyze	hɑlkmɯzɑ
hɑstɑlArHHn	hɑstɑleriin	hɑstɑlɑrɯɯn
isteArAk	isteɑrɑk	isteerek
kɑhrɑmɑnlHk	kɑhrɑmɑnlik	kɑhrɑmɑnlɯk
kɑpɑsiteDA	kɑpɑsitete	kɑpɑsitede
kɑpɑtHp	kɑpɑtup	kɑpɑtɯp
liderlAr	liderlɑr	liderler
liflArH	liflɑrɯ	lifleri
prensiplAr	prensiplɑr	prensipler
rɑkɑmlArA	rɑkɑmlere	rɑkɑmlɑrɑ
tɑɑhhytlH	tɑɑhhytli	tɑɑhhytly
tɑrɑfmHzDAn	tɑrɑfmizden	tɑrɑfmɯzdɑn
uzɑkDAki	uzɑkteki	uzɑktɑki
jønetimDA	jønetimdɑ	jønetimde
jerleʃAn	jerleʃɑn	jerleʃen
jurtdɯʃɯnDAki	jurtdɯʃɯnteki	jurtdɯʃɯndɑki
bɑʃɑrɯsHzlHk	bɑʃɑrɯsizlik	bɑʃɑrɯsɯzlɯk
ʤihɑzlArHHn	ʤihɑzleriin	ʤihɑzlɑrɯɯn
dokuHn	dokuin	dokuun
gørynHʃ	gøryniʃ	gørynyʃ
kɑjbetmADAn	kɑjbetmɑden	kɑjbetmeden
kolA	kole	kolɑ
kumH	kumɯ	kumu
mɑddelArDA	mɑddelerdɑ	mɑddelerde
renklArDA	renklɑrdɑ	renklerde
syreʧlArHn	syreʧlɑrɯn	syreʧlerin
sɑtHʃlAr	sɑtiʃler	sɑtɯʃlɑr
senɑtoH	senɑtoi	senɑtou
sorumlHlArH	sorumlileri	sorumlulɑrɯ
tɑkɯmmHz	tɑkɯmmiz	tɑkɯmmɯz
tɑrɑflArDAn	tɑrɑflɑrden	tɑrɑflɑrdɑn
ɑʧɯkDA	ɑʧɯkte	ɑʧɯktɑ
bølmA	bølmɑ	bølme
bilgilArnHzA	bilgilernizɑ	bilgilernize
burslAr	bursler	burslɑr
dɑvrɑnHʃlArHHn	dɑvrɑniʃleriin	dɑvrɑnɯʃlɑrɯɯn
deɰiʃmAAn	deɰiʃmɑɑn	deɰiʃmeen
devreDA	devrete	devrede
dozDA	dozde	dozdɑ
gørmAAn	gørmɑɑn	gørmeen
hedeflArHn	hedeflɑrɯn	hedeflerin
herʃejA	herʃejɑ	herʃeje
koʃulDA	koʃulde	koʃuldɑ
kullɑnɯmlArH	kullɑnɯmleri	kullɑnɯmlɑrɯ
kusurH	kusuri	kusuru
modyllArH	modyllɑrɯ	modylleri
okulDAki	okuldeki	okuldɑki
olAlHm	olelim	olɑlɯm
sɯnɯrlArHHn	sɯnɯrleriin	sɯnɯrlɑrɯɯn
syregelAn	syregelɑn	syregelen
sɑlonA	sɑlone	sɑlonɑ
ʃirketlArDA	ʃirketlɑrdɑ	ʃirketlerde
dostlArH	dostleri	dostlɑrɯ
eksiklHklAr	eksikliklɑr	eksiklikler
hykymlHlArHn	hykymlilerin	hykymlylerin
hukukHHn	hukukiin	hukukuun
ihrɑʤɑtHn	ihrɑʤɑtin	ihrɑʤɑtɯn
illArA	illɑrɑ	illere
inʤelemADA	inʤelemete	inʤelemede
istɑtistiklAr	istɑtistiklɑr	istɑtistikler
sɑjfɑlHk	sɑjfɑlik	sɑjfɑlɯk
jɑpmAm	jɑpmem	jɑpmɑm
jɑrH	jɑrɯ	jɑri
jɑvɑʃʧA	jɑvɑʃʧe	jɑvɑʃʧɑ
ɑrtHʃHn	ɑrtiʃin	ɑrtɯʃɯn
beklemAA	beklemɑɑ	beklemee
durumlArHn	durumlerin	durumlɑrɯn
itirɑzlAr	itirɑzler	itirɑzlɑr
nyfuslH	nyfusli	nyfuslu
olɑjlArHHn	olɑjleriin	olɑjlɑrɯɯn
typH	typɯ	typy
jerlArDAki	jerlɑrtɑki	jerlerdeki
bɑʃkɑnlArHHn	bɑʃkɑnleriin	bɑʃkɑnlɑrɯɯn
hɑsɑrlH	hɑsɑrli	hɑsɑrlɯ
ihlɑlH	ihlɑlɯ	ihlɑli
kentlArHn	kentlɑrɯn	kentlerin
meslektɑʃlArmHzHn	meslektɑʃlermizin	meslektɑʃlɑrmɯzɯn
niteliklArA	niteliklɑrɑ	niteliklere
sɑɰlɯksHz	sɑɰlɯksiz	sɑɰlɯksɯz
seminerDA	seminerdɑ	seminerde
ɑlHnʤA	ɑlinʤe	ɑlɯnʤɑ
ɑlternɑtiflAr	ɑlternɑtiflɑr	ɑlternɑtifler
bildirimDA	bildirimdɑ	bildirimde
dɑɰɯlɯmlArH	dɑɰɯlɯmleri	dɑɰɯlɯmlɑrɯ
etydH	etydi	etydy
gyʧlyklAr	gyʧlyklɑr	gyʧlykler
hɑstɑlArDAn	hɑstɑlɑrden	hɑstɑlɑrdɑn
ilerlemAH	ilerlemɑɯ	ilerlemei
izlAnAʤAk	izlɑnɑʤɑk	izleneʤek
køtylHk	køtylik	køtylyk
kɑbloH	kɑbloi	kɑblou
kɑslArH	kɑsleri	kɑslɑrɯ
kumlH	kumli	kumlu
listeDAki	listeteki	listedeki
ormɑnlHk	ormɑnlik	ormɑnlɯk
seferlArH	seferlɑrɯ	seferleri
vɑtɑndɑʃlArA	vɑtɑndɑʃlere	vɑtɑndɑʃlɑrɑ
jorHʤH	joruʤi	joruʤu
ʧekilmA	ʧekilmɑ	ʧekilme
ɑhlɑkH	ɑhlɑki	ɑhlɑkɯ
denetimA	denetimɑ	denetime
doɰHʃH	doɰiʃi	doɰuʃu
dokuHHn	dokuiin	dokuuun
evDAki	evtɑki	evdeki
fɑbrikɑDA	fɑbrikɑde	fɑbrikɑdɑ
geʧmAA	geʧmɑɑ	geʧmee
kurɑllArHHn	kurɑlleriin	kurɑllɑrɯɯn
metreA	metreɑ	metree
modyllAr	modyllɑr	modyller
sinjɑlH	sinjɑlɯ	sinjɑli
sistemDAki	sistemdɑki	sistemdeki
sitemHzA	sitemizɑ	sitemize
usulA	usulɑ	usule
ujgulɑmɑlArDAn	ujgulɑmɑlɑrden	ujgulɑmɑlɑrdɑn
vɑtɑndɑʃlArH	vɑtɑndɑʃleri	vɑtɑndɑʃlɑrɯ
vermAnHz	vermɑniz	vermeniz
jɑrɑtArAk	jɑrɑterek	jɑrɑtɑrɑk
ønDAn	øndɑn	ønden
øzellHklArDAn	øzelliklɑrden	øzelliklerden
eksiklHklArHn	eksikliklɑrɯn	eksikliklerin
erkeklArA	erkeklɑrɑ	erkeklere
firmɑDAn	firmɑden	firmɑdɑn
geʧmiʃDAki	geʧmiʃtɑki	geʧmiʃteki
getirmAAn	getirmɑɑn	getirmeen
hɑjɑtmHzHn	hɑjɑtmizin	hɑjɑtmɯzɯn
huzurH	huzuri	huzuru
kɑlkɯnmADA	kɑlkɯnmɑde	kɑlkɯnmɑdɑ
medjɑDA	medjɑte	medjɑdɑ
memurHn	memurɯn	memurun
olɑjlArDA	olɑjlerdɑ	olɑjlɑrdɑ
rɑjlH	rɑjli	rɑjlɯ
rollAr	rollɑr	roller
syryʤyHn	syryʤyin	syryʤyyn
tyrHn	tyrɯn	tyryn
vermAAʤAk	vermɑɑʤɑk	vermeeʤek
jɑkɯnlHk	jɑkɯnlik	jɑkɯnlɯk
ɑlɑʤɑklArHHn	ɑlɑʤɑkleriin	ɑlɑʤɑklɑrɯɯn
dyrystlHk	dyrystlik	dyrystlyk
denetlAmA	denetlɑmɑ	denetleme
firmɑDA	firmɑde	firmɑdɑ
gyneʃDAn	gyneʃden	gyneʃten
kurslArA	kurslere	kurslɑrɑ
metotlArH	metotleri	metotlɑrɯ
okuHʤHA	okuiʤie	okuuʤuɑ
semptomlArH	semptomleri	semptomlɑrɯ
tuʃlAr	tuʃler	tuʃlɑr
jønetmA	jønetmɑ	jønetme
ʧorlH	ʧorli	ʧorlu
øɰrenmAH	øɰrenmɑɯ	øɰrenmei
ʤɑmlAr	ʤɑmler	ʤɑmlɑr
deɰerlendirmAH	deɰerlendirmɑɯ	deɰerlendirmei
etmAnHzH	etmɑnizi	etmenizi
girmAAn	girmɑɑn	girmeen
kɑnɑtlH	kɑnɑtli	kɑnɑtlɯ
kɑrɑkteristiklArH	kɑrɑkteristiklɑrɯ	kɑrɑkteristikleri
kɑslArHn	kɑslerin	kɑslɑrɯn
konulArHHn	konuleriin	konulɑrɯɯn
kulyplArH	kulyplɑrɯ	kulypleri
pɑzɑrDAki	pɑzɑrtɑki	pɑzɑrdɑki
sɯnɯrHHn	sɯnɯriin	sɯnɯrɯɯn
sɑtɯrA	sɑtɯre	sɑtɯrɑ
tytynH	tytyni	tytyny
jykHHn	jykiin	jykyyn
ʧɯkDHkDAn	ʧɯktiktɑn	ʧɯktɯktɑn
ɑʧɯlArDAn	ɑʧɯlɑrden	ɑʧɯlɑrdɑn
bilgisɑjɑrnHzH	bilgisɑjɑrnizi	bilgisɑjɑrnɯzɯ
ʤɑmlArH	ʤɑmleri	ʤɑmlɑrɯ
ellArHn	ellɑrɯn	ellerin
fotoɰrɑfDA	fotoɰrɑfte	fotoɰrɑftɑ
gørmADAn	gørmɑden	gørmeden
gynlArDAn	gynlɑrden	gynlerden
gyzellHklAr	gyzelliklɑr	gyzellikler
gereklArH	gereklɑrɯ	gerekleri
isteklAr	isteklɑr	istekler
kyresAllAʃmAHn	kyresellɑʃmɑɯn	kyreselleʃmein
kontrollAr	kontrollɑr	kontroller
minerɑllArH	minerɑllɑrɯ	minerɑlleri
operɑtørlArH	operɑtørlɑrɯ	operɑtørleri
unutmAAlHm	unutmɑɑlim	unutmɑɑlɯm
vɑtɑndɑʃlArmHz	vɑtɑndɑʃlermiz	vɑtɑndɑʃlɑrmɯz
ɑdlArHHn	ɑdleriin	ɑdlɑrɯɯn
ɑmɑʧlArHHn	ɑmɑʧleriin	ɑmɑʧlɑrɯɯn
ɑnlAAbilmA	ɑnlɑɑbilmɑ	ɑnlɑɑbilme
bølymmHz	bølymmiz	bølymmyz
byjytmA	byjytmɑ	byjytme
belirlemADA	belirlemete	belirlemede
dyzejlArDA	dyzejlerdɑ	dyzejlerde
dojurHʤH	dojuruʤi	dojuruʤu
gørynHʃH	gøryniʃi	gørynyʃy
gidermA	gidermɑ	giderme
gitmAH	gitmɑɯ	gitmei
iʃlemAA	iʃlemɑɑ	iʃlemee
iletiʃimA	iletiʃimɑ	iletiʃime
minerɑllAr	minerɑllɑr	minerɑller
odɑDAn	odɑden	odɑdɑn
sɑbɑhHn	sɑbɑhin	sɑbɑhɯn
sɑvɑʃHHn	sɑvɑʃiin	sɑvɑʃɯɯn
sergiDA	sergite	sergide
vyʤutDAki	vyʤutteki	vyʤuttɑki
jyrymA	jyrymɑ	jyryme
jyznʤH	jyznʤi	jyznʤy
øɰretmA	øɰretmɑ	øɰretme
ʃehirlArHn	ʃehirlɑrɯn	ʃehirlerin
bɑkHʃH	bɑkiʃi	bɑkɯʃɯ
bɑnkɑDAn	bɑnkɑden	bɑnkɑdɑn
døkymHHn	døkymiin	døkymyyn
eriʃkinlArDA	eriʃkinlɑrdɑ	eriʃkinlerde
gelirlArHn	gelirlɑrɯn	gelirlerin
hɑllArH	hɑllɑrɯ	hɑlleri
huzursHzlHk	huzursizlik	huzursuzluk
iʧimDA	iʧimdɑ	iʧimde
ihrɑʤɑtDA	ihrɑʤɑtte	ihrɑʤɑttɑ
iliʃkiDA	iliʃkite	iliʃkide
inʤelAnAn	inʤelɑnɑn	inʤelenen
kɑldɯrHp	kɑldɯrup	kɑldɯrɯp
mɑkɑmlAr	mɑkɑmler	mɑkɑmlɑr
onnʤH	onnʤi	onnʤu
tyrlArHn	tyrlɑrɯn	tyrlerin
tɑhminlArH	tɑhminlɑrɯ	tɑhminleri
tɑnɯmlAAn	tɑnɯmleen	tɑnɯmlɑɑn
tebliɰlAr	tebliɰlɑr	tebliɰler
testlArHn	testlɑrɯn	testlerin
jyzejlArDA	jyzejlerdɑ	jyzejlerde
jɑtArAk	jɑterek	jɑtɑrɑk
jijeʤeklArH	jijeʤeklɑrɯ	jijeʤekleri
ɑʃɑmɑDAn	ɑʃɑmɑden	ɑʃɑmɑdɑn
byjytmA	byjytmɑ	byjytme
benimseAn	benimseɑn	benimseen
birimlArDA	birimlerdɑ	birimlerde
gɑzlArn	gɑzlern	gɑzlɑrn
iʧermAAn	iʧermɑɑn	iʧermeen
ithɑlɑtʧH	ithɑlɑtʧi	ithɑlɑtʧɯ
kɑlmAksHzHn	kɑlmɑksizin	kɑlmɑksɯzɯn
olgunlHk	olgunlik	olgunluk
pijɑsɑDAn	pijɑsɑden	pijɑsɑdɑn
syrmADA	syrmɑde	syrmete
sɑnɑtʧHlArH	sɑnɑtʧileri	sɑnɑtʧɯlɑrɯ
sɑjmHzDA	sɑjmizde	sɑjmɯzdɑ
toplummHzHn	toplummizin	toplummuzun
jøreA	jøreɑ	jøree
jyryArAk	jyryɑrɑk	jyryerek
ʧɯkmADA	ʧɯkmɑde	ʧɯkmɑtɑ
ɑrtHʃA	ɑrtiʃe	ɑrtɯʃɑ
binDAn	bindɑn	binden
grɑfiklArH	grɑfiklɑrɯ	grɑfikleri
kɯzlArHn	kɯzlerin	kɯzlɑrɯn
kɑrtnHzHn	kɑrtnizin	kɑrtnɯzɯn
mydyrmHz	mydyrmiz	mydyrmyz
memurlArHHn	memurleriin	memurlɑrɯɯn
modellArDA	modellɑrdɑ	modellerde
sɯnɑvDAn	sɯnɑvden	sɯnɑvdɑn
sevijeDAki	sevijeteki	sevijedeki
solDA	solde	soldɑ
solDAn	solden	soldɑn
tohumlArH	tohumleri	tohumlɑrɯ
ʧevirmA	ʧevirmɑ	ʧevirme
ʃɑrtlH	ʃɑrtli	ʃɑrtlɯ
ɑdɑjlArDAn	ɑdɑjlerden	ɑdɑjlɑrdɑn
bøʤeklAr	bøʤeklɑr	bøʤekler
bilgisɑjɑrnHz	bilgisɑjɑrniz	bilgisɑjɑrnɯz
dønDHkDAn	døndiktɑn	døndykten
døvHʃ	døviʃ	døvyʃ
derneklArHn	derneklɑrɯn	derneklerin
dillArDA	dillɑrdɑ	dillerde
elnHzA	elnɯzɑ	elnize
gøzlH	gøzli	gøzly
gelmAAn	gelmɑɑn	gelmeen
hykymetDAn	hykymettɑn	hykymetten
hɑtɑsHz	hɑtɑsiz	hɑtɑsɯz
insɑnlArHHn	insɑnleriin	insɑnlɑrɯɯn
kɑrtnHz	kɑrtniz	kɑrtnɯz
kɑrtlH	kɑrtli	kɑrtlɯ
mɑkɑmlArH	mɑkɑmleri	mɑkɑmlɑrɯ
meslekDAn	meslektɑn	meslekten
onɑjlAr	onɑjler	onɑjlɑr
sɯnɑvHHn	sɯnɑviin	sɯnɑvɯɯn
sɑfhɑDA	sɑfhɑde	sɑfhɑdɑ
sɑnɑjinDA	sɑnɑjindɑ	sɑnɑjinde
toplumDAn	toplumden	toplumdɑn
jetiʃkinlAr	jetiʃkinlɑr	jetiʃkinler
ʧekilmA	ʧekilmɑ	ʧekilme
yjelHklArH	yjeliklɑrɯ	yjelikleri
ɑlternɑtiflArH	ɑlternɑtiflɑrɯ	ɑlternɑtifleri
ɑrɑʧlArA	ɑrɑʧlere	ɑrɑʧlɑrɑ
bildirArAk	bildirɑrɑk	bildirerek
girmAH	girmɑɯ	girmei
hɑklArDAn	hɑklɑrden	hɑklɑrdɑn
ilerlemAA	ilerlemɑɑ	ilerlemee
illArH	illɑrɯ	illeri
kɯʃlHk	kɯʃlik	kɯʃlɯk
kɑrtnHzH	kɑrtnizi	kɑrtnɯzɯ
kɑslAr	kɑsler	kɑslɑr
mezunlArHHn	mezunleriin	mezunlɑrɯɯn
oturumH	oturumɯ	oturumu
rɑkɑmlArHn	rɑkɑmlerin	rɑkɑmlɑrɯn
seferDA	seferdɑ	seferde
jɯldɯzlArH	jɯldɯzleri	jɯldɯzlɑrɯ
jønelAn	jønelɑn	jønelen
jyklAnAn	jyklɑnɑn	jyklenen
jenilHklArA	jeniliklɑrɑ	jeniliklere
ɯslɑhH	ɯslɑhi	ɯslɑhɯ
ødemAlArHn	ødemɑlɑrɯn	ødemelerin
ʃenliklArH	ʃenliklɑrɯ	ʃenlikleri
yzermHzA	yzermizɑ	yzermize
ɑidɑtH	ɑidɑtu	ɑidɑtɯ
ɑntibijotiklAr	ɑntibijotiklɑr	ɑntibijotikler
ɑrtHʃHHn	ɑrtiʃiin	ɑrtɯʃɯɯn
byjyDHkʧA	byjydikʧe	byjydykʧe
dɑvrɑnHʃlArDA	dɑvrɑniʃlerdɑ	dɑvrɑnɯʃlɑrdɑ
gørmADA	gørmɑde	gørmete
hɑstɑDAn	hɑstɑden	hɑstɑdɑn
izinlAr	izinlɑr	izinler
kɑldɯrAn	kɑldɯren	kɑldɯrɑn
literɑtyrDA	literɑtyrdɑ	literɑtyrde
noktɑlArHHn	noktɑleriin	noktɑlɑrɯɯn
noktɑlArDAn	noktɑlɑrden	noktɑlɑrdɑn
pɑdiʃɑhHn	pɑdiʃɑhin	pɑdiʃɑhɯn
sɯfɑtH	sɯfɑtu	sɯfɑtɯ
syrtynmA	syrtynmɑ	syrtynme
sektørlArH	sektørlɑrɯ	sektørleri
sembollAr	sembollɑr	semboller
soruHHn	soruiin	soruuun
uluslH	ulusli	uluslu
ulusH	ulusi	ulusu
virysHn	virysin	virysyn
jɑpAbilmAH	jɑpɑbilmɑɯ	jɑpɑbilmei
ɑltA	ɑlte	ɑltɑ
bɑsHp	bɑsip	bɑsɯp
bugynlArA	bugynlɑrɑ	bugynlere
fonksijonlArHHn	fonksijonleriin	fonksijonlɑrɯɯn
gyrsAl	gyrsɑl	gyrsel
hyʤreA	hyʤreɑ	hyʤree
hykymlHlAr	hykymliler	hykymlyler
imɑʒH	imɑʒi	imɑʒɯ
istemAA	istemɑɑ	istemee
kyltyrlArHn	kyltyrlɑrɯn	kyltyrlerin
kullɑnmADAn	kullɑnmɑden	kullɑnmɑtɑn
otellArDA	otellɑrdɑ	otellerde
sinjɑllArH	sinjɑllɑrɯ	sinjɑlleri
jykHn	jykin	jykyn
ørgytlAnmAH	ørgytlɑnmɑɯ	ørgytlenmei
dyzenlemAH	dyzenlemɑɯ	dyzenlemei
evreDA	evrete	evrede
fijɑtHHn	fijɑtiin	fijɑtɯɯn
forumH	forumɯ	forumu
gøryntylAmA	gøryntylɑmɑ	gøryntyleme
hyʤrelArDA	hyʤrelerdɑ	hyʤrelerde
køkH	køki	køky
menyDAki	menytɑki	menydeki
olHʃ	oliʃ	oluʃ
tymørlAr	tymørlɑr	tymørler
tetkiklArH	tetkiklɑrɯ	tetkikleri
ujumlHlHk	ujumlilik	ujumluluk
jɑpmAnHzH	jɑpmenizi	jɑpmɑnɯzɯ
ʧɑɰmHzDA	ʧɑɰmizde	ʧɑɰmɯzdɑ
øzgyrlHklArHn	øzgyrliklɑrɯn	øzgyrlyklerin
yrynDA	yryndɑ	yrynde
ɑʧɯkʧAH	ɑʧɯkʧei	ɑʧɯkʧɑɯ
ɑfetlAr	ɑfetlɑr	ɑfetler
bølymmHzDA	bølymmizde	bølymmyzde
bɑnkɑlArHHn	bɑnkɑleriin	bɑnkɑlɑrɯɯn
bileʃiklAr	bileʃiklɑr	bileʃikler
bojutA	bojute	bojutɑ
dɯʃDAn	dɯʃden	dɯʃtɑn
dyʃmɑnlHk	dyʃmɑnlik	dyʃmɑnlɯk
emzirmA	emzirmɑ	emzirme
etmAm	etmɑm	etmem
hepmHzA	hepmyze	hepmize
kɑnɑllH	kɑnɑlli	kɑnɑllɯ
kodlH	kodli	kodlu
merɑklH	merɑkli	merɑklɯ
muhɑbirlArH	muhɑbirlɑrɯ	muhɑbirleri
risklArHn	risklɑrɯn	risklerin
sɯklHkDA	sɯklikte	sɯklɯktɑ
sɯnɯfHHn	sɯnɯfiin	sɯnɯfɯɯn
sɑbɯrlH	sɑbɯrli	sɑbɯrlɯ
sevijelArDA	sevijelerdɑ	sevijelerde
jɑzlArH	jɑzleri	jɑzlɑrɯ
ʧeklAr	ʧeklɑr	ʧekler
ølʧmA	ølʧmɑ	ølʧme
ɑkHp	ɑkip	ɑkɯp
besinlAr	besinlɑr	besinler
gøllAr	gøllɑr	gøller
gøryʃArAk	gøryʃɑrɑk	gøryʃerek
impɑrɑtorlHk	impɑrɑtorlik	impɑrɑtorluk
linklArH	linklɑrɯ	linkleri
rollArH	rollɑrɯ	rolleri
sevArAk	sevɑrɑk	severek
vɑkɑDA	vɑkɑde	vɑkɑdɑ
verAʤAklArH	vereʤeklɑrɯ	vereʤekleri
jɑʃɑmADA	jɑʃɑmɑde	jɑʃɑmɑtɑ
jɑnlɯʃlHk	jɑnlɯʃlik	jɑnlɯʃlɯk
jɑprɑklArHHn	jɑprɑkleriin	jɑprɑklɑrɯɯn
ʧɑlɯʃmADAn	ʧɑlɯʃmɑden	ʧɑlɯʃmɑdɑn
ysH	ysi	ysy
ɑkHʃHHn	ɑkiʃiin	ɑkɯʃɯɯn
birejA	birejɑ	bireje
bozHʤH	boziʤi	bozuʤu
durgunlHk	durgunlik	durgunluk
dujHnʤA	dujinʤe	dujunʤɑ
ellArDA	ellɑrdɑ	ellerde
etmAmAH	etmɑmɑɯ	etmemei
firmɑnHzHn	firmɑnizin	firmɑnɯzɯn
kirlAnmA	kirlɑnmɑ	kirlenme
konumHz	konumiz	konumuz
mɑkinɑlArHHn	mɑkinɑleriin	mɑkinɑlɑrɯɯn
orgɑnizɑsjonA	orgɑnizɑsjone	orgɑnizɑsjonɑ
pɑnoH	pɑnoi	pɑnou
subɑjlAr	subɑjler	subɑjlɑr
topA	tope	topɑ
toplummHzDA	toplummizde	toplummuzdɑ
ørmA	ørmɑ	ørme
ʃiʃmA	ʃiʃmɑ	ʃiʃme
ɑkɯlDA	ɑkɯlde	ɑkɯldɑ
ɑndɯrAn	ɑndɯren	ɑndɯrɑn
ɑrkɑdɑʃlArHn	ɑrkɑdɑʃlerin	ɑrkɑdɑʃlɑrɯn
ɑvH	ɑvu	ɑvɯ
ɑjrɯʤɑlɯklH	ɑjrɯʤɑlɯkli	ɑjrɯʤɑlɯklɯ
bɑʃnHzA	bɑʃnizɑ	bɑʃnɯzɑ
dyʃynmADAn	dyʃynmɑden	dyʃynmeden
dekɑnlHk	dekɑnlik	dekɑnlɯk
demAA	demɑɑ	demee
doktornHzA	doktornizɑ	doktornuzɑ
etmenlAr	etmenlɑr	etmenler
fikirlArHn	fikirlɑrɯn	fikirlerin
gørynymA	gørynymɑ	gørynyme
girDHklArH	girdiklɑrɯ	girdikleri
iʧermAH	iʧermɑɯ	iʧermei
ilɑʧlArA	ilɑʧlere	ilɑʧlɑrɑ
kɑmpDA	kɑmpte	kɑmptɑ
mɑhɑllinDA	mɑhɑllindɑ	mɑhɑllinde
mektupDA	mektupte	mektuptɑ
metɑllAr	metɑllɑr	metɑller
sɑntrɑlH	sɑntrɑlɯ	sɑntrɑli
seʧAn	seʧɑn	seʧen
tɑleplArHn	tɑleplɑrɯn	tɑleplerin
tɑnɯmlAHʤH	tɑnɯmleiʤi	tɑnɯmlɑɯʤɯ
tesisA	tesisɑ	tesise
jøreDAki	jøreteki	jøredeki
ʧɯkHʃlArH	ʧɯkiʃleri	ʧɯkɯʃlɑrɯ
ʧevirmA	ʧevirmɑ	ʧevirme
ɯsrɑrlH	ɯsrɑrli	ɯsrɑrlɯ
ɑlɯnmADA	ɑlɯnmɑde	ɑlɯnmɑtɑ
ɑlmAnHzH	ɑlmɑnizi	ɑlmɑnɯzɯ
ɑnlɑmlArH	ɑnlɑmleri	ɑnlɑmlɑrɯ
ɑtH	ɑtu	ɑtɯ
belirlemAA	belirlemɑɑ	belirlemee
besinlArHn	besinlɑrɯn	besinlerin
borsɑDA	borsɑde	borsɑdɑ
dɑllArHHn	dɑlleriin	dɑllɑrɯɯn
hɑvɑDAki	hɑvɑtɑki	hɑvɑdɑki
iʃlemAH	iʃlemɑɯ	iʃlemei
kɯzlArH	kɯzleri	kɯzlɑrɯ
kesinlAʃAn	kesinlɑʃɑn	kesinleʃen
kitɑplArHHn	kitɑpleriin	kitɑplɑrɯɯn
okulHHn	okuliin	okuluun
sɑʧlArH	sɑʧleri	sɑʧlɑrɯ
sɑjfɑmHzDA	sɑjfɑmɯzde	sɑjfɑmɯzdɑ
sesA	sesɑ	sese
tɑnɯklHk	tɑnɯklik	tɑnɯklɯk
uzmɑnlArHHn	uzmɑnleriin	uzmɑnlɑrɯɯn
ʧøzHʤH	ʧøziʤi	ʧøzyʤy
ʃɑrtsHz	ʃɑrtsiz	ʃɑrtsɯz
ystDAn	ysttɑn	ystten
ɑrkɑdɑʃmHzHn	ɑrkɑdɑʃmizin	ɑrkɑdɑʃmɯzɯn
ɑrkɑdɑʃlArmA	ɑrkɑdɑʃlermɑ	ɑrkɑdɑʃlɑrmɑ
bɑʃɑrɯlArHHn	bɑʃɑrɯleriin	bɑʃɑrɯlɑrɯɯn
bileʃAn	bileʃɑn	bileʃen
dønmAA	dønmɑɑ	dønmee
fotoɰrɑfʧHlHk	fotoɰrɑfʧilik	fotoɰrɑfʧɯlɯk
fotoɰrɑfʧHlAr	fotoɰrɑfʧiler	fotoɰrɑfʧɯlɑr
hyzynlH	hyzynli	hyzynly
hɑberlArHn	hɑberlɑrɯn	hɑberlerin
hɑjɑtmHzDA	hɑjɑtmizde	hɑjɑtmɯzdɑ
ilerlemAlAr	ilerlemɑlɑr	ilerlemeler
insɑnmHzHn	insɑnmizin	insɑnmɯzɯn
kɑtArAk	kɑterek	kɑtɑrɑk
mɑsɑDA	mɑsɑde	mɑsɑdɑ
pɑrɑsHz	pɑrɑsiz	pɑrɑsɯz
reɑksijonA	reɑksijone	reɑksijonɑ
syrelArDA	syrelerdɑ	syrelerde
sytʧH	sytʧi	sytʧy
sɑjɯlArHHn	sɑjɯleriin	sɑjɯlɑrɯɯn
sɑjfɑmHz	sɑjfɑmiz	sɑjfɑmɯz
senDA	sendɑ	sende
tɑhminlAr	tɑhminlɑr	tɑhminler
toplɑntɯHHn	toplɑntɯiin	toplɑntɯɯɯn
jɑptɯrɯmlAr	jɑptɯrɯmler	jɑptɯrɯmlɑr
ødyllH	ødylli	ødylly
ødemelArDA	ødemelerdɑ	ødemelerde
ʃiʃmɑnlHk	ʃiʃmɑnlik	ʃiʃmɑnlɯk
yrynlArDAn	yrynlɑrden	yrynlerden
ɑɰɯzlArH	ɑɰɯzleri	ɑɰɯzlɑrɯ
ɑsɯllH	ɑsɯlli	ɑsɯllɯ
bileʃiklArH	bileʃiklɑrɯ	bileʃikleri
bulmADA	bulmɑde	bulmɑtɑ
dyʃynyrlAr	dyʃynyrlɑr	dyʃynyrler
dyʃynsAl	dyʃynsɑl	dyʃynsel
elmHzA	elmyze	elmize
emirlAr	emirlɑr	emirler
gyʧDA	gyʧdɑ	gyʧte
geʧirmAA	geʧirmɑɑ	geʧirmee
illArDAn	illɑrden	illerden
illArHn	illɑrɯn	illerin
ipH	ipɯ	ipi
istɑtistiklArH	istɑtistiklɑrɯ	istɑtistikleri
kɑnɑtlArH	kɑnɑtleri	kɑnɑtlɑrɯ
mɑterjɑllArH	mɑterjɑllɑrɯ	mɑterjɑlleri
merkezmHzA	merkezmyze	merkezmize
meslektɑʃlArmHz	meslektɑʃlermiz	meslektɑʃlɑrmɯz
modernlAʃmA	modernlɑʃmɑ	modernleʃme
nɑzlH	nɑzli	nɑzlɯ
olArAkDA	olɑrɑkte	olɑrɑktɑ
penʤereA	penʤereɑ	penʤeree
protokollAr	protokollɑr	protokoller
ruhsɑtlH	ruhsɑtli	ruhsɑtlɯ
sektørlArHn	sektørlɑrɯn	sektørlerin
sergilAnAn	sergilɑnɑn	sergilenen
sinirlAr	sinirlɑr	sinirler
sistemnHzA	sistemnizɑ	sistemnize
sporDA	sportɑ	spordɑ
tɑlimɑtlArH	tɑlimɑtleri	tɑlimɑtlɑrɯ
tɑnkH	tɑnki	tɑnkɯ
tiplAr	tiplɑr	tipler
jɯldɯzlArHn	jɯldɯzlerin	jɯldɯzlɑrɯn
jɑpmAlArnH	jɑpmelernɯ	jɑpmɑlɑrnɯ
ʧoʤuklArDAn	ʧoʤuklɑrden	ʧoʤuklɑrdɑn
ʃeffɑflHk	ʃeffɑflik	ʃeffɑflɯk
bɑʃHHn	bɑʃiin	bɑʃɯɯn
dønyʃmAH	dønyʃmɑɯ	dønyʃmei
denizlArDA	denizlɑrdɑ	denizlerde
disklAr	disklɑr	diskler
dokuznʤH	dokuznʤi	dokuznʤu
donɑnɯmlArH	donɑnɯmleri	donɑnɯmlɑrɯ
dostʧA	dostʧe	dostʧɑ
elmA	elmɑ	elme
gyʧlyklArH	gyʧlyklɑrɯ	gyʧlykleri
iʃverenlAr	iʃverenlɑr	iʃverenler
konsoloslHk	konsoloslik	konsolosluk
mysteʃɑrlHkʧA	mysteʃɑrlikʧe	mysteʃɑrlɯkʧɑ
misɑfirlAr	misɑfirlɑr	misɑfirler
nerelArDA	nerelerdɑ	nerelerde
progrɑmlArDAn	progrɑmlerden	progrɑmlɑrdɑn
rektørHn	rektørɯn	rektøryn
ruhsɑtsHz	ruhsɑtsiz	ruhsɑtsɯz
senetlAr	senetlɑr	senetler
silɑhHn	silɑhin	silɑhɯn
telefonnHzHn	telefonnizin	telefonnuzun
tetkiklAr	tetkiklɑr	tetkikler
ʧɯrɑklHk	ʧɯrɑklik	ʧɯrɑklɯk
ønlemAA	ønlemɑɑ	ønlemee
ʃikɑjetlArHn	ʃikɑjetlɑrɯn	ʃikɑjetlerin
ɑdnHz	ɑdniz	ɑdnɯz
ɑlAbilmAH	ɑlɑbilmɑɯ	ɑlɑbilmei
ʤihɑzHHn	ʤihɑziin	ʤihɑzɯɯn
denejimA	denejimɑ	denejime
editørH	editøri	editøry
fɑrkHn	fɑrkin	fɑrkɯn
gynHHn	gyniin	gynyyn
kømyrH	kømyri	kømyry
kyltyrlAr	kyltyrlɑr	kyltyrler
kɑtɯlDHklArH	kɑtɯldiklɑrɯ	kɑtɯldɯklɑrɯ
metinDA	metindɑ	metinde
sɑjgɯlArmH	sɑjgɯlɑrmi	sɑjgɯlɑrmɯ
sorulArnHzH	sorulɑrnizi	sorulɑrnɯzɯ
telefonnHzA	telefonnɯzɑ	telefonnuzɑ
turistlArHn	turistlɑrɯn	turistlerin
jyklArH	jyklɑrɯ	jykleri
zɑmɑnkinDAn	zɑmɑnkindɑn	zɑmɑnkinden
ɑdnHzH	ɑdnizi	ɑdnɯzɯ
ɑvA	ɑve	ɑvɑ
byltenlArH	byltenlɑrɯ	byltenleri
bɑnkɑlArDAn	bɑnkɑlɑrden	bɑnkɑlɑrdɑn
belgelArDA	belgelerdɑ	belgelerde
bozmA	bozme	bozmɑ
gyʧsHz	gyʧsiz	gyʧsyz
gylAn	gylɑn	gylen
gerʧeklAʃmA	gerʧeklɑʃmɑ	gerʧekleʃme
itirɑzlArH	itirɑzleri	itirɑzlɑrɯ
kullAnHʤHlH	kullɑnɯʤili	kullɑnɯʤɯlɯ
metɑllArHn	metɑllɑrɯn	metɑllerin
oluʃmADA	oluʃmɑde	oluʃmɑtɑ
olHnʤAA	olinʤɑɑ	olunʤɑɑ
pyryzsHz	pyryzsiz	pyryzsyz
proteinlAr	proteinlɑr	proteinler
tyketimA	tyketimɑ	tyketime
terørH	terøri	terøry
tozlH	tozli	tozlu
jɑrɯʃlArH	jɑrɯʃleri	jɑrɯʃlɑrɯ
jɑzɯlɯmlArHHn	jɑzɯlɯmleriin	jɑzɯlɯmlɑrɯɯn
ʧɯkHʃlH	ʧɯkiʃlɯ	ʧɯkɯʃlɯ
ʧɑlɯʃɑnlArmHzHn	ʧɑlɯʃɑnlɑrmizin	ʧɑlɯʃɑnlɑrmɯzɯn
ʧɑlɯʃmAlArmHzDA	ʧɑlɯʃmɑlɑrmizde	ʧɑlɯʃmɑlɑrmɯzdɑ
ødemADA	ødemete	ødemede
ʃehirDAki	ʃehirtɑki	ʃehirdeki
ɑletlArHn	ɑletlɑrɯn	ɑletlerin
ɑnlɑmlAr	ɑnlɑmler	ɑnlɑmlɑr
bɑʃmHzA	bɑʃmizɑ	bɑʃmɯzɑ
bilHʃsAl	biliʃsɑl	biliʃsel
bitAʤAk	biteʤɑk	biteʤek
buzlH	buzli	buzlu
dønHʃDA	døniʃdɑ	dønyʃte
dyzeltmAlAr	dyzeltmɑlɑr	dyzeltmeler
desteklArH	desteklɑrɯ	destekleri
dillArHn	dillɑrɯn	dillerin
etkenlArDAn	etkenlɑrden	etkenlerden
frekɑnslH	frekɑnsli	frekɑnslɯ
gøndermAnHz	gøndermɑniz	gøndermeniz
iʧeʤeklAr	iʧeʤeklɑr	iʧeʤekler
kɑdroHn	kɑdroin	kɑdroun
kɑnserlArH	kɑnserlɑrɯ	kɑnserleri
kɑrʃɯmHzDA	kɑrʃɯmɯzde	kɑrʃɯmɯzdɑ
koʃulsHz	koʃulsiz	koʃulsuz
modellAnmAH	modellɑnmɑɯ	modellenmei
mutfɑkDA	mutfɑkte	mutfɑktɑ
plɑtformlArDA	plɑtformlerdɑ	plɑtformlɑrdɑ
profillArH	profillɑrɯ	profilleri
sɑɰlɑDHklArH	sɑɰlɑtiklɑrɯ	sɑɰlɑdɯklɑrɯ
tyketAn	tyketɑn	tyketen
tenʤereA	tenʤereɑ	tenʤeree
tijɑtroHn	tijɑtroin	tijɑtroun
ʧɑlɯʃDHkDAn	ʧɑlɯʃdiktɑn	ʧɑlɯʃtɯktɑn
ørneklArDAn	ørneklɑrden	ørneklerden
ʃehirlArɑrɑsɯ	ʃehirlɑrɑrɑsɯ	ʃehirlerɑrɑsɯ
ɑdnHzA	ɑdnizɑ	ɑdnɯzɑ
ɑrɑʤɯnHzHn	ɑrɑʤɯnizin	ɑrɑʤɯnɯzɯn
byjyklHklArH	byjykliklɑrɯ	byjyklykleri
byjyklHkDAki	byjyklikteki	byjyklykteki
beʃDA	beʃdɑ	beʃte
borʧlArHHn	borʧleriin	borʧlɑrɯɯn
borʧlHHn	borʧliin	borʧluun
enflɑsjonA	enflɑsjone	enflɑsjonɑ
gørDHkDAn	gørdiktɑn	gørdykten
girmADA	girmɑde	girmete
hɑberleʃmAH	hɑberleʃmɑɯ	hɑberleʃmei
kɯʃlArH	kɯʃleri	kɯʃlɑrɯ
kyʧylmA	kyʧylmɑ	kyʧylme
kɑnɑllArHHn	kɑnɑlleriin	kɑnɑllɑrɯɯn
kemiklArH	kemiklɑrɯ	kemikleri
kimliklArH	kimliklɑrɯ	kimlikleri
kirlAnmAH	kirlɑnmɑɯ	kirlenmei
kooperɑtiflArH	kooperɑtiflɑrɯ	kooperɑtifleri
kuʃlArHn	kuʃlerin	kuʃlɑrɯn
lifA	lifɑ	life
mɑhɑlleDA	mɑhɑllete	mɑhɑllede
mɑmullArH	mɑmullɑrɯ	mɑmulleri
nedenDAn	nedendɑn	nedenden
pɑrʧɑlArHHn	pɑrʧɑleriin	pɑrʧɑlɑrɯɯn
prosedyrH	prosedyri	prosedyry
sɑjfɑDAki	sɑjfɑtɑki	sɑjfɑdɑki
sinjɑllAr	sinjɑllɑr	sinjɑller
tedɑrikʧH	tedɑrikʧu	tedɑrikʧi
unsurlArDAn	unsurlɑrden	unsurlɑrdɑn
vermAmAH	vermɑmɑɯ	vermemei
jykymlHlHklAr	jykymliliklɑr	jykymlylykler
ʧɑlɯʃmAmHz	ʧɑlɯʃmemiz	ʧɑlɯʃmɑmɯz
ʧoɰunlukDA	ʧoɰunlukte	ʧoɰunluktɑ
ynH	yni	yny
ɑlɑʤɑklH	ɑlɑʤɑkli	ɑlɑʤɑklɯ
ɑvukɑtA	ɑvukɑte	ɑvukɑtɑ
ɑjɑrlH	ɑjɑrli	ɑjɑrlɯ
bitmAH	bitmɑɯ	bitmei
ʤihɑzlArA	ʤihɑzlere	ʤihɑzlɑrɑ
dɑkikɑDAn	dɑkikɑden	dɑkikɑdɑn
delillAr	delillɑr	deliller
dolɑrDAn	dolɑrden	dolɑrdɑn
fonA	fone	fonɑ
gøʧH	gøʧi	gøʧy
gørevlArDA	gørevlerdɑ	gørevlerde
gørmADAn	gørmɑden	gørmeten
gɑlɑtA	gɑlɑte	gɑlɑtɑ
gerʧeklArA	gerʧeklɑrɑ	gerʧeklere
hesɑplArHHn	hesɑpleriin	hesɑplɑrɯɯn
iplAr	iplɑr	ipler
kɑlɯnlHk	kɑlɯnlik	kɑlɯnlɯk
kɑnɑlHn	kɑnɑlin	kɑnɑlɯn
kɑvrɑmlArHHn	kɑvrɑmleriin	kɑvrɑmlɑrɯɯn
kesitlAr	kesitlɑr	kesitler
kitɑplArDAn	kitɑplɑrden	kitɑplɑrdɑn
miktɑrDAki	miktɑrtɑki	miktɑrdɑki
odɑmHzA	odɑmyze	odɑmɯzɑ
pɑrlɑklHk	pɑrlɑklik	pɑrlɑklɯk
telefonnHzH	telefonnizi	telefonnuzu
teminɑtA	teminɑte	teminɑtɑ
teminɑtlArH	teminɑtleri	teminɑtlɑrɯ
usullArA	usullɑrɑ	usullere
jɑʃɑmDAn	jɑʃɑmden	jɑʃɑmdɑn
zehirlAnmA	zehirlɑnmɑ	zehirlenme
ʧɑlɯʃmADAn	ʧɑlɯʃmɑden	ʧɑlɯʃmɑtɑn
ʃɑnlH	ʃɑnli	ʃɑnlɯ
ɑrɑʧlArDAn	ɑrɑʧlɑrden	ɑrɑʧlɑrdɑn
ɑrkɑdɑʃlArmHzA	ɑrkɑdɑʃlermizɑ	ɑrkɑdɑʃlɑrmɯzɑ
bɑɰlɑntɯHHn	bɑɰlɑntɯiin	bɑɰlɑntɯɯɯn
bɑrɑʒHn	bɑrɑʒin	bɑrɑʒɯn
beledijemHzA	beledijemizɑ	beledijemize
birimDA	birimdɑ	birimde
eserlArDAn	eserlɑrden	eserlerden
gøkjyzynDA	gøkjyzyndɑ	gøkjyzynde
giderlArHn	giderlɑrɯn	giderlerin
køpeklAr	køpeklɑr	køpekler
køjHHn	køjiin	køjyyn
kɑdemeDA	kɑdemete	kɑdemede
kemiklArHn	kemiklɑrɯn	kemiklerin
kooperɑtiflAr	kooperɑtiflɑr	kooperɑtifler
mydyrlAr	mydyrlɑr	mydyrler
memurHHn	memuriin	memuruun
nedenlArHn	nedenlɑrɯn	nedenlerin
progrɑmlH	progrɑmli	progrɑmlɯ
rɑdjoH	rɑdjoi	rɑdjou
reklɑmlAr	reklɑmler	reklɑmlɑr
riskA	riskɑ	riske
tørenlArH	tørenlɑrɯ	tørenleri
tytynDA	tytyndɑ	tytynde
tɑʃlArHn	tɑʃlerin	tɑʃlɑrɯn
teminɑtHn	teminɑtin	teminɑtɯn
terminɑllArH	terminɑllɑrɯ	terminɑlleri
uɰurlH	uɰurli	uɰurlu
jɑnmHzDA	jɑnmyzde	jɑnmɯzdɑ
zɑrɑrsHz	zɑrɑrsiz	zɑrɑrsɯz
zorlAHʤH	zorleiʤi	zorlɑɯʤɯ
ʧɑbɑlArHHn	ʧɑbɑleriin	ʧɑbɑlɑrɯɯn
ʧɑlɯʃmɑlArnHzDA	ʧɑlɯʃmɑlɑrnizde	ʧɑlɯʃmɑlɑrnɯzdɑ
ʧokʧA	ʧokʧe	ʧokʧɑ
ødeAn	ødeɑn	ødeen
ølmA	ølmɑ	ølme
ɑɰlArHHn	ɑɰleriin	ɑɰlɑrɯɯn
ɑdɑDAki	ɑdɑtɑki	ɑdɑdɑki
bɑnkɑDA	bɑnkɑde	bɑnkɑdɑ
birliklArHn	birliklɑrɯn	birliklerin
dyʃAnH	dyʃɑnɯ	dyʃeni
deɰerDA	deɰerdɑ	deɰerde
gyvenDA	gyvendɑ	gyvende
gɑzlArH	gɑzleri	gɑzlɑrɯ
geʧHʃDA	geʧiʃdɑ	geʧiʃte
geʧmADA	geʧmɑde	geʧmete
insɑnlArmHzHn	insɑnlɑrmizin	insɑnlɑrmɯzɯn
istɑsjonlArHHn	istɑsjonleriin	istɑsjonlɑrɯɯn
kɑrDAn	kɑrden	kɑrdɑn
kontrolHHn	kontroliin	kontrolyyn
ortɑklArHHn	ortɑkleriin	ortɑklɑrɯɯn
portføjH	portføji	portføjy
tɑbloDAki	tɑblotɑki	tɑblodɑki
teʃkilɑtHn	teʃkilɑtin	teʃkilɑtɯn
vɑtɑndɑʃlArHHn	vɑtɑndɑʃleriin	vɑtɑndɑʃlɑrɯɯn
ʃehirlArH	ʃehirlɑrɯ	ʃehirleri
yrynlArmHzH	yrynlɑrmizi	yrynlermizi
ɑrkɑdɑʃlHk	ɑrkɑdɑʃlik	ɑrkɑdɑʃlɯk
bølymDAki	bølymtɑki	bølymdeki
ʤumhurijetnHn	ʤumhurijetnɯn	ʤumhurijetnin
dyzenDA	dyzendɑ	dyzende
dikkɑtmH	dikkɑtmɯ	dikkɑtmi
etlAr	etlɑr	etler
fɑɑlijetDAn	fɑɑlijettɑn	fɑɑlijetten
fotoɰrɑflArHHn	fotoɰrɑfleriin	fotoɰrɑflɑrɯɯn
gøtyrHp	gøtyrup	gøtyryp
geʧirmAH	geʧirmɑɯ	geʧirmei
getirAbilmA	getirɑbilmɑ	getirebilme
kɑsɯtlH	kɑsɯtli	kɑsɯtlɯ
kɑzɑnDHklArH	kɑzɑndiklɑrɯ	kɑzɑndɯklɑrɯ
kɑzmA	kɑzme	kɑzmɑ
kitɑplHk	kitɑplik	kitɑplɯk
kodHHn	kodiin	koduun
nesillArA	nesillɑrɑ	nesillere
performɑnsHHn	performɑnsiin	performɑnsɯɯn
tymørHn	tymørɯn	tymøryn
tɑrzHHn	tɑrziin	tɑrzɯɯn
telefonlArHHn	telefonleriin	telefonlɑrɯɯn
toplɑntɯlArHHn	toplɑntɯleriin	toplɑntɯlɑrɯɯn
uʧlH	uʧlɯ	uʧlu
ulɑʃmADA	ulɑʃmɑde	ulɑʃmɑdɑ
uzɑklɯkDAki	uzɑklɯkteki	uzɑklɯktɑki
jɑtɑkDA	jɑtɑkte	jɑtɑktɑ
zɑrɑrlArDAn	zɑrɑrlɑrden	zɑrɑrlɑrdɑn
ʧevirArAk	ʧevirɑrɑk	ʧevirerek
ønʤeliklArH	ønʤeliklɑrɯ	ønʤelikleri
ɑrzH	ɑrzi	ɑrzɯ
biʧimsAl	biʧimsɑl	biʧimsel
bildirmA	bildirmɑ	bildirme
dønemsAl	dønemsɑl	dønemsel
deɰerlendirmAHn	deɰerlendirmɑɯn	deɰerlendirmein
deɰiʃkenlArHn	deɰiʃkenlɑrɯn	deɰiʃkenlerin
deɰinAn	deɰinɑn	deɰinen
dolmɑDAn	dolmɑden	dolmɑdɑn
ellArA	ellɑrɑ	ellere
engellArHn	engellɑrɯn	engellerin
etkenlArHn	etkenlɑrɯn	etkenlerin
etmADA	etmɑde	etmede
etmAHHn	etmɑɯɯn	etmeiin
geniʃlAmAH	geniʃlɑmɑɯ	geniʃlemei
ithɑlH	ithɑlɯ	ithɑli
kɑjmɑkɑmlHk	kɑjmɑkɑmlik	kɑjmɑkɑmlɯk
koordinɑtlArH	koordinɑtleri	koordinɑtlɑrɯ
kulyplAr	kulyplɑr	kulypler
kuruluʃDAn	kuruluʃden	kuruluʃtɑn
kurummHz	kurummiz	kurummuz
liflArHn	liflɑrɯn	liflerin
odɑmHzHn	odɑmizin	odɑmɯzɯn
olumsuzlHklArA	olumsuzliklɑrɑ	olumsuzluklɑrɑ
pɑrkHn	pɑrkin	pɑrkɯn
sɯnɑvlArHHn	sɯnɑvleriin	sɯnɑvlɑrɯɯn
søzʤyklArHn	søzʤyklɑrɯn	søzʤyklerin
silɑhsHzlAnmA	silɑhsizlɑnmɑ	silɑhsɯzlɑnmɑ
sonuʧsHz	sonuʧsiz	sonuʧsuz
suʧlArDAn	suʧlɑrden	suʧlɑrdɑn
teknoloʒiDA	teknoloʒite	teknoloʒide
telefonnHz	telefonniz	telefonnuz
unsurlArHHn	unsurleriin	unsurlɑrɯɯn
jɑnɯtlArH	jɑnɯtleri	jɑnɯtlɑrɯ
jerleʃmAH	jerleʃmɑɯ	jerleʃmei
ʧøkmAH	ʧøkmɑɯ	ʧøkmei
øɰrenimA	øɰrenimɑ	øɰrenime
ødemAAn	ødemɑɑn	ødemeen
ørneklArDA	ørneklɑrdɑ	ørneklerde
ʃirketlArDAn	ʃirketlɑrden	ʃirketlerden
ɑlmAmHz	ɑlmɑmiz	ɑlmɑmɯz
ɑjɑklH	ɑjɑkli	ɑjɑklɯ
bɑsɑmɑklH	bɑsɑmɑkli	bɑsɑmɑklɯ
benzerlHklAr	benzerliklɑr	benzerlikler
ʤoɰrɑfjɑDA	ʤoɰrɑfjɑte	ʤoɰrɑfjɑdɑ
døvizA	døvizɑ	døvize
dyʃArAk	dyʃɑrɑk	dyʃerek
dynH	dyni	dyny
filmA	filmɑ	filme
gørynmAAn	gørynmɑɑn	gørynmeen
gøsterimA	gøsterimɑ	gøsterime
getirmADA	getirmɑde	getirmete
gitDHklArH	gittiklɑrɯ	gittikleri
ihrɑʤɑtHHn	ihrɑʤɑtiin	ihrɑʤɑtɯɯn
kɯzɑrɯklHk	kɯzɑrɯklik	kɯzɑrɯklɯk
mɑliklArH	mɑliklɑrɯ	mɑlikleri
mevzuɑtHHn	mevzuɑtiin	mevzuɑtɯɯn
temizlAmA	temizlɑmɑ	temizleme
vɑrlɯklArHHn	vɑrlɯkleriin	vɑrlɯklɑrɯɯn
jerjyzynDAki	jerjyzyndɑki	jerjyzyndeki
ʧɑlɯʃmAlArmHzA	ʧɑlɯʃmɑlɑrmizɑ	ʧɑlɯʃmɑlɑrmɯzɑ
ʧekmAH	ʧekmɑɯ	ʧekmei
ʧizgiDA	ʧizgite	ʧizgide
ʧoʤuklArmHzH	ʧoʤuklɑrmizi	ʧoʤuklɑrmɯzɯ
ɑlbymHn	ɑlbymin	ɑlbymyn
ɑnlɑtArAk	ɑnlɑterek	ɑnlɑtɑrɑk
ɑrɑʧDA	ɑrɑʧdɑ	ɑrɑʧtɑ
ɑteʃDAn	ɑteʃden	ɑteʃten
gøʧHn	gøʧin	gøʧyn
gereʧlAr	gereʧlɑr	gereʧler
ihɑlelArDA	ihɑlelerdɑ	ihɑlelerde
kɯsɯmDAn	kɯsɯmden	kɯsɯmdɑn
kɑlmADA	kɑlmɑde	kɑlmɑtɑ
kɑnsHzlHk	kɑnsizlik	kɑnsɯzlɯk
kɑtlArH	kɑtleri	kɑtlɑrɯ
kullɑnɯmlH	kullɑnɯmli	kullɑnɯmlɯ
kurɑklHk	kurɑklik	kurɑklɯk
kutuplH	kutupli	kutuplu
myrɑʤɑɑtlArH	myrɑʤɑɑtleri	myrɑʤɑɑtlɑrɯ
oluʃumlAr	oluʃumler	oluʃumlɑr
onurH	onuri	onuru
ojlAr	ojler	ojlɑr
performɑnsHn	performɑnsin	performɑnsɯn
tyrlArDA	tyrlɑrdɑ	tyrlerde
tedbirlArA	tedbirlɑrɑ	tedbirlere
toplumlArH	toplumleri	toplumlɑrɯ
ujkusHzlHk	ujkusizlik	ujkusuzluk
vɑrmADAn	vɑrmɑden	vɑrmɑdɑn
jønetmeliklArHn	jønetmeliklɑrɯn	jønetmeliklerin
jɑʃlHlArHn	jɑʃlilerin	jɑʃlɯlɑrɯn
jɑpɯtlArH	jɑpɯtleri	jɑpɯtlɑrɯ
jineDA	jinete	jinede
ʧekilmAA	ʧekilmɑɑ	ʧekilmee
ølmAH	ølmɑɯ	ølmei
ɑdɑmHHn	ɑdɑmiin	ɑdɑmɯɯn
ɑrkɑdɑʃlArmHn	ɑrkɑdɑʃlermin	ɑrkɑdɑʃlɑrmɯn
bɑʃkɑnlHklArH	bɑʃkɑnliklɑrɯ	bɑʃkɑnlɯklɑrɯ
bejA	bejɑ	beje
bitmADAn	bitmɑden	bitmeden
dɑvrɑnHʃHn	dɑvrɑniʃin	dɑvrɑnɯʃɯn
deɰiʃmAA	deɰiʃmɑɑ	deɰiʃmee
dinmHz	dinmyz	dinmiz
doɰɑDAki	doɰɑtɑki	doɰɑdɑki
durHʃ	duriʃ	duruʃ
fɑzlH	fɑzli	fɑzlɯ
firmɑmHzHn	firmɑmizin	firmɑmɯzɯn
formlArHn	formlerin	formlɑrɯn
gerʧeklArHn	gerʧeklɑrɯn	gerʧeklerin
gruplArDAn	gruplɑrden	gruplɑrdɑn
hoʤɑmHz	hoʤɑmiz	hoʤɑmɯz
iʧmAA	iʧmɑɑ	iʧmee
kɑjɑlHk	kɑjɑlik	kɑjɑlɯk
komʃulHk	komʃulik	komʃuluk
mɑterjɑllArHn	mɑterjɑllɑrɯn	mɑterjɑllerin
nedenlArA	nedenlɑrɑ	nedenlere
syrmA	syrmɑ	syrme
sɑtHʃlArDA	sɑtiʃlerdɑ	sɑtɯʃlɑrdɑ
sokɑkDAki	sokɑkteki	sokɑktɑki
sunmADA	sunmɑde	sunmɑtɑ
tutumlArH	tutumleri	tutumlɑrɯ
jɑʃɑmnHzDA	jɑʃɑmnizde	jɑʃɑmnɯzdɑ
jolDAki	joldeki	joldɑki
ʧɑmurHn	ʧɑmurɯn	ʧɑmurun
ʧoɰumHz	ʧoɰumiz	ʧoɰumuz
ɯlɯmlH	ɯlɯmli	ɯlɯmlɯ
ʃirketDAn	ʃirkettɑn	ʃirketten
yrynlArmHzHn	yrynlɑrmizin	yrynlermizin
ɑrkɑdɑʃlArA	ɑrkɑdɑʃlere	ɑrkɑdɑʃlɑrɑ
bytynsAl	bytynsɑl	bytynsel
bɑkɯmlH	bɑkɯmli	bɑkɯmlɯ
bitkilArDA	bitkilerdɑ	bitkilerde
døkymA	døkymɑ	døkyme
dyzlemDA	dyzlemdɑ	dyzlemde
eɰitmA	eɰitmɑ	eɰitme
esenlAr	esenlɑr	esenler
gɑjrimenkullArHn	gɑjrimenkullɑrɯn	gɑjrimenkullerin
hyʤreDA	hyʤrete	hyʤrede
kyltyrlH	kyltyrli	kyltyrly
kɑzɑlArHHn	kɑzɑleriin	kɑzɑlɑrɯɯn
konferɑnslArH	konferɑnsleri	konferɑnslɑrɯ
mɑkbuzHn	mɑkbuzin	mɑkbuzun
mesleklArH	mesleklɑrɯ	meslekleri
mirɑsH	mirɑsi	mirɑsɯ
okuDHkDAn	okutiktɑn	okuduktɑn
olumsuzlHklArH	olumsuzliklɑrɯ	olumsuzluklɑrɯ
sɑjfɑlArHHn	sɑjfɑleriin	sɑjfɑlɑrɯɯn
sosH	sosi	sosu
tɑʃɯDHklArH	tɑʃɯdiklɑrɯ	tɑʃɯdɯklɑrɯ
tɑkHp	tɑkip	tɑkɯp
tohumlHk	tohumlik	tohumluk
uzɑjDA	uzɑjde	uzɑjdɑ
vɑrlɯklH	vɑrlɯkli	vɑrlɯklɯ
jurttɑʃlAr	jurttɑʃler	jurttɑʃlɑr
ʧøkmA	ʧøkmɑ	ʧøkme
ʧekmAH	ʧekmɑɯ	ʧekmei
øɰretAn	øɰretɑn	øɰreten
ølʧylH	ølʧyli	ølʧyly
ʃuurH	ʃuuri	ʃuuru
yrynHHn	yryniin	yrynyyn
ɑlɯmlArH	ɑlɯmleri	ɑlɯmlɑrɯ
ɑlɑnlH	ɑlɑnli	ɑlɑnlɯ
ɑlbymDA	ɑlbymdɑ	ɑlbymde
ɑtlH	ɑtli	ɑtlɯ
bøʤeklArHn	bøʤeklɑrɯn	bøʤeklerin
byjyArAk	byjyɑrɑk	byjyerek
bɑʃvuruHHn	bɑʃvuruiin	bɑʃvuruuun
bilDHklArH	bildiklɑrɯ	bildikleri
bulAbilmA	bulɑbilmɑ	bulɑbilme
defterlAr	defterlɑr	defterler
dinlenmA	dinlenmɑ	dinlenme
edebijɑtA	edebijɑte	edebijɑtɑ
etlArHn	etlɑrɯn	etlerin
fɑktørlArA	fɑktørlɑrɑ	fɑktørlere
gøʧmenlArHn	gøʧmenlɑrɯn	gøʧmenlerin
gøsterHʃlH	gøsteriʃlɯ	gøsteriʃli
hɑjɑtmHzA	hɑjɑtmyze	hɑjɑtmɯzɑ
hususHn	hususin	hususun
huzursHz	huzursiz	huzursuz
kontrolsHz	kontrolsiz	kontrolsyz
mydɑhɑleDA	mydɑhɑlete	mydɑhɑlede
menfɑɑtH	menfɑɑtu	menfɑɑti
mevsimDA	mevsimdɑ	mevsimde
pɑrɑDAn	pɑrɑden	pɑrɑdɑn
sɯfɯrA	sɯfɯre	sɯfɯrɑ
sɑtɯʃlArHn	sɑtɯʃlerin	sɑtɯʃlɑrɯn
seʧDHklArH	seʧdiklɑrɯ	seʧtikleri
senetlArHn	senetlɑrɯn	senetlerin
solunumH	solunumɯ	solunumu
teʧhizɑtHn	teʧhizɑtin	teʧhizɑtɯn
tohumlAr	tohumler	tohumlɑr
unlH	unli	unlu
verAnlArHn	verenlɑrɯn	verenlerin
jønetmeliklArH	jønetmeliklɑrɯ	jønetmelikleri
jɑʃHHn	jɑʃiin	jɑʃɯɯn
jurttɑʃlArHn	jurttɑʃlerin	jurttɑʃlɑrɯn
zorlHklArA	zorliklɑrɑ	zorluklɑrɑ
ʧøkAn	ʧøkɑn	ʧøken
ʧɑɰlArDAn	ʧɑɰlɑrden	ʧɑɰlɑrdɑn
ølʧytlAr	ølʧytlɑr	ølʧytler
belkiDA	belkite	belkide
bildirmAH	bildirmɑɯ	bildirmei
bilgisɑjɑrlArDAn	bilgisɑjɑrlɑrden	bilgisɑjɑrlɑrdɑn
ʤezɑlArHHn	ʤezɑleriin	ʤezɑlɑrɯɯn
dɯʃɑrɯDAki	dɯʃɑrɯtɑki	dɯʃɑrɯdɑki
dereʤelArDA	dereʤelerdɑ	dereʤelerde
devɑmsHzlHk	devɑmsizlik	devɑmsɯzlɯk
dezɑvɑntɑʒlArH	dezɑvɑntɑʒleri	dezɑvɑntɑʒlɑrɯ
elementlArHn	elementlɑrɯn	elementlerin
enstityDA	enstitydɑ	enstityde
erkeklArDAn	erkeklɑrden	erkeklerden
evnHzA	evnizɑ	evnize
filmlArDA	filmlerdɑ	filmlerde
gørmAlArH	gørmɑlɑrɯ	gørmeleri
geʧirDHklArH	geʧirdiklɑrɯ	geʧirdikleri
gelAnlArA	gelɑnlɑrɑ	gelenlere
getirmAlArH	getirmɑlɑrɯ	getirmeleri
girmAlArH	girmɑlɑrɯ	girmeleri
hɑjɑtnHzH	hɑjɑtnizi	hɑjɑtnɯzɯ
hesɑpDA	hesɑpte	hesɑptɑ
iʃlemDA	iʃlemdɑ	iʃlemde
kɑmpɑnjɑDA	kɑmpɑnjɑte	kɑmpɑnjɑdɑ
kɑnɯtlAmHʃ	kɑnɯtlemiʃ	kɑnɯtlɑmɯʃ
kutuHHn	kutuiin	kutuuun
myteɑhhitlAr	myteɑhhitlɑr	myteɑhhitler
mɑlijetlArHn	mɑlijetlɑrɯn	mɑlijetlerin
nesillAr	nesillɑr	nesiller
okullArDAn	okullɑrden	okullɑrdɑn
sɯrɑDAki	sɯrɑtɑki	sɯrɑdɑki
syrmA	syrmɑ	syrme
sɑvɑʃlArDA	sɑvɑʃlerdɑ	sɑvɑʃlɑrdɑ
tɑksitlAr	tɑksitlɑr	tɑksitler
turistlAr	turistlɑr	turistler
uluslArHn	uluslerin	uluslɑrɯn
vɑkɑlArHHn	vɑkɑleriin	vɑkɑlɑrɯɯn
vɑtɑndɑʃlArmHzA	vɑtɑndɑʃlermizɑ	vɑtɑndɑʃlɑrmɯzɑ
jykselmAA	jykselmɑɑ	jykselmee
jɑʃlHlArDA	jɑʃlilerdɑ	jɑʃlɯlɑrdɑ
zijɑretlAr	zijɑretlɑr	zijɑretler
ʧelikDAn	ʧeliktɑn	ʧelikten
ʧizAn	ʧizɑn	ʧizen
ɑdresDAn	ɑdrestɑn	ɑdresten
bɯrɑkmADAn	bɯrɑkmɑden	bɯrɑkmɑdɑn
bɑkɯmlArH	bɑkɯmleri	bɑkɯmlɑrɯ
bilmAnHz	bilmɑniz	bilmeniz
dønyʃymlH	dønyʃymli	dønyʃymly
dɑɰlArHHn	dɑɰleriin	dɑɰlɑrɯɯn
direnmA	direnmɑ	direnme
doɰumH	doɰumɯ	doɰumu
geʧmAH	geʧmɑɯ	geʧmei
hɑmurH	hɑmuri	hɑmuru
hɑtlArn	hɑtlern	hɑtlɑrn
hissetmA	hissetmɑ	hissetme
kɯsɯtlAHʤH	kɯsɯtleiʤi	kɯsɯtlɑɯʤɯ
kømyrHn	kømyrɯn	kømyryn
kɑlHnʤA	kɑlinʤe	kɑlɯnʤɑ
kɑrɑDA	kɑrɑde	kɑrɑdɑ
kurɑmlArH	kurɑmleri	kurɑmlɑrɯ
mɑltA	mɑlte	mɑltɑ
mutlulHklAr	mutluliklɑr	mutluluklɑr
olmAnHzH	olmɑnizi	olmɑnɯzɯ
pilotH	piloti	pilotu
sytHHn	sytiin	sytyyn
sektørDAn	sektørtɑn	sektørden
stɑtyDA	stɑtydɑ	stɑtyde
suDAki	sutɑki	sudɑki
tɑzminɑtHn	tɑzminɑtin	tɑzminɑtɯn
jyryHʃA	jyryiʃe	jyryyʃe
jijeʤeklArHn	jijeʤeklɑrɯn	jijeʤeklerin
yzermA	yzermɑ	yzerme
ɑrɑʃtɯrAn	ɑrɑʃtɯren	ɑrɑʃtɯrɑn
ɑrɑmHzA	ɑrɑmyze	ɑrɑmɯzɑ
ɑsistɑnlHk	ɑsistɑnlik	ɑsistɑnlɯk
ɑsitlAr	ɑsitlɑr	ɑsitler
byjylH	byjyli	byjyly
bɑʃvurDHklArH	bɑʃvurdiklɑrɯ	bɑʃvurduklɑrɯ
bɑʃvurmAnHz	bɑʃvurmɑniz	bɑʃvurmɑnɯz
dønymlHk	dønymlik	dønymlyk
dynjɑmHzDA	dynjɑmɯzde	dynjɑmɯzdɑ
etkilAnmA	etkilenmɑ	etkilenme
etrɑfDA	etrɑfte	etrɑftɑ
fonksijonHHn	fonksijoniin	fonksijonuun
gøryntylAnmAH	gøryntylɑnmɑɯ	gøryntylenmei
gyndemDAki	gyndemdɑki	gyndemdeki
gɑzlH	gɑzli	gɑzlɯ
geleneklArH	geleneklɑrɯ	gelenekleri
gitmAAn	gitmɑɑn	gitmeen
iʧmA	iʧmɑ	iʧme
iʧsAl	iʧsɑl	iʧsel
kɯjmetlArHn	kɯjmetlɑrɯn	kɯjmetlerin
køjlyHn	køjlyin	køjlyyn
kɑbuklH	kɑbukli	kɑbuklu
kɑrɑDAn	kɑrɑden	kɑrɑdɑn
kɑrɑrDAn	kɑrɑrden	kɑrɑrdɑn
kɑsH	kɑsi	kɑsɯ
kɑtɯlɯmlH	kɑtɯlɯmli	kɑtɯlɯmlɯ
kɑzɑDA	kɑzɑde	kɑzɑdɑ
kolHHn	koliin	koluun
mɑhkemeDA	mɑhkemete	mɑhkemede
mɑllArHHn	mɑlleriin	mɑllɑrɯɯn
mɑnɑsH	mɑnɑsi	mɑnɑsɯ
olguHHn	olguiin	olguuun
ortɑDAki	ortɑtɑki	ortɑdɑki
pɑrʧɑDAn	pɑrʧɑden	pɑrʧɑdɑn
profesørH	profesøri	profesøry
sɑvɑʃlArHn	sɑvɑʃlerin	sɑvɑʃlɑrɯn
senelArDA	senelerdɑ	senelerde
suʧA	suʧe	suʧɑ
tɑvsijelArDA	tɑvsijelerdɑ	tɑvsijelerde
ujgulɑDHklArH	ujgulɑtiklɑrɯ	ujgulɑdɯklɑrɯ
vɑzgeʧmA	vɑzgeʧmɑ	vɑzgeʧme
jɑlnɯzlHk	jɑlnɯzlik	jɑlnɯzlɯk
jɑnlɯʃlAr	jɑnlɯʃler	jɑnlɯʃlɑr
jɑjlH	jɑjli	jɑjlɯ
jɑzDHklArH	jɑzdiklɑrɯ	jɑzdɯklɑrɯ
jerjyzyHn	jerjyzyin	jerjyzyyn
ʧɑɰmHzHn	ʧɑɰmizin	ʧɑɰmɯzɯn
ʧɑɰdɑʃlAʃmA	ʧɑɰdɑʃleʃmɑ	ʧɑɰdɑʃlɑʃmɑ
ørtAn	ørtɑn	ørten
ɑdɑjlHk	ɑdɑjlik	ɑdɑjlɯk
ɑkɑdemisjenlAr	ɑkɑdemisjenlɑr	ɑkɑdemisjenler
ɑkɑlHn	ɑkɑlin	ɑkɑlɯn
ɑlkolHn	ɑlkolin	ɑlkolyn
ɑtmosferDA	ɑtmosferdɑ	ɑtmosferde
bɑkɑnmHz	bɑkɑnmyz	bɑkɑnmɯz
bileʃiklArHn	bileʃiklɑrɯn	bileʃiklerin
ʤetvellArH	ʤetvellɑrɯ	ʤetvelleri
dyʃHp	dyʃup	dyʃyp
dynjɑmHzHn	dynjɑmizin	dynjɑmɯzɯn
demAH	demɑɯ	demei
doɰurgɑnlHk	doɰurgɑnlik	doɰurgɑnlɯk
duvɑrDAn	duvɑrden	duvɑrdɑn
elementlAr	elementlɑr	elementler
gøʧlAr	gøʧlɑr	gøʧler
geʧAnlArA	geʧɑnlɑrɑ	geʧenlere
hɑrʧlArH	hɑrʧleri	hɑrʧlɑrɯ
imɑlɑtʧH	imɑlɑtʧi	imɑlɑtʧɯ
inʤelemAH	inʤelemɑɯ	inʤelemei
irtifɑkH	irtifɑki	irtifɑkɯ
itirɑzDA	itirɑzde	itirɑzdɑ
kɯsɯmlArHHn	kɯsɯmleriin	kɯsɯmlɑrɯɯn
kɑʧnʤH	kɑʧnʤi	kɑʧnʤɯ
kɑjɯplArHHn	kɑjɯpleriin	kɑjɯplɑrɯɯn
konumlArH	konumleri	konumlɑrɯ
kullɑnɯmlAr	kullɑnɯmler	kullɑnɯmlɑr
kumɑʃlAr	kumɑʃler	kumɑʃlɑr
logoH	logoi	logou
numɑrɑlArHHn	numɑrɑleriin	numɑrɑlɑrɯɯn
orɑnlH	orɑnli	orɑnlɯ
pɑjlArHHn	pɑjleriin	pɑjlɑrɯɯn
performɑnslArH	performɑnsleri	performɑnslɑrɯ
søzleʃmelArDA	søzleʃmelerdɑ	søzleʃmelerde
semptomlArHn	semptomlerin	semptomlɑrɯn
servisDAn	servistɑn	servisten
sejretmA	sejretmɑ	sejretme
sigɑrɑDAn	sigɑrɑden	sigɑrɑdɑn
solDAki	soldeki	soldɑki
soluklH	solukli	soluklu
tɑʃɯmADA	tɑʃɯmɑde	tɑʃɯmɑtɑ
jɑʃɑHp	jɑʃɑup	jɑʃɑɯp
jemeklArHn	jemeklɑrɯn	jemeklerin
jorumlArH	jorumleri	jorumlɑrɯ
ʧɑlɯʃAlHm	ʧɑlɯʃɑlim	ʧɑlɯʃɑlɯm
ʧiʧeklArHn	ʧiʧeklɑrɯn	ʧiʧeklerin
ølAnlArHn	ølɑnlɑrɯn	ølenlerin
yniteDA	ynitete	ynitede
yniversiteDAki	yniversiteteki	yniversitedeki
ɑdɯmlArHn	ɑdɯmlerin	ɑdɯmlɑrɯn
ɑnlɑmADA	ɑnlɑmɑde	ɑnlɑmɑtɑ
ɑnlɑjɯʃlArH	ɑnlɑjɯʃleri	ɑnlɑjɯʃlɑrɯ
bɑslAArAk	bɑsleerek	bɑslɑɑrɑk
beledijelArDA	beledijelerdɑ	beledijelerde
blokDA	blokte	bloktɑ
boɰɑzDA	boɰɑzde	boɰɑzdɑ
bojutHHn	bojutiin	bojutuun
bulDHklArH	buldiklɑrɯ	bulduklɑrɯ
erkeklArH	erkeklɑrɯ	erkekleri
fonksijonlH	fonksijonli	fonksijonlu
gøʧmenlAr	gøʧmenlɑr	gøʧmenler
gønderDHklArH	gønderdiklɑrɯ	gønderdikleri
gøstermAlArH	gøstermɑlɑrɯ	gøstermeleri
gøzlArDA	gøzlɑrdɑ	gøzlerde
iʧermADA	iʧermɑde	iʧermete
iʃnHzA	iʃnizɑ	iʃnize
ileriDAki	ileriteki	ilerideki
kɑzɑDAn	kɑzɑden	kɑzɑdɑn
kesimlArDA	kesimlerdɑ	kesimlerde
kutuHn	kutuin	kutuun
mevduɑtH	mevduɑtu	mevduɑtɯ
milletmHzA	milletmyze	milletmize
minimHzA	minimizɑ	minimize
reformlArH	reformleri	reformlɑrɯ
sɑɰlAHʤHH	sɑɰlɑiʤii	sɑɰlɑɯʤɯɯ
typHn	typin	typyn
tɑmɑmlAHp	tɑmɑmleip	tɑmɑmlɑɯp
tɑrtɯʃmAsHz	tɑrtɯʃmɑsiz	tɑrtɯʃmɑsɯz
topʧHlAr	topʧiler	topʧulɑr
toplɑmlArH	toplɑmleri	toplɑmlɑrɯ
ulusHHn	ulusiin	ulusuun
jønHHn	jøniin	jønyyn
jɑɰmurlH	jɑɰmurli	jɑɰmurlu
jɑzmADAn	jɑzmeden	jɑzmɑdɑn
joɰunlHklH	joɰunlikli	joɰunluklu
ʧillAr	ʧillɑr	ʧiller
ʧizArAk	ʧizɑrɑk	ʧizerek
ʧoʤuklArnHzHn	ʧoʤuklernizin	ʧoʤuklɑrnɯzɯn
ʧoʤuklH	ʧoʤukli	ʧoʤuklu
øɰytmA	øɰytmɑ	øɰytme
øɰrenʤilArDA	øɰrenʤilerdɑ	øɰrenʤilerde
ɑnɑjɑsɑDA	ɑnɑjɑsɑde	ɑnɑjɑsɑdɑ
bɑjrɑmlAr	bɑjrɑmler	bɑjrɑmlɑr
bojutDAki	bojutteki	bojuttɑki
buhɑrlH	buhɑrli	buhɑrlɯ
dynjɑmHz	dynjɑmiz	dynjɑmɯz
dɑvrɑnHʃDA	dɑvrɑnɯʃdɑ	dɑvrɑnɯʃtɑ
deɰiʃmADAn	deɰiʃmɑden	deɰiʃmeden
dinlemAA	dinlemɑɑ	dinlemee
dujguHHn	dujguiin	dujguuun
gøryʃHHn	gøryʃiin	gøryʃyyn
gɑjrimenkulHn	gɑjrimenkulun	gɑjrimenkulyn
gidermAA	gidermɑɑ	gidermee
hɑjɑtDAki	hɑjɑtteki	hɑjɑttɑki
hɑjvɑnlArDAn	hɑjvɑnlɑrden	hɑjvɑnlɑrdɑn
insɑnlArmHz	insɑnlɑrmiz	insɑnlɑrmɯz
kyresAllAʃAn	kyresellɑʃɑn	kyreselleʃen
kɑrɑkolA	kɑrɑkole	kɑrɑkolɑ
kɑrɑkterlArHn	kɑrɑkterlɑrɯn	kɑrɑkterlerin
kɑtmɑnlH	kɑtmɑnli	kɑtmɑnlɯ
kɑjbetmA	kɑjbetmɑ	kɑjbetme
kɑjbetmA	kɑjbetmɑ	kɑjbetme
kollH	kolli	kollu
kopAn	kopen	kopɑn
kotH	koti	kotu
kurumDAki	kurumtɑki	kurumdɑki
liselArDA	liselerdɑ	liselerde
okuHʤHnHn	okuiʤinin	okuuʤunun
rɑhɑtsHzlHklAr	rɑhɑtsizliklɑr	rɑhɑtsɯzlɯklɑr
reformlArHn	reformlerin	reformlɑrɯn
tɑrlɑDA	tɑrlɑde	tɑrlɑdɑ
teknoloʒiDAki	teknoloʒiteki	teknoloʒideki
tellArH	tellɑrɯ	telleri
terøristlAr	terøristlɑr	terøristler
tesirlArH	tesirlɑrɯ	tesirleri
ujkusHz	ujkusiz	ujkusuz
ujumHn	ujumin	ujumun
jyzHHn	jyziin	jyzyyn
jɑʃɑmlArHHn	jɑʃɑmleriin	jɑʃɑmlɑrɯɯn
ʧeʃitlAr	ʧeʃitlɑr	ʧeʃitler
ʧeklArH	ʧeklɑrɯ	ʧekleri
ømyrlArH	ømyrlɑrɯ	ømyrleri
øzellHklArDA	øzelliklɑrdɑ	øzelliklerde
ʃɑirlAr	ʃɑirlɑr	ʃɑirler
yniversitemHzA	yniversitemizɑ	yniversitemize
ɑʧɯlɯʃDA	ɑʧɯlɯʃdɑ	ɑʧɯlɯʃtɑ
ɑnketlAr	ɑnketlɑr	ɑnketler
ɑrɑHʃlArH	ɑrɑiʃleri	ɑrɑɯʃlɑrɯ
ɑzotlH	ɑzotli	ɑzotlu
berɑbernDAki	berɑberndɑki	berɑberndeki
bitmA	bitmɑ	bitme
døkymDA	døkymdɑ	døkymde
dyʃynmAH	dyʃynmɑɯ	dyʃynmei
dɑvrɑnHʃlArA	dɑvrɑniʃlere	dɑvrɑnɯʃlɑrɑ
dekontH	dekonti	dekontu
delillArH	delillɑrɯ	delilleri
dinɑmiklArH	dinɑmiklɑrɯ	dinɑmikleri
dostlHklAr	dostliklɑr	dostluklɑr
eksiklArH	eksiklɑrɯ	eksikleri
fiillAr	fiillɑr	fiiller
hɑriʤinDAki	hɑriʤinteki	hɑriʤindeki
hɑvuzHn	hɑvuzin	hɑvuzun
hɑjɑtnHzDA	hɑjɑtnɯzde	hɑjɑtnɯzdɑ
hujlH	hujli	hujlu
kɑtkɯHHn	kɑtkɯiin	kɑtkɯɯɯn
kemiklAr	kemiklɑr	kemikler
klɑvjeDAn	klɑvjetɑn	klɑvjeden
limitlAr	limitlɑr	limitler
mɑhkemelArDA	mɑhkemelerdɑ	mɑhkemelerde
miktɑrlArHHn	miktɑrleriin	miktɑrlɑrɯɯn
minerɑlH	minerɑlɯ	minerɑli
minerɑllArHn	minerɑllɑrɯn	minerɑllerin
motiflAr	motiflɑr	motifler
politikɑmHz	politikɑmiz	politikɑmɯz
rehberlArH	rehberlɑrɯ	rehberleri
rizikoHn	rizikoin	rizikoun
sɑntrɑllAr	sɑntrɑllɑr	sɑntrɑller
sirkA	sirkɑ	sirke
suʧlHlHk	suʧlilik	suʧluluk
sunumlAr	sunumler	sunumlɑr
temsilʤilHklAr	temsilʤiliklɑr	temsilʤilikler
tohumH	tohumɯ	tohumu
ulɑʃAbilmAH	ulɑʃɑbilmɑɯ	ulɑʃɑbilmei
umutsHz	umutsiz	umutsuz
jenilHklArHn	jeniliklɑrɯn	jeniliklerin
jetiʃmA	jetiʃmɑ	jetiʃme
ɑɰɯrlɯkDA	ɑɰɯrlɯkte	ɑɰɯrlɯktɑ
ɑrkɑdɑʃHHn	ɑrkɑdɑʃiin	ɑrkɑdɑʃɯɯn
bɑʃlɑDHklArH	bɑʃlɑtiklɑrɯ	bɑʃlɑdɯklɑrɯ
bɑʃlArH	bɑʃleri	bɑʃlɑrɯ
bɑbɑDAn	bɑbɑden	bɑbɑdɑn
bɑhɑdɯrlH	bɑhɑdɯrli	bɑhɑdɯrlɯ
bozmADAn	bozmeden	bozmɑdɑn
bulDHkʧA	buldikʧe	buldukʧɑ
ʤɑmDAn	ʤɑmden	ʤɑmdɑn
deliklArH	deliklɑrɯ	delikleri
denetlAnAn	denetlɑnɑn	denetlenen
destekDAn	destektɑn	destekten
eɰilmA	eɰilmɑ	eɰilme
editørlAr	editørlɑr	editørler
fijɑtHn	fijɑtin	fijɑtɯn
fotoɰrɑflH	fotoɰrɑfli	fotoɰrɑflɯ
gøryʃDA	gøryʃdɑ	gøryʃte
gøstermAAn	gøstermɑɑn	gøstermeen
gyllAr	gyllɑr	gyller
geliʃmAHHn	geliʃmɑɯɯn	geliʃmeiin
hesɑplH	hesɑpli	hesɑplɯ
inʃɑɑtHn	inʃɑɑtin	inʃɑɑtɯn
kɑpɑtArAk	kɑpɑterek	kɑpɑtɑrɑk
kɑrɑrsHz	kɑrɑrsiz	kɑrɑrsɯz
konutlArH	konutleri	konutlɑrɯ
kullAnHʤHHHn	kullɑnɯʤiiin	kullɑnɯʤɯɯɯn
kullɑnɯmDAn	kullɑnɯmden	kullɑnɯmdɑn
meslektɑʃmHz	meslektɑʃmiz	meslektɑʃmɯz
okʧHlHk	okʧilik	okʧuluk
olɑnɑklArDAn	olɑnɑklɑrden	olɑnɑklɑrdɑn
oluʃumlArH	oluʃumleri	oluʃumlɑrɯ
progrɑmmHz	progrɑmmiz	progrɑmmɯz
proteinlArHn	proteinlɑrɯn	proteinlerin
ruhsɑtlArH	ruhsɑtleri	ruhsɑtlɑrɯ
sɑɰlɑmlHk	sɑɰlɑmlik	sɑɰlɑmlɯk
sɑhiplAr	sɑhiplɑr	sɑhipler
sɑjfɑmHzDAn	sɑjfɑmɯzden	sɑjfɑmɯzdɑn
sorulArDAn	sorulɑrden	sorulɑrdɑn
sunDHklArH	sundiklɑrɯ	sunduklɑrɯ
tymørlArDA	tymørlɑrdɑ	tymørlerde
tɑbiɑtHn	tɑbiɑtin	tɑbiɑtɯn
tertibɑtH	tertibɑtu	tertibɑtɯ
tutɑrlHlHk	tutɑrlilik	tutɑrlɯlɯk
jønlAr	jønlɑr	jønler
zijɑretDAn	zijɑrettɑn	zijɑretten
ɯʃɯnlArHHn	ɯʃɯnleriin	ɯʃɯnlɑrɯɯn
ɯrkʧH	ɯrkʧu	ɯrkʧɯ
ørneklArA	ørneklɑrɑ	ørneklere
ɑksɑklHklAr	ɑksɑkliklɑr	ɑksɑklɯklɑr
ɑtɯfDA	ɑtɯfdɑ	ɑtɯftɑ
bilɑnʧoH	bilɑnʧoi	bilɑnʧou
bilgilArDA	bilgilerdɑ	bilgilerde
bilimDA	bilimdɑ	bilimde
binɑlArDAn	binɑlɑrden	binɑlɑrdɑn
boʃlukDA	boʃlukte	boʃluktɑ
broʃyrlAr	broʃyrlɑr	broʃyrler
dileDHklArH	diletiklɑrɯ	diledikleri
dillArDAn	dillɑrden	dillerden
ekAn	ekɑn	eken
ekiplArHn	ekiplɑrɯn	ekiplerin
etmAmA	etmɑmɑ	etmeme
ejlemDA	ejlemdɑ	ejlemde
gøndermAlArH	gøndermɑlɑrɯ	gøndermeleri
gørmAnHzH	gørmɑnizi	gørmenizi
gydymlH	gydymli	gydymly
hɑreketlArDA	hɑreketlɑrdɑ	hɑreketlerde
herkesʧA	herkesʧɑ	herkesʧe
kɑdromHz	kɑdromiz	kɑdromuz
kɑsɑbɑDA	kɑsɑbɑde	kɑsɑbɑdɑ
keʃfetmA	keʃfetmɑ	keʃfetme
kolHn	kolin	kolun
lyzumH	lyzumɯ	lyzumu
mɑʧDA	mɑʧdɑ	mɑʧtɑ
mekɑnizmɑlArHHn	mekɑnizmɑleriin	mekɑnizmɑlɑrɯɯn
molekyllAr	molekyllɑr	molekyller
numɑrɑnHz	numɑrɑniz	numɑrɑnɯz
odunHn	odunin	odunun
operɑsjonA	operɑsjone	operɑsjonɑ
ortɑmlArHHn	ortɑmleriin	ortɑmlɑrɯɯn
ortɑmlArA	ortɑmlere	ortɑmlɑrɑ
ojlAmADA	ojlemete	ojlɑmɑdɑ
sɑtArAk	sɑterek	sɑtɑrɑk
sebeplArHn	sebeplɑrɯn	sebeplerin
siteDAki	siteteki	sitedeki
stresA	stresɑ	strese
terʤihlAr	terʤihlɑr	terʤihler
ujgunsHz	ujgunsiz	ujgunsuz
vizjonmHz	vizjonmyz	vizjonmuz
jønetmeliklArA	jønetmeliklɑrɑ	jønetmeliklere
jɑɰsHz	jɑɰsiz	jɑɰsɯz
jɑnlɯʃlArH	jɑnlɯʃleri	jɑnlɯʃlɑrɯ
jɑtɑklHk	jɑtɑklik	jɑtɑklɯk
jɑtɑklArHHn	jɑtɑkleriin	jɑtɑklɑrɯɯn
jurttɑʃlHk	jurttɑʃlik	jurttɑʃlɯk
zɑmɑnmHzDA	zɑmɑnmyzde	zɑmɑnmɯzdɑ
zɑrɑrDAn	zɑrɑrden	zɑrɑrdɑn
ʧɯkɑrlArHHn	ʧɯkɑrleriin	ʧɯkɑrlɑrɯɯn
ønmDA	ønmdɑ	ønmde
ʃɑnsnHz	ʃɑnsniz	ʃɑnsnɯz
ɑmelijɑtA	ɑmelijɑte	ɑmelijɑtɑ
ɑvukɑtlArA	ɑvukɑtlere	ɑvukɑtlɑrɑ
bɯrɑkAlHm	bɯrɑkɑlim	bɯrɑkɑlɯm
bɑkɯmsHz	bɑkɯmsiz	bɑkɯmsɯz
bɑtɯlHlAʃmA	bɑtɯlileʃmɑ	bɑtɯlɯlɑʃmɑ
ʤɑnlHlArH	ʤɑnlileri	ʤɑnlɯlɑrɯ
dyzenlAnHp	dyzenlɑnɯp	dyzenlenip
derneklArA	derneklɑrɑ	derneklere
direktiflArH	direktiflɑrɯ	direktifleri
dosjɑDAn	dosjɑtɑn	dosjɑdɑn
engellAmAA	engellɑmɑɑ	engellemee
fɑkyltelArDA	fɑkyltelerdɑ	fɑkyltelerde
fɑrkHHn	fɑrkiin	fɑrkɯɯn
gøkDAn	gøktɑn	gøkten
gømylH	gømyli	gømyly
gørynHʃDA	gøryniʃdɑ	gørynyʃte
gørAnlArHn	gørenlɑrɯn	gørenlerin
geʧirmAH	geʧirmɑɯ	geʧirmei
geʤikmAlH	geʤikmɑlɯ	geʤikmeli
geliʃimsAl	geliʃimsɑl	geliʃimsel
genʧlArDA	genʧlɑrdɑ	genʧlerde
gururH	gururi	gururu
hɑrflArHn	hɑrflɑrɯn	hɑrflerin
hɑstɑlɯkDA	hɑstɑlɯkte	hɑstɑlɯktɑ
hɑstɑlArmHzHn	hɑstɑlɑrmizin	hɑstɑlɑrmɯzɯn
hɑtɑlArDAn	hɑtɑlɑrden	hɑtɑlɑrdɑn
hɑjɑllAr	hɑjɑllɑr	hɑjɑller
hɑjɑtlArH	hɑjɑtleri	hɑjɑtlɑrɯ
hektɑrlHk	hektɑrlik	hektɑrlɯk
hoʃgørylH	hoʃgøryli	hoʃgøryly
hukukDA	hukukte	hukuktɑ
iʃleDHklArH	iʃletiklɑrɯ	iʃledikleri
kɯrAn	kɯren	kɯrɑn
køpryHn	køpryin	køpryyn
kɑlDHkDAn	kɑldiktɑn	kɑldɯktɑn
kɑlkHʃ	kɑlkiʃ	kɑlkɯʃ
kɑpɑklH	kɑpɑkli	kɑpɑklɯ
kɑpDA	kɑpte	kɑptɑ
kɑtHn	kɑtin	kɑtɯn
kɑjbetmAH	kɑjbetmɑɯ	kɑjbetmei
klɑsørH	klɑsøri	klɑsøry
kuʃlArH	kuʃleri	kuʃlɑrɯ
kulɑklHk	kulɑklik	kulɑklɯk
kurulmHzHn	kurulmizin	kurulmuzun
myʃterilArnHzA	myʃterilernizɑ	myʃterilernize
mɑtemɑtikʧH	mɑtemɑtikʧu	mɑtemɑtikʧi
modDA	modde	moddɑ
oturDHklArH	oturdiklɑrɯ	oturduklɑrɯ
pozisjonA	pozisjone	pozisjonɑ
prosedyrlArH	prosedyrlɑrɯ	prosedyrleri
risklArA	risklɑrɑ	risklere
ruhHHn	ruhiin	ruhuun
søjlemAH	søjlemɑɯ	søjlemei
sɑbɑhDAn	sɑbɑhden	sɑbɑhtɑn
seʧeneklArDAn	seʧeneklɑrden	seʧeneklerden
sinemɑDA	sinemɑde	sinemɑdɑ
sorulArHHn	soruleriin	sorulɑrɯɯn
tɑnɯmnA	tɑnɯmne	tɑnɯmnɑ
ustɑlHk	ustɑlik	ustɑlɯk
ujgulɑmADA	ujgulɑmɑde	ujgulɑmɑtɑ
jɑʃɑmlArH	jɑʃɑmleri	jɑʃɑmlɑrɯ
jɑrdɯmʤɯlArHHn	jɑrdɯmʤɯleriin	jɑrdɯmʤɯlɑrɯɯn
jɑrdɯmlArHn	jɑrdɯmlerin	jɑrdɯmlɑrɯn
jɑjɯnlArHHn	jɑjɯnleriin	jɑjɯnlɑrɯɯn
zenginlHklArH	zenginliklɑrɯ	zenginlikleri
ʧɑlɯʃAbilmAH	ʧɑlɯʃɑbilmɑɯ	ʧɑlɯʃɑbilmei
ʧiftlAr	ʧiftlɑr	ʧiftler
øɰrenDHklArH	øɰrendiklɑrɯ	øɰrendikleri
ʃɑnsmHz	ʃɑnsmiz	ʃɑnsmɯz
ɑnlɑHnʤA	ɑnlɑɯnʤe	ɑnlɑɯnʤɑ
ɑrkɑdɑʃlArmHzH	ɑrkɑdɑʃlermizi	ɑrkɑdɑʃlɑrmɯzɯ
bileʃenlAr	bileʃenlɑr	bileʃenler
bilimlArDA	bilimlerdɑ	bilimlerde
dyʃmAA	dyʃmɑɑ	dyʃmee
deɰerlArDAn	deɰerlɑrden	deɰerlerden
denemAA	denemɑɑ	denemee
devɑmlHlHk	devɑmlilik	devɑmlɯlɯk
dosjɑDAki	dosjɑtɑki	dosjɑdɑki
enstityHHn	enstityiin	enstityyyn
eserlArDA	eserlɑrdɑ	eserlerde
fijɑtlH	fijɑtli	fijɑtlɯ
formyllArH	formyllɑrɯ	formylleri
gøkjyzyHn	gøkjyzyin	gøkjyzyyn
gyʧlAnmAH	gyʧlɑnmɑɯ	gyʧlenmei
geʧirmADAn	geʧirmɑden	geʧirmeden
gijmA	gijmɑ	gijme
hɑʤimsAl	hɑʤimsɑl	hɑʤimsel
insɑnmHz	insɑnmyz	insɑnmɯz
kɯsɯmlArDA	kɯsɯmlerdɑ	kɯsɯmlɑrdɑ
kɑʧɑkʧHlHk	kɑʧɑkʧilik	kɑʧɑkʧɯlɯk
kɑbulA	kɑbulɑ	kɑbule
krɑllHk	krɑllik	krɑllɯk
kurtulHʃH	kurtuliʃi	kurtuluʃu
lɑstiklArH	lɑstiklɑrɯ	lɑstikleri
lisɑnsHn	lisɑnsin	lisɑnsɯn
mɑdenlArHn	mɑdenlɑrɯn	mɑdenlerin
mesɑʒnHzH	mesɑʒnizi	mesɑʒnɯzɯ
okullArmHzDA	okullɑrmizde	okullɑrmɯzdɑ
oluklH	olukli	oluklu
onɑjlAmA	onɑjleme	onɑjlɑmɑ
operɑtørHn	operɑtørɯn	operɑtøryn
otH	oti	otu
refɑhH	refɑhi	refɑhɯ
sytunHn	sytunin	sytunun
sɑvunmADA	sɑvunmɑde	sɑvunmɑdɑ
sektørlArDAn	sektørlɑrden	sektørlerden
soɰukDA	soɰukte	soɰuktɑ
uʧsHz	uʧsiz	uʧsuz
jɑɰmurH	jɑɰmuri	jɑɰmuru
jɑklɑʃɯmlArHn	jɑklɑʃɯmlerin	jɑklɑʃɯmlɑrɯn
jɑklɑʃDHkʧA	jɑklɑʃtikʧe	jɑklɑʃtɯkʧɑ
jɑrgɯsHz	jɑrgɯsiz	jɑrgɯsɯz
jɑzDHkDAn	jɑzdiktɑn	jɑzdɯktɑn
zɯrhlH	zɯrhli	zɯrhlɯ
zeminlArDA	zeminlɑrdɑ	zeminlerde
ʧɯkHʃDA	ʧɯkiʃdɑ	ʧɯkɯʃtɑ
ʧɑlɯʃɑnlArmHz	ʧɑlɯʃɑnlɑrmiz	ʧɑlɯʃɑnlɑrmɯz
ʧɑmurH	ʧɑmuri	ʧɑmuru
ʧekerlAr	ʧekerlɑr	ʧekerler
ødeDHklArH	ødetiklɑrɯ	ødedikleri
ønʤeliklAr	ønʤeliklɑr	ønʤelikler
ʃehirlArA	ʃehirlɑrɑ	ʃehirlere
yʧnʤHlHk	yʧnʤilik	yʧnʤylyk
yrynDAn	yryndɑn	yrynden
ɑʧmADAn	ɑʧmɑden	ɑʧmɑdɑn
ɑlmADA	ɑlmɑde	ɑlmɑdɑ
ɑmbɑlɑʒH	ɑmbɑlɑʒi	ɑmbɑlɑʒɯ
ɑmelijɑtlArH	ɑmelijɑtleri	ɑmelijɑtlɑrɯ
ɑtɑlHm	ɑtɑlim	ɑtɑlɯm
ɑvHn	ɑvin	ɑvɯn
ɑzɑlmADA	ɑzɑlmɑde	ɑzɑlmɑtɑ
bɑkHʃlArH	bɑkiʃleri	bɑkɯʃlɑrɯ
birleʃAn	birleʃɑn	birleʃen
blokH	bloki	bloku
bonoH	bonoi	bonou
deɰiʃiklHklArDAn	deɰiʃikliklɑrden	deɰiʃikliklerden
donɑnɯmlAr	donɑnɯmler	donɑnɯmlɑr
etiketlAr	etiketlɑr	etiketler
frekɑnslArDA	frekɑnslerdɑ	frekɑnslɑrdɑ
gørynymDA	gørynymdɑ	gørynymde
gørDHkʧA	gørdikʧe	gørdykʧe
gøzHHn	gøziin	gøzyyn
gelmAmAH	gelmɑmɑɯ	gelmemei
hykymlHHn	hykymliin	hykymlyyn
hɑtlArA	hɑtlere	hɑtlɑrɑ
hɑvuzlArH	hɑvuzleri	hɑvuzlɑrɯ
hɑjɑtmHn	hɑjɑtmin	hɑjɑtmɯn
hɑjrɑnlHk	hɑjrɑnlik	hɑjrɑnlɯk
istɑsjonHHn	istɑsjoniin	istɑsjonuun
køjlHlArH	køjlileri	køjlyleri
kyʧyklAr	kyʧyklɑr	kyʧykler
kɑbɯzlHk	kɑbɯzlik	kɑbɯzlɯk
kɑnɑlDA	kɑnɑlde	kɑnɑldɑ
kɑnɑlDAn	kɑnɑlden	kɑnɑldɑn
kɑslArHHn	kɑsleriin	kɑslɑrɯɯn
klɑsørHn	klɑsørɯn	klɑsøryn
konuʃmADAn	konuʃmɑden	konuʃmɑdɑn
meslektɑʃlArmHzA	meslektɑʃlermizɑ	meslektɑʃlɑrmɯzɑ
molekyllArH	molekyllɑrɯ	molekylleri
neDA	nete	nede
normlArH	normleri	normlɑrɯ
otomobillAr	otomobillɑr	otomobiller
prosedyrlAr	prosedyrlɑr	prosedyrler
sɯzmA	sɯzme	sɯzmɑ
suʧlArA	suʧlere	suʧlɑrɑ
sunumlArH	sunumleri	sunumlɑrɯ
typlAr	typlɑr	typler
tɑʃɯnmɑzlArHn	tɑʃɯnmɑzlerin	tɑʃɯnmɑzlɑrɯn
tɑbiɑtH	tɑbiɑtu	tɑbiɑtɯ
tɑbloHHn	tɑbloiin	tɑblouun
teʃekkyrlArmH	teʃekkyrlɑrmi	teʃekkyrlermi
tehditlAr	tehditlɑr	tehditler
vɑzgeʧmA	vɑzgeʧmɑ	vɑzgeʧme
jønlArDAn	jønlɑrden	jønlerden
jyryHʃlArH	jyryiʃleri	jyryyʃleri
jɑkɯnnA	jɑkɯnne	jɑkɯnnɑ
jɑrɑtDHklArH	jɑrɑttiklɑrɯ	jɑrɑttɯklɑrɯ
jɑtɯrɯmlArDA	jɑtɯrɯmlerdɑ	jɑtɯrɯmlɑrdɑ
jɑzɑrlArHHn	jɑzɑrleriin	jɑzɑrlɑrɯɯn
jenilHklArDAn	jeniliklɑrden	jeniliklerden
jetiʃkinlArHn	jetiʃkinlɑrɯn	jetiʃkinlerin
ʧeklArHn	ʧeklɑrɯn	ʧeklerin
ødylHn	ødylin	ødylyn
ødeneklArH	ødeneklɑrɯ	ødenekleri
øzetlAmA	øzetlɑmɑ	øzetleme
ʃykrɑnlArmH	ʃykrɑnlɑrmi	ʃykrɑnlɑrmɯ
ɑʧDHklArH	ɑʧdiklɑrɯ	ɑʧtɯklɑrɯ
ɑdɑptørH	ɑdɑptøri	ɑdɑptøry
ɑrɑlɯkDA	ɑrɑlɯkte	ɑrɑlɯktɑ
ɑsɯrlHk	ɑsɯrlik	ɑsɯrlɯk
bɑroHn	bɑroin	bɑroun
bitymlH	bitymli	bitymly
bojDAn	bojden	bojdɑn
dɯʃDA	dɯʃdɑ	dɯʃtɑ
dønerlAr	dønerlɑr	dønerler
dɑɰɯtHʤH	dɑɰɯtiʤi	dɑɰɯtɯʤɯ
dillArA	dillɑrɑ	dillere
dijɑgrɑmlArH	dijɑgrɑmleri	dijɑgrɑmlɑrɯ
durHʃH	duriʃi	duruʃu
duvɑrlArHHn	duvɑrleriin	duvɑrlɑrɯɯn
elimDAki	elimdɑki	elimdeki
elmH	elmɯ	elmi
enfeksijonA	enfeksijone	enfeksijonɑ
fɑɑlijetlArDAn	fɑɑlijetlɑrden	fɑɑlijetlerden
gylymseArAk	gylymseɑrɑk	gylymseerek
geʧmAlArH	geʧmɑlɑrɯ	geʧmeleri
geʤikmADAn	geʤikmɑden	geʤikmeden
hizmetnHzDA	hizmetnɯzde	hizmetnizde
illArDAki	illɑrtɑki	illerdeki
inmA	inmɑ	inme
kɯjɑfetlAr	kɯjɑfetlɑr	kɯjɑfetler
kømyrlArHn	kømyrlɑrɯn	kømyrlerin
kɑbloHn	kɑbloin	kɑbloun
kɑpsɑmHHn	kɑpsɑmiin	kɑpsɑmɯɯn
kitɑpDAki	kitɑpteki	kitɑptɑki
korkuHn	korkuin	korkuun
kullɑnmAnHzH	kullɑnmɑnizi	kullɑnmɑnɯzɯ
meʤlisDAn	meʤlistɑn	meʤlisten
motiflArH	motiflɑrɯ	motifleri
nøbetlAr	nøbetlɑr	nøbetler
oʤɑklArHHn	oʤɑkleriin	oʤɑklɑrɯɯn
oluʃumHn	oluʃumin	oluʃumun
oruʧlArH	oruʧleri	oruʧlɑrɯ
poliplAr	poliplɑr	polipler
sevDHklArH	sevdiklɑrɯ	sevdikleri
sorunmHz	sorunmyz	sorunmuz
stɑʒHn	stɑʒin	stɑʒɯn
tyrDAki	tyrtɑki	tyrdeki
tɑhsilɑtH	tɑhsilɑtu	tɑhsilɑtɯ
tɑrɑfsHzlHk	tɑrɑfsizlik	tɑrɑfsɯzlɯk
tɑrzlArH	tɑrzleri	tɑrzlɑrɯ
tuzlArH	tuzleri	tuzlɑrɯ
uʧurumHn	uʧurumin	uʧurumun
umutlH	umutli	umutlu
ujumsHzlHk	ujumsizlik	ujumsuzluk
vɑtɑndɑʃmHz	vɑtɑndɑʃmiz	vɑtɑndɑʃmɯz
jɑɰHʃlAr	jɑɰiʃler	jɑɰɯʃlɑr
jɑzɑrlHk	jɑzɑrlik	jɑzɑrlɯk
jenilAʃmA	jenileʃmɑ	jenileʃme
jurtlArH	jurtleri	jurtlɑrɯ
ɑɰrɯsHz	ɑɰrɯsiz	ɑɰrɯsɯz
ɑlemDA	ɑlemdɑ	ɑlemde
ɑntrenørH	ɑntrenøri	ɑntrenøry
ɑrɑmADA	ɑrɑmɑde	ɑrɑmɑdɑ
ɑrɑzilArDA	ɑrɑzilerdɑ	ɑrɑzilerde
ɑrkɑdɑʃnHz	ɑrkɑdɑʃniz	ɑrkɑdɑʃnɯz
bɑʃvurulArHHn	bɑʃvuruleriin	bɑʃvurulɑrɯɯn
bedellAr	bedellɑr	bedeller
besinlArH	besinlɑrɯ	besinleri
binɑlArHHn	binɑleriin	binɑlɑrɯɯn
ʤinsAllHk	ʤinsɑllik	ʤinsellik
ʤinsDAn	ʤinstɑn	ʤinsten
defterlArHn	defterlɑrɯn	defterlerin
denetimlArDA	denetimlerdɑ	denetimlerde
denetlAAn	denetlɑɑn	denetleen
devirlArDA	devirlɑrdɑ	devirlerde
esinlAnArAk	esinlɑnɑrɑk	esinlenerek
etkilAnmAH	etkilenmɑɯ	etkilenmei
fɑturɑsHz	fɑturɑsiz	fɑturɑsɯz
fɑzDA	fɑzde	fɑzdɑ
gyʧsHzlHk	gyʧsizlik	gyʧsyzlyk
geleʤeklAr	geleʤeklɑr	geleʤekler
hɑritɑDA	hɑritɑde	hɑritɑdɑ
kɑmpusH	kɑmpusi	kɑmpusu
kɑnolA	kɑnole	kɑnolɑ
kɑtDAki	kɑtteki	kɑttɑki
klorlH	klorli	klorlu
kontrolHn	kontrolin	kontrolyn
konutHn	konutin	konutun
liderlArHn	liderlɑrɯn	liderlerin
mezɑrlHk	mezɑrlik	mezɑrlɯk
nesillArHn	nesillɑrɯn	nesillerin
ortɑmlArHn	ortɑmlerin	ortɑmlɑrɯn
otomɑsjonA	otomɑsjone	otomɑsjonɑ
ojunlArDAn	ojunlɑrden	ojunlɑrdɑn
protokolHn	protokolin	protokolyn
sɑjmɑnlHk	sɑjmɑnlik	sɑjmɑnlɯk
seminerlArA	seminerlɑrɑ	seminerlere
sendikɑmHz	sendikɑmiz	sendikɑmɯz
sinirlArHn	sinirlɑrɯn	sinirlerin
sunAbilmA	sunɑbilmɑ	sunɑbilme
sunuʤuHn	sunuʤuin	sunuʤuun
tymørH	tymøri	tymøry
tytynlArA	tytynlɑrɑ	tytynlere
tɑʃlArHHn	tɑʃleriin	tɑʃlɑrɯɯn
tɑkɯmlArHHn	tɑkɯmleriin	tɑkɯmlɑrɯɯn
tɑkvimDA	tɑkvimdɑ	tɑkvimde
tɑrɑfnHzA	tɑrɑfnizɑ	tɑrɑfnɯzɑ
teʃviklAr	teʃviklɑr	teʃvikler
temɑslAr	temɑsler	temɑslɑr
turizmDA	turizmdɑ	turizmde
tutAbilmA	tutɑbilmɑ	tutɑbilme
tutHʃ	tutiʃ	tutuʃ
tutukluHn	tutukluin	tutukluun
ulɑʃDHkDAn	ulɑʃtiktɑn	ulɑʃtɯktɑn
ujgulɑHʤH	ujgulɑiʤi	ujgulɑɯʤɯ
vɑsɯflH	vɑsɯfli	vɑsɯflɯ
jɯlDAki	jɯldeki	jɯldɑki
jɑʃlHlArA	jɑʃlilere	jɑʃlɯlɑrɑ
ʧɑlɯʃmAlArnHz	ʧɑlɯʃmɑlɑrniz	ʧɑlɯʃmɑlɑrnɯz
ʧɑtɯʃmADA	ʧɑtɯʃmɑde	ʧɑtɯʃmɑdɑ
ʧizimA	ʧizimɑ	ʧizime
ɑlmAlArnA	ɑlmɑlɑrne	ɑlmɑlɑrnɑ
ɑnɑlizA	ɑnɑlizɑ	ɑnɑlize
ɑrenɑDA	ɑrenɑde	ɑrenɑdɑ
byjyHp	byjyup	byjyyp
bɑsɑmɑkDA	bɑsɑmɑkte	bɑsɑmɑktɑ
belirtmA	belirtmɑ	belirtme
birejlArDA	birejlerdɑ	birejlerde
bulɑʃmADAn	bulɑʃmɑden	bulɑʃmɑdɑn
ʤiroH	ʤiroi	ʤirou
eʤzɑnelArDA	eʤzɑnelerdɑ	eʤzɑnelerde
gørynmAH	gørynmɑɯ	gørynmei
gøtyrmA	gøtyrmɑ	gøtyrme
gynʤellAnmAH	gynʤellɑnmɑɯ	gynʤellenmei
gynlH	gynli	gynly
geʤikmAlAr	geʤikmɑlɑr	geʤikmeler
gereksinmA	gereksinmɑ	gereksinme
gitmADA	gitmɑde	gitmete
hɑllArA	hɑllɑrɑ	hɑllere
hɑjɑtmHz	hɑjɑtmiz	hɑjɑtmɯz
hizmetnHzA	hizmetnɯzɑ	hizmetnize
ihtijɑʧlArnHzA	ihtijɑʧlernizɑ	ihtijɑʧlɑrnɯzɑ
kyltyrDA	kyltyrdɑ	kyltyrde
kɑlɯnlHkDA	kɑlɯnlikte	kɑlɯnlɯktɑ
kɑnɑllArDAn	kɑnɑllɑrden	kɑnɑllɑrdɑn
kemiklArDA	kemiklɑrdɑ	kemiklerde
kirletAn	kirletɑn	kirleten
korkuDAn	korkutɑn	korkudɑn
koroH	koroi	korou
nɑmuslH	nɑmusli	nɑmuslu
olAʤAklArnH	olɑʤɑklernɯ	olɑʤɑklɑrnɯ
oluʃumHHn	oluʃumiin	oluʃumuun
rolHHn	roliin	rolyyn
sɯklHk	sɯklik	sɯklɯk
sɑɰlɑmADAn	sɑɰlɑmɑden	sɑɰlɑmɑtɑn
sembollArH	sembollɑrɯ	sembolleri
senɑrjoH	senɑrjoi	senɑrjou
tɑrɑfmHzA	tɑrɑfmyze	tɑrɑfmɯzɑ
tempoH	tempoi	tempou
tenʤereDA	tenʤerete	tenʤerede
uzɑklArDAn	uzɑklɑrden	uzɑklɑrdɑn
uzunlukDA	uzunlukte	uzunluktɑ
vefɑtH	vefɑtu	vefɑtɯ
vermAlH	vermɑlɯ	vermeli
jyklAnHʤHA	jyklɑnɯʤɯɑ	jykleniʤie
jɑʃlAr	jɑʃler	jɑʃlɑr
jɑpɯlArDAn	jɑpɯlɑrden	jɑpɯlɑrdɑn
jɑrɯjɯlDAn	jɑrɯjɯlden	jɑrɯjɯldɑn
jɑtHp	jɑtup	jɑtɯp
jetiʃmAH	jetiʃmɑɯ	jetiʃmei
jollH	jolli	jollu
øzetlAr	øzetlɑr	øzetler
ʃekillArHn	ʃekillɑrɯn	ʃekillerin
ɑʃɑmɑlArDAn	ɑʃɑmɑlɑrden	ɑʃɑmɑlɑrdɑn
ɑrkɑdɑʃmHn	ɑrkɑdɑʃmin	ɑrkɑdɑʃmɯn
ɑtsHz	ɑtsiz	ɑtsɯz
ɑjrɯlDHkDAn	ɑjrɯldiktɑn	ɑjrɯldɯktɑn
ɑjrɯlmɑDAn	ɑjrɯlmɑden	ɑjrɯlmɑdɑn
byjyklArHn	byjyklɑrɯn	byjyklerin
bɑɰɯʃlAr	bɑɰɯʃler	bɑɰɯʃlɑr
bɑʃlArDA	bɑʃlerdɑ	bɑʃlɑrdɑ
beklAnmAH	beklɑnmɑɯ	beklenmei
belirlemAH	belirlemɑɯ	belirlemei
buʤɑksHz	buʤɑksiz	buʤɑksɯz
døllAnmA	døllɑnmɑ	døllenme
dønHnʤA	døninʤe	dønynʤe
dyzenlemAlArDA	dyzenlemɑlɑrdɑ	dyzenlemelerde
deɰiʃmADA	deɰiʃmɑde	deɰiʃmete
deɰiʃmAlArH	deɰiʃmɑlɑrɯ	deɰiʃmeleri
deliklAr	deliklɑr	delikler
desteklAmAA	desteklɑmɑɑ	desteklemee
dostmHz	dostmiz	dostmuz
efektlAr	efektlɑr	efektler
etkilAmAH	etkilemɑɯ	etkilemei
formyllAr	formyllɑr	formyller
gøkjyzynH	gøkjyzyni	gøkjyzyny
gøndermAA	gøndermɑɑ	gøndermee
gørmAHn	gørmɑɯn	gørmein
geʤikmAH	geʤikmɑɯ	geʤikmei
gerekAnH	gerekɑnɯ	gerekeni
girmAnHzDAn	girmɑnɯzden	girmenizden
hɑjɑllArH	hɑjɑllɑrɯ	hɑjɑlleri
hitlAr	hitlɑr	hitler
iʧmHzA	iʧmyze	iʧmize
ijilAʃmAH	ijileʃmɑɯ	ijileʃmei
kɑdɯnlArDAn	kɑdɯnlɑrden	kɑdɯnlɑrdɑn
kɑslArDA	kɑslerdɑ	kɑslɑrdɑ
kɑzɑnʧlArH	kɑzɑnʧleri	kɑzɑnʧlɑrɯ
konArAk	konerek	konɑrɑk
kullHk	kullik	kulluk
kurslArHn	kurslerin	kurslɑrɯn
lɑfH	lɑfi	lɑfɯ
mɑʧA	mɑʧe	mɑʧɑ
mɑʧlArH	mɑʧleri	mɑʧlɑrɯ
mɑkbuzlArH	mɑkbuzleri	mɑkbuzlɑrɯ
merdivenlAr	merdivenlɑr	merdivenler
mirɑsHn	mirɑsin	mirɑsɯn
odɑlArDAn	odɑlɑrden	odɑlɑrdɑn
pɑrlɑmentoHn	pɑrlɑmentoin	pɑrlɑmentoun
politikɑDA	politikɑde	politikɑdɑ
ryzgɑrlH	ryzgɑrli	ryzgɑrlɯ
sɑɰlAnmADA	sɑɰlɑnmɑde	sɑɰlɑnmɑtɑ
sɑjfɑmHzA	sɑjfɑmyze	sɑjfɑmɯzɑ
silɑhsHz	silɑhsiz	silɑhsɯz
stɑndH	stɑndi	stɑndɯ
tɑrɑmɑDAn	tɑrɑmɑden	tɑrɑmɑdɑn
testlArDA	testlɑrdɑ	testlerde
umutlArH	umutleri	umutlɑrɯ
ujumsHz	ujumsiz	ujumsuz
jyksekøɰretimA	jyksekøɰretimɑ	jyksekøɰretime
jɑrɯʃDA	jɑrɯʃdɑ	jɑrɯʃtɑ
ʧɯkHʃlAr	ʧɯkiʃler	ʧɯkɯʃlɑr
ʧɑlɯʃmAlArmHzHn	ʧɑlɯʃmɑlɑrmizin	ʧɑlɯʃmɑlɑrmɯzɯn
ʧɑlɯʃmAlArnHzH	ʧɑlɯʃmɑlɑrnizi	ʧɑlɯʃmɑlɑrnɯzɯ
ʃɑrtlArDAn	ʃɑrtlɑrden	ʃɑrtlɑrdɑn
ʃɑrtnɑmeDA	ʃɑrtnɑmete	ʃɑrtnɑmede
ɑidɑtlArH	ɑidɑtleri	ɑidɑtlɑrɯ
ɑldɯrmADAn	ɑldɯrmɑden	ɑldɯrmɑdɑn
ɑmelijɑtHn	ɑmelijɑtin	ɑmelijɑtɯn
ɑnɑjɑsɑmHzHn	ɑnɑjɑsɑmizin	ɑnɑjɑsɑmɯzɯn
ɑrɑbɑDA	ɑrɑbɑde	ɑrɑbɑdɑ
ɑrɑHʃlAr	ɑrɑiʃler	ɑrɑɯʃlɑr
ɑtɯklArHHn	ɑtɯkleriin	ɑtɯklɑrɯɯn
bɑʃnHzH	bɑʃnizi	bɑʃnɯzɯ
bɑnjoH	bɑnjoi	bɑnjou
bɑsmɑnHz	bɑsmɑniz	bɑsmɑnɯz
bebeklArA	bebeklɑrɑ	bebeklere
bitmAAn	bitmɑɑn	bitmeen
ʤinɑjetlAr	ʤinɑjetlɑr	ʤinɑjetler
døkmA	døkmɑ	døkme
dyʃmA	dyʃmɑ	dyʃme
desteklAmAH	desteklɑmɑɯ	desteklemei
dolulHk	dolulik	doluluk
evlenmA	evlenmɑ	evlenme
fɑrklHlHklArA	fɑrkliliklɑrɑ	fɑrklɯlɯklɑrɑ
fertlArHn	fertlɑrɯn	fertlerin
formlArHHn	formleriin	formlɑrɯɯn
gøryntylAnAn	gøryntylɑnɑn	gøryntylenen
gørmAnHz	gørmɑniz	gørmeniz
gøzlAnmAH	gøzlɑnmɑɯ	gøzlenmei
gyzellHklArHn	gyzelliklɑrɯn	gyzelliklerin
geleneklAr	geleneklɑr	gelenekler
hɑlkmHzH	hɑlkmizi	hɑlkmɯzɯ
ihtijɑʧlArnHzH	ihtijɑʧlernizi	ihtijɑʧlɑrnɯzɯ
iletAn	iletɑn	ileten
ilgilenmA	ilgilenmɑ	ilgilenme
istɑsjonA	istɑsjone	istɑsjonɑ
kyrlAʃAn	kyrlɑʃɑn	kyrleʃen
kɑbulnH	kɑbulnɯ	kɑbulny
kɑdemeDAki	kɑdemeteki	kɑdemedeki
kɑdroHHn	kɑdroiin	kɑdrouun
kɑliteDAki	kɑliteteki	kɑlitedeki
kɑnɑlHHn	kɑnɑliin	kɑnɑlɯɯn
kemerlArH	kemerlɑrɯ	kemerleri
koʃullH	koʃulli	koʃullu
konserDA	konserdɑ	konserde
kriterlArHn	kriterlɑrɯn	kriterlerin
lɑstiklArHn	lɑstiklɑrɯn	lɑstiklerin
listelArDA	listelerdɑ	listelerde
myrɑʤɑɑtDA	myrɑʤɑɑtte	myrɑʤɑɑttɑ
notHn	notin	notun
oʤɑkDA	oʤɑkte	oʤɑktɑ
ortɑlɯkDA	ortɑlɯkte	ortɑlɯktɑ
otobysH	otobysi	otobysy
otobysA	otobysɑ	otobyse
ojlArH	ojleri	ojlɑrɯ
pɑrsellArHn	pɑrsellɑrɯn	pɑrsellerin
pijɑsɑlArDAki	pijɑsɑlɑrtɑki	pijɑsɑlɑrdɑki
plɑnsHz	plɑnsiz	plɑnsɯz
senɑtoHn	senɑtoin	senɑtoun
tɑhlillArH	tɑhlillɑrɯ	tɑhlilleri
tɑkɯmlArHn	tɑkɯmlerin	tɑkɯmlɑrɯn
toplummHz	toplummiz	toplummuz
turlH	turli	turlu
verAʤAklAr	vereʤeklɑr	vereʤekler
jyrytmADA	jyrytmɑde	jyrytmete
jolsuzlHklArHn	jolsuzliklɑrɯn	jolsuzluklɑrɯn
zeminlAr	zeminlɑr	zeminler
ʧøkHʃ	ʧøkiʃ	ʧøkyʃ
ʧøzymlAmAH	ʧøzymlɑmɑɯ	ʧøzymlemei
ʧɑlɯʃmAnHz	ʧɑlɯʃmɑniz	ʧɑlɯʃmɑnɯz
ʧekmADA	ʧekmɑde	ʧekmete
ʧekDHklArH	ʧektiklɑrɯ	ʧektikleri
ølymsHz	ølymsiz	ølymsyz
ølHnʤAA	ølinʤɑɑ	ølynʤee
øzgyrlHklArHHn	øzgyrlikleriin	øzgyrlykleriin
ɑʧmADA	ɑʧmɑde	ɑʧmɑtɑ
ɑɰɯzDA	ɑɰɯzde	ɑɰɯzdɑ
ɑlɯʃveriʃlArDA	ɑlɯʃveriʃlerdɑ	ɑlɯʃveriʃlerde
ɑmirlAr	ɑmirlɑr	ɑmirler
ɑrɑbɑDAn	ɑrɑbɑden	ɑrɑbɑdɑn
ɑjɑklArHHn	ɑjɑkleriin	ɑjɑklɑrɯɯn
ɑjɑrlArHHn	ɑjɑrleriin	ɑjɑrlɑrɯɯn
ɑjlArA	ɑjlere	ɑjlɑrɑ
ɑjvɑlHk	ɑjvɑlik	ɑjvɑlɯk
bølmA	bølmɑ	bølme
bɑʃlɯkDA	bɑʃlɯkte	bɑʃlɯktɑ
bɑnkɑmHzHn	bɑnkɑmizin	bɑnkɑmɯzɯn
bɑjlAr	bɑjler	bɑjlɑr
bitHnʤAA	bitinʤɑɑ	bitinʤee
bojDA	bojde	bojdɑ
bulHʃlAr	buliʃler	buluʃlɑr
ʤemijetlAr	ʤemijetlɑr	ʤemijetler
dyzeltmAA	dyzeltmɑɑ	dyzeltmee
dezɑvɑntɑʒH	dezɑvɑntɑʒi	dezɑvɑntɑʒɯ
dolɑjsHz	dolɑjsiz	dolɑjsɯz
dosjɑlArnHzH	dosjɑlɑrnizi	dosjɑlɑrnɯzɯ
dojAsHjA	dojɑsijɑ	dojɑsɯjɑ
durumlArDAn	durumlerden	durumlɑrdɑn
enstitymHz	enstitymiz	enstitymyz
erozjonA	erozjone	erozjonɑ
eserlArA	eserlɑrɑ	eserlere
fɑbrikɑlArHHn	fɑbrikɑleriin	fɑbrikɑlɑrɯɯn
fɑktørHHn	fɑktøriin	fɑktøryyn
fotoɰrɑflArDAn	fotoɰrɑflɑrden	fotoɰrɑflɑrdɑn
gøndermAH	gøndermɑɯ	gøndermei
geʧDHklArH	geʧdiklɑrɯ	geʧtikleri
geliʃDHkʧA	geliʃdikʧe	geliʃtikʧe
gezHp	gezup	gezip
hɑkikɑtH	hɑkikɑtu	hɑkikɑti
hukukʧHlAr	hukukʧiler	hukukʧulɑr
iʃverenlArHn	iʃverenlɑrɯn	iʃverenlerin
inDA	indɑ	inde
itAn	itɑn	iten
kɯlɑvuzDA	kɯlɑvuzde	kɯlɑvuzdɑ
kyʧylAn	kyʧylɑn	kyʧylen
kɑsHn	kɑsin	kɑsɯn
kɑtAʤAk	kɑteʤɑk	kɑtɑʤɑk
kɑjdetmA	kɑjdetmɑ	kɑjdetme
kesitlArDA	kesitlɑrdɑ	kesitlerde
kurɑmlAr	kurɑmler	kurɑmlɑr
mɑɰdurH	mɑɰduri	mɑɰduru
metinlArDA	metinlɑrdɑ	metinlerde
misjonmHz	misjonmyz	misjonmuz
noktɑDAki	noktɑtɑki	noktɑdɑki
okullArDAki	okullɑrtɑki	okullɑrdɑki
potɑnsijellArH	potɑnsijellɑrɯ	potɑnsijelleri
profesjonellAr	profesjonellɑr	profesjoneller
ruhsɑtA	ruhsɑte	ruhsɑtɑ
sɯfɯrDAn	sɯfɯrden	sɯfɯrdɑn
sɯrɑlAmADA	sɯrɑlɑmɑde	sɯrɑlɑmɑdɑ
sɑntrɑllArH	sɑntrɑllɑrɯ	sɑntrɑlleri
tɯkɑnɯklHk	tɯkɑnɯklik	tɯkɑnɯklɯk
tɑhɑkkukH	tɑhɑkkuki	tɑhɑkkuku
tɑzminɑtsHz	tɑzminɑtsiz	tɑzminɑtsɯz
tespitlAr	tespitlɑr	tespitler
tutumlAr	tutumler	tutumlɑr
verAbilmAH	verebilmɑɯ	verebilmei
vitɑminlAr	vitɑminlɑr	vitɑminler
jønetmAA	jønetmɑɑ	jønetmee
jyrytDHklArH	jyryttiklɑrɯ	jyryttykleri
jɑkHp	jɑkip	jɑkɯp
ʧyrymA	ʧyrymɑ	ʧyryme
ʧɑɰɯrAn	ʧɑɰɯren	ʧɑɰɯrɑn
ʧɑmlHk	ʧɑmlik	ʧɑmlɯk
ʧevrelArDA	ʧevrelerdɑ	ʧevrelerde
øɰretmenmHz	øɰretmenmyz	øɰretmenmiz
ølʧAn	ølʧɑn	ølʧen
ørtyHHn	ørtyiin	ørtyyyn
ʃiʃirmA	ʃiʃirmɑ	ʃiʃirme
ɑʧɯHHn	ɑʧɯiin	ɑʧɯɯɯn
ɑkɯmlArHHn	ɑkɯmleriin	ɑkɯmlɑrɯɯn
ɑlmAksHzHn	ɑlmɑksizin	ɑlmɑksɯzɯn
ɑnlɑmADAn	ɑnlɑmɑden	ɑnlɑmɑdɑn
bytynHn	bytynin	bytynyn
bɑhʧelArDA	bɑhʧelerdɑ	bɑhʧelerde
bɑjrɑklH	bɑjrɑkli	bɑjrɑklɯ
bojHHn	bojiin	bojuun
bozArAk	bozerek	bozɑrɑk
bozuklHklArHn	bozukliklɑrɯn	bozukluklɑrɯn
bulunmADAn	bulunmɑden	bulunmɑtɑn
bulutlArH	bulutleri	bulutlɑrɯ
ʤymleDA	ʤymlete	ʤymlede
dyzenlAnmADA	dyzenlɑnmɑde	dyzenlenmete
deɰerlendirmAlArnH	deɰerlendirmɑlɑrnɯ	deɰerlendirmelerni
demokrɑsilArDA	demokrɑsilerdɑ	demokrɑsilerde
eklAnHnʤA	eklɑninʤe	ekleninʤe
engellAArAk	engellɑɑrɑk	engelleerek
etmADHklArH	etmetiklɑrɯ	etmedikleri
formɑtA	formɑte	formɑtɑ
gøryʃHp	gøryʃup	gøryʃyp
gynʤellAnAn	gynʤellɑnɑn	gynʤellenen
hɑritɑlArHHn	hɑritɑleriin	hɑritɑlɑrɯɯn
hɑvuzlH	hɑvuzli	hɑvuzlu
ilʧeDAki	ilʧeteki	ilʧedeki
ilgilenmAA	ilgilenmɑɑ	ilgilenmee
inʃɑɑtlArH	inʃɑɑtleri	inʃɑɑtlɑrɯ
inɑnʧlArH	inɑnʧleri	inɑnʧlɑrɯ
izlAnArAk	izlɑnɑrɑk	izlenerek
kɑrɑʤiɰerDA	kɑrɑʤiɰerdɑ	kɑrɑʤiɰerde
kɑrɑjoluHn	kɑrɑjoluin	kɑrɑjoluun
komisjonlArHHn	komisjonleriin	komisjonlɑrɯɯn
kulɑkDAki	kulɑkteki	kulɑktɑki
myʃɑvirlAr	myʃɑvirlɑr	myʃɑvirler
myziklArH	myziklɑrɯ	myzikleri
medenijetlAr	medenijetlɑr	medenijetler
okuDHklArH	okutuklɑrɯ	okuduklɑrɯ
olmAlArHHn	olmɑleriin	olmɑlɑrɯɯn
plɑtformlArH	plɑtformleri	plɑtformlɑrɯ
resimlArDA	resimlerdɑ	resimlerde
resulH	resulu	resuly
tɑʃɯHʤHH	tɑʃɯiʤii	tɑʃɯɯʤɯɯ
tɑnɯmlAmHʃ	tɑnɯmlemiʃ	tɑnɯmlɑmɯʃ
tɑnɯmlAmADA	tɑnɯmlɑmɑde	tɑnɯmlɑmɑtɑ
tɑriflArH	tɑriflɑrɯ	tɑrifleri
tɑvlH	tɑvli	tɑvlɯ
telefonHHn	telefoniin	telefonuun
terminɑllAr	terminɑllɑr	terminɑller
tuzlHlHk	tuzlilik	tuzluluk
vermAksHzHn	vermɑksizin	vermeksizin
jyklArHn	jyklɑrɯn	jyklerin
jɑɰHʃH	jɑɰiʃi	jɑɰɯʃɯ
jɑɰmurHn	jɑɰmurɯn	jɑɰmurun
jɑtHʃ	jɑtiʃ	jɑtɯʃ
ʧɑmurlH	ʧɑmurli	ʧɑmurlu
ʧekirdeklArH	ʧekirdeklɑrɯ	ʧekirdekleri
ʧimlAnmA	ʧimlɑnmɑ	ʧimlenme
ɯsɯHHn	ɯsɯiin	ɯsɯɯɯn
ølymHHn	ølymiin	ølymyyn
ʃehirlAʃmA	ʃehirlɑʃmɑ	ʃehirleʃme
ʃubeDA	ʃubete	ʃubede
ɑilelArDA	ɑilelerdɑ	ɑilelerde
ɑrɑʤɯnHzH	ɑrɑʤɯnizi	ɑrɑʤɯnɯzɯ
ɑrɑnHzDA	ɑrɑnɯzde	ɑrɑnɯzdɑ
ɑsɯlsHz	ɑsɯlsiz	ɑsɯlsɯz
bɑʃmH	bɑʃmi	bɑʃmɯ
bilmA	bilmɑ	bilme
bollHk	bollik	bolluk
bojutlArHHn	bojutleriin	bojutlɑrɯɯn
dɑvɑDAn	dɑvɑden	dɑvɑdɑn
dersnDAn	dersndɑn	dersnden
eklemlArDA	eklemlerdɑ	eklemlerde
etkenlArH	etkenlɑrɯ	etkenleri
fiillArH	fiillɑrɯ	fiilleri
formDAki	formtɑki	formdɑki
gynlAnmAH	gynlɑnmɑɯ	gynlenmei
gytmAAn	gytmɑɑn	gytmeen
geliʃimA	geliʃimɑ	geliʃime
girmAnHzH	girmɑnizi	girmenizi
hɑtlH	hɑtli	hɑtlɯ
hɑjɑtnHz	hɑjɑtniz	hɑjɑtnɯz
kɯtɑDA	kɯtɑde	kɯtɑdɑ
kɯjAsHjA	kɯjɑsijɑ	kɯjɑsɯjɑ
kykyrtlH	kykyrtli	kykyrtly
kodHn	kodɯn	kodun
lyzumsHz	lyzumsiz	lyzumsuz
lɑstiklAr	lɑstiklɑr	lɑstikler
listelAnmAH	listelɑnmɑɯ	listelenmei
mevsimA	mevsimɑ	mevsime
normlArA	normlere	normlɑrɑ
piʃmɑnlHk	piʃmɑnlik	piʃmɑnlɯk
syzylAn	syzylɑn	syzylen
sɑldɯrAn	sɑldɯren	sɑldɯrɑn
sɑnAH	sɑnei	sɑnɑɯ
sɑrɑjDA	sɑrɑjde	sɑrɑjdɑ
seʧmAlArH	seʧmɑlɑrɯ	seʧmeleri
tymørlArH	tymørlɑrɯ	tymørleri
tɑkɯmmHzHn	tɑkɯmmizin	tɑkɯmmɯzɯn
tezgɑhH	tezgɑhi	tezgɑhɯ
tezgɑhlArH	tezgɑhleri	tezgɑhlɑrɯ
vɑlilHklAr	vɑliliklɑr	vɑlilikler
vɑlilHklArA	vɑliliklɑrɑ	vɑliliklere
jɑjɯnlArDAn	jɑjɯnlɑrden	jɑjɯnlɑrdɑn
jeteneklAr	jeteneklɑr	jetenekler
joɰunlHkDA	joɰunlikte	joɰunluktɑ
ʧøzAʤAk	ʧøzeʤɑk	ʧøzeʤek
ɯsɯtHʤH	ɯsɯtiʤi	ɯsɯtɯʤɯ
øɰrenimmH	øɰrenimmɯ	øɰrenimmi
øɰretmenlArmHz	øɰretmenlɑrmiz	øɰretmenlermiz
ølDHkDAn	øldiktɑn	øldykten
øzgyrlHklArA	øzgyrliklɑrɑ	øzgyrlyklere
ɑrɑʧlHk	ɑrɑʧlik	ɑrɑʧlɯk
ɑrɑmHzDAki	ɑrɑmɯzdeki	ɑrɑmɯzdɑki
ɑrkɑdɑʃlArmH	ɑrkɑdɑʃlermi	ɑrkɑdɑʃlɑrmɯ
bɯrɑkDHklArH	bɯrɑktiklɑrɯ	bɯrɑktɯklɑrɯ
bɑɰlɑntɯlArHHn	bɑɰlɑntɯleriin	bɑɰlɑntɯlɑrɯɯn
bɑʃørtylH	bɑʃørtyli	bɑʃørtyly
bɑntlH	bɑntli	bɑntlɯ
binɑDAn	binɑden	binɑdɑn
binAn	binɑn	binen
bozmA	bozme	bozmɑ
ʤephelArDA	ʤephelerdɑ	ʤephelerde
dyʃHʃH	dyʃiʃi	dyʃyʃy
deɰerlendirmAlArDA	deɰerlendirmɑlɑrdɑ	deɰerlendirmelerde
devirlAr	devirlɑr	devirler
devletlArɑrɑsɯ	devletlɑrɑrɑsɯ	devletlerɑrɑsɯ
disiplinlAr	disiplinlɑr	disiplinler
doɰuDAki	doɰutɑki	doɰudɑki
eɰitimDAki	eɰitimdɑki	eɰitimdeki
erimA	erimɑ	erime
etkinliklArDAn	etkinliklɑrden	etkinliklerden
evrenDA	evrendɑ	evrende
firmɑnHz	firmɑniz	firmɑnɯz
fotoɰrɑfʧHHn	fotoɰrɑfʧiin	fotoɰrɑfʧɯɯn
gønyllylHk	gønyllylik	gønyllylyk
gøndermAH	gøndermɑɯ	gøndermei
geʧAlHm	geʧɑlim	geʧelim
hykymsHz	hykymsiz	hykymsyz
hɑvuzlAr	hɑvuzler	hɑvuzlɑr
iʃɑretlArHn	iʃɑretlɑrɯn	iʃɑretlerin
iʃgyʤyHn	iʃgyʤyin	iʃgyʤyyn
iʃlevsAllHk	iʃlevsɑllik	iʃlevsellik
ithɑlɑtDA	ithɑlɑtte	ithɑlɑttɑ
izlemAH	izlemɑɯ	izlemei
kɯsɯmlArA	kɯsɯmlere	kɯsɯmlɑrɑ
kɑlkHnʤA	kɑlkinʤe	kɑlkɯnʤɑ
kɑrɑrlArDAn	kɑrɑrlɑrden	kɑrɑrlɑrdɑn
kesirlAr	kesirlɑr	kesirler
kokusHz	kokusiz	kokusuz
kurmADA	kurmɑde	kurmɑtɑ
mɑkineDA	mɑkinete	mɑkinede
milletDAn	millettɑn	milletten
muhtɑrlHk	muhtɑrlik	muhtɑrlɯk
pejgɑmberlAr	pejgɑmberlɑr	pejgɑmberler
plɑtformlAr	plɑtformler	plɑtformlɑr
sɑjgɯnlHk	sɑjgɯnlik	sɑjgɯnlɯk
seʧAʤAklArH	seʧeʤeklɑrɯ	seʧeʤekleri
selɑmlAr	selɑmler	selɑmlɑr
siDA	site	side
silɑhlArA	silɑhlere	silɑhlɑrɑ
sormADAn	sormɑden	sormɑdɑn
sorumsHz	sorumsiz	sorumsuz
typlArH	typlɑrɯ	typleri
tɑkHn	tɑkin	tɑkɯn
teʃekkylH	teʃekkyli	teʃekkyly
tutDHklArH	tuttiklɑrɯ	tuttuklɑrɯ
uɰrɑmADAn	uɰrɑmɑden	uɰrɑmɑdɑn
ujkuDAn	ujkutɑn	ujkudɑn
uzɑtArAk	uzɑterek	uzɑtɑrɑk
uzmɑnlArDAn	uzmɑnlɑrden	uzmɑnlɑrdɑn
vesikɑlHk	vesikɑlik	vesikɑlɯk
jønlArA	jønlɑrɑ	jønlere
jyryHʃlAr	jyryiʃler	jyryyʃler
jɑzɯmHzDA	jɑzɯmɯzde	jɑzɯmɯzdɑ
jetiʃkinlArDA	jetiʃkinlɑrdɑ	jetiʃkinlerde
jetiʃkinlArA	jetiʃkinlɑrɑ	jetiʃkinlere
zɑmɑnlArHHn	zɑmɑnleriin	zɑmɑnlɑrɯɯn
zɑrfH	zɑrfi	zɑrfɯ
ʧekinmADAn	ʧekinmɑden	ʧekinmeden
ønnHzA	ønnɯzɑ	ønnyze
øjkyHn	øjkyin	øjkyyn
ʃɑirlArHn	ʃɑirlɑrɯn	ʃɑirlerin
ystynlHklArH	ystynliklɑrɯ	ystynlykleri
yzernHzA	yzernizɑ	yzernize
ɑkrɑbɑlHk	ɑkrɑbɑlik	ɑkrɑbɑlɯk
ɑrɑbuluʤulHk	ɑrɑbuluʤulik	ɑrɑbuluʤuluk
ɑtHʃH	ɑtiʃi	ɑtɯʃɯ
bytynlAʃmAH	bytynlɑʃmɑɯ	bytynleʃmei
bɑʃlAAlHm	bɑʃleelim	bɑʃlɑɑlɯm
biʧimA	biʧimɑ	biʧime
bildirmAlArH	bildirmɑlɑrɯ	bildirmeleri
bilmAlArH	bilmɑlɑrɯ	bilmeleri
binmA	binmɑ	binme
boɰɑzlAr	boɰɑzler	boɰɑzlɑr
bulgulArHHn	bulguleriin	bulgulɑrɯɯn
bulunmADHkʧA	bulunmetikʧe	bulunmɑdɯkʧɑ
ʤihɑzDA	ʤihɑzde	ʤihɑzdɑ
dyʃynmAH	dyʃynmɑɯ	dyʃynmei
dɑireDA	dɑirete	dɑirede
dɑlgɑlArHHn	dɑlgɑleriin	dɑlgɑlɑrɯɯn
delmA	delmɑ	delme
dinlArHn	dinlɑrɯn	dinlerin
dolgunlHk	dolgunlik	dolgunluk
eʃmA	eʃmɑ	eʃme
elnHzDAn	elnɯzden	elnizden
etkenlArA	etkenlɑrɑ	etkenlere
etmADHk	etmetik	etmedik
fɑzlɑlHk	fɑzlɑlik	fɑzlɑlɯk
fertlAr	fertlɑr	fertler
fiillArHn	fiillɑrɯn	fiillerin
gølHHn	gøliin	gølyyn
gøllArH	gøllɑrɯ	gølleri
gøzlemlAnAn	gøzlemlɑnɑn	gøzlemlenen
gylH	gyli	gyly
gyryltyHn	gyryltyin	gyryltyyn
geʧmAmAH	geʧmɑmɑɯ	geʧmemei
gemiDA	gemite	gemide
geziDA	gezite	gezide
iʧDA	iʧdɑ	iʧte
ideɑlH	ideɑlɯ	ideɑli
imkɑnlArDAn	imkɑnlɑrden	imkɑnlɑrdɑn
ithɑlɑtA	ithɑlɑte	ithɑlɑtɑ
kɯsɯrlHk	kɯsɯrlik	kɯsɯrlɯk
køpeklArHn	køpeklɑrɯn	køpeklerin
kyltyrmHzHn	kyltyrmizin	kyltyrmyzyn
kɑrɯʃɯklHk	kɑrɯʃɯklik	kɑrɯʃɯklɯk
kɑrikɑtyrlAr	kɑrikɑtyrlɑr	kɑrikɑtyrler
kɑjmɑklH	kɑjmɑkli	kɑjmɑklɯ
ligDA	ligdɑ	ligde
mɑdenlArH	mɑdenlɑrɯ	mɑdenleri
mɑkɑmlArHn	mɑkɑmlerin	mɑkɑmlɑrɯn
mɑksɑtlH	mɑksɑtli	mɑksɑtlɯ
mɑlzemeDA	mɑlzemete	mɑlzemede
mɑmyllArH	mɑmyllɑrɯ	mɑmylleri
misɑfirlArA	misɑfirlɑrɑ	misɑfirlere
modellArA	modellɑrɑ	modellere
monitørlAr	monitørlɑr	monitørler
olmAHnʤA	olmɑɯnʤe	olmɑɯnʤɑ
olumsuzlHk	olumsuzlik	olumsuzluk
operɑtørlArHn	operɑtørlɑrɯn	operɑtørlerin
pɑdiʃɑhH	pɑdiʃɑhi	pɑdiʃɑhɯ
renklArA	renklɑrɑ	renklere
sɯnɑvlArDAn	sɯnɑvlerden	sɯnɑvlɑrdɑn
sɑvunmAsHz	sɑvunmɑsiz	sɑvunmɑsɯz
seʧmAlAr	seʧmɑlɑr	seʧmeler
seʧmAH	seʧmɑɯ	seʧmei
sempozjumHn	sempozjumin	sempozjumun
sinirlArH	sinirlɑrɯ	sinirleri
suʧlHlAr	suʧliler	suʧlulɑr
tørenlAr	tørenlɑr	tørenler
temɑslArDA	temɑslerdɑ	temɑslɑrdɑ
testlArDAn	testlɑrden	testlerden
umutsHzlHk	umutsizlik	umutsuzluk
vermADA	vermɑde	vermede
vermAlArnH	vermɑlɑrnɯ	vermelerni
vurHʃ	vuriʃ	vuruʃ
jønelmAH	jønelmɑɯ	jønelmei
jɑnmHzA	jɑnmyze	jɑnmɯzɑ
jemAA	jemɑɑ	jemee
ʧøzymHHn	ʧøzymiin	ʧøzymyyn
ʧøzynAn	ʧøzynɑn	ʧøzynen
ʧeʃitlArHn	ʧeʃitlɑrɯn	ʧeʃitlerin
ʧoɰumHzHn	ʧoɰumizin	ʧoɰumuzun
ʧoʤuklArnHzA	ʧoʤuklernizɑ	ʧoʤuklɑrnɯzɑ
ødeneklArHn	ødeneklɑrɯn	ødeneklerin
ønDAki	øndɑki	øndeki
ørgytlArDA	ørgytlɑrdɑ	ørgytlerde
ɑntibijotiklArHn	ɑntibijotiklɑrɯn	ɑntibijotiklerin
ɑtomlAr	ɑtomler	ɑtomlɑr
bɯrɑkDHkDAn	bɯrɑktiktɑn	bɯrɑktɯktɑn
bɑjrɑmlArDA	bɑjrɑmlerdɑ	bɑjrɑmlɑrdɑ
belgelAnmAH	belgelɑnmɑɯ	belgelenmei
deɰerlArDA	deɰerlɑrdɑ	deɰerlerde
desenlArH	desenlɑrɯ	desenleri
dinɑmizmH	dinɑmizmɯ	dinɑmizmi
dinDAn	dindɑn	dinden
dinlemAH	dinlemɑɯ	dinlemei
doɰuHn	doɰuin	doɰuun
dostlArHHn	dostleriin	dostlɑrɯɯn
edebijɑtDA	edebijɑtte	edebijɑttɑ
eklemAA	eklemɑɑ	eklemee
fijɑtlArmHzA	fijɑtlermizɑ	fijɑtlɑrmɯzɑ
gøklArA	gøklɑrɑ	gøklere
gynlArDAki	gynlɑrtɑki	gynlerdeki
geʧirDHkDAn	geʧirdiktɑn	geʧirdikten
geliʃAʤAk	geliʃeʤɑk	geliʃeʤek
gelmAH	gelmɑɯ	gelmei
gizlAmA	gizlɑmɑ	gizleme
ilɑʧlArDAn	ilɑʧlɑrden	ilɑʧlɑrdɑn
iplArH	iplɑrɯ	ipleri
kɑtɑlogH	kɑtɑlogi	kɑtɑlogu
kɑvrɑmlArA	kɑvrɑmlere	kɑvrɑmlɑrɑ
kirlAnmAHn	kirlɑnmɑɯn	kirlenmein
konAʤAk	koneʤɑk	konɑʤɑk
kumɑʃlArHn	kumɑʃlerin	kumɑʃlɑrɯn
kursijerlAr	kursijerlɑr	kursijerler
listemHzA	listemizɑ	listemize
mɑɰdurHn	mɑɰdurɯn	mɑɰdurun
mɑhkumHn	mɑhkumin	mɑhkumun
miktɑrDAn	miktɑrden	miktɑrdɑn
mirɑsʧHlArH	mirɑsʧileri	mirɑsʧɯlɑrɯ
normlAr	normler	normlɑr
pɑrɑnHz	pɑrɑniz	pɑrɑnɯz
rektørlHkʧA	rektørlikʧe	rektørlykʧe
sɯnɑvsHz	sɯnɑvsiz	sɯnɑvsɯz
søkmA	søkmɑ	søkme
sɑɰlɯkDA	sɑɰlɯkte	sɑɰlɯktɑ
sɑnɑtlArHHn	sɑnɑtleriin	sɑnɑtlɑrɯɯn
sɑjfɑlArmHzDA	sɑjfɑlɑrmizde	sɑjfɑlɑrmɯzdɑ
seʧeneklArHn	seʧeneklɑrɯn	seʧeneklerin
seklHnDAki	seklinteki	seklindeki
sektørmHzHn	sektørmizin	sektørmyzyn
seminerlArDA	seminerlɑrdɑ	seminerlerde
seminerlArHn	seminerlɑrɯn	seminerlerin
sevmAH	sevmɑɯ	sevmei
sitelArDA	sitelerdɑ	sitelerde
sitenHzA	sitenizɑ	sitenize
sonuʧlArDAn	sonuʧlɑrden	sonuʧlɑrdɑn
stokH	stoki	stoku
tytynlArDAn	tytynlɑrden	tytynlerden
tɑvɑDA	tɑvɑde	tɑvɑdɑ
telefonlArDAn	telefonlɑrden	telefonlɑrdɑn
topluluklArHHn	toplulukleriin	topluluklɑrɯɯn
triljonlHk	triljonlik	triljonluk
tutɑnɑkDA	tutɑnɑkte	tutɑnɑktɑ
tutuklulHk	tutuklulik	tutukluluk
uʧɑkDA	uʧɑkte	uʧɑktɑ
unsurHn	unsurɯn	unsurun
ujgɑrlHklArHn	ujgɑrliklɑrɯn	ujgɑrlɯklɑrɯn
uzɑjlArH	uzɑjleri	uzɑjlɑrɯ
jɯɰmA	jɯɰme	jɯɰmɑ
jykymlHlHklArHn	jykymliliklɑrɯn	jykymlylyklerin
jyksekokulDA	jyksekokulde	jyksekokuldɑ
jyksekokulmHz	jyksekokulmiz	jyksekokulmuz
ʧoɰulʤulHk	ʧoɰulʤulik	ʧoɰulʤuluk
øɰrenmAlArH	øɰrenmɑlɑrɯ	øɰrenmeleri
øɰretmAA	øɰretmɑɑ	øɰretmee
øteDA	øtete	øtede
ʃehitlAr	ʃehitlɑr	ʃehitler
ʃubemHzA	ʃubemizɑ	ʃubemize
yʧHHn	yʧiin	yʧyyn
ɑhlɑklH	ɑhlɑkli	ɑhlɑklɯ
bøbreklAr	bøbreklɑr	bøbrekler
bebeklArH	bebeklɑrɯ	bebekleri
beledijeDAn	beledijetɑn	beledijeden
belirtmADA	belirtmɑde	belirtmete
bileʃenlArHn	bileʃenlɑrɯn	bileʃenlerin
bilmAlH	bilmɑlɯ	bilmeli
birikimA	birikimɑ	birikime
boɰɑzHn	boɰɑzin	boɰɑzɯn
boruHHn	boruiin	boruuun
brɑnʃDA	brɑnʃdɑ	brɑnʃtɑ
dyzenlArH	dyzenlɑrɯ	dyzenleri
deneklArHn	deneklɑrɯn	deneklerin
devletlArDA	devletlɑrdɑ	devletlerde
doɰɑDAn	doɰɑden	doɰɑdɑn
drenɑʒH	drenɑʒi	drenɑʒɯ
ejlemlArDA	ejlemlerdɑ	ejlemlerde
fɑturɑlArnHzH	fɑturɑlɑrnizi	fɑturɑlɑrnɯzɯ
gørmAmA	gørmɑmɑ	gørmeme
gøstermADAn	gøstermɑden	gøstermeden
gɑjrimenkullAr	gɑjrimenkullɑr	gɑjrimenkuller
genʧlArDAn	genʧlɑrden	genʧlerden
getirmAHn	getirmɑɯn	getirmein
girAnlArA	girɑnlɑrɑ	girenlere
girAnlArHn	girɑnlɑrɯn	girenlerin
giriʃimsAl	giriʃimsɑl	giriʃimsel
kɯʃlAr	kɯʃler	kɯʃlɑr
kɯlɑvuzlHk	kɯlɑvuzlik	kɯlɑvuzluk
kɑdrolArHHn	kɑdroleriin	kɑdrolɑrɯɯn
kɑnɯtlArH	kɑnɯtleri	kɑnɯtlɑrɯ
kɑnserlArHn	kɑnserlɑrɯn	kɑnserlerin
kɑrʃɯnHzDA	kɑrʃɯnɯzde	kɑrʃɯnɯzdɑ
kɑjbetmAA	kɑjbetmɑɑ	kɑjbetmee
komʃumHz	komʃumiz	komʃumuz
konsɑntrɑsjonHHn	konsɑntrɑsjoniin	konsɑntrɑsjonuun
konHʃ	koniʃ	konuʃ
konutA	konute	konutɑ
krɑlHn	krɑlin	krɑlɯn
kurAbilmA	kurɑbilmɑ	kurɑbilme
kurslArDA	kurslerdɑ	kurslɑrdɑ
kuruluʃmHz	kuruluʃmiz	kuruluʃmuz
mykelleflArHn	mykelleflɑrɯn	mykelleflerin
mɑɰɑzɑDA	mɑɰɑzɑde	mɑɰɑzɑdɑ
mɑhɑllelArDA	mɑhɑllelerdɑ	mɑhɑllelerde
metinDAn	metindɑn	metinden
metrɑʒlH	metrɑʒli	metrɑʒlɯ
oturumlAr	oturumler	oturumlɑr
oturumHn	oturumin	oturumun
ojunlArHHn	ojunleriin	ojunlɑrɯɯn
pɑrkDA	pɑrkte	pɑrktɑ
pijɑsɑlArHHn	pijɑsɑleriin	pijɑsɑlɑrɯɯn
plɑtformHn	plɑtformin	plɑtformun
søkHp	søkip	søkyp
sɑntrɑlHn	sɑntrɑlin	sɑntrɑlɯn
sɑtHʃHn	sɑtiʃin	sɑtɯʃɯn
sɑtHʃHHn	sɑtiʃiin	sɑtɯʃɯɯn
sɑvɑʃlArA	sɑvɑʃlere	sɑvɑʃlɑrɑ
seʧDHkDAn	seʧdiktɑn	seʧtikten
stɑndɑrtDA	stɑndɑrtte	stɑndɑrttɑ
tɑbiɑtDA	tɑbiɑtte	tɑbiɑttɑ
tɑhɑmmylH	tɑhɑmmyli	tɑhɑmmyly
tedɑvilArDA	tedɑvilerdɑ	tedɑvilerde
tozlAr	tozler	tozlɑr
ujduHn	ujduin	ujduun
jønetimsAl	jønetimsɑl	jønetimsel
jɑsɑDAn	jɑsɑden	jɑsɑdɑn
jolʤulukDA	jolʤulukte	jolʤuluktɑ
jorgunlHkDAn	jorgunliktɑn	jorgunluktɑn
zɑmɑnlArDAn	zɑmɑnlɑrden	zɑmɑnlɑrdɑn
ølHnʤA	ølinʤe	ølynʤe
ønderlArH	ønderlɑrɯ	ønderleri
øzyrlylHk	øzyrlylik	øzyrlylyk
ʃeritlAr	ʃeritlɑr	ʃeritler
yniversitelArDAki	yniversitelerdɑki	yniversitelerdeki
yretimDAki	yretimdɑki	yretimdeki
ɑnlɑjɯʃmHz	ɑnlɑjɯʃmiz	ɑnlɑjɯʃmɯz
ɑtmosferDAki	ɑtmosferdɑki	ɑtmosferdeki
ɑjɯnDAki	ɑjɯnteki	ɑjɯndɑki
byltenDA	byltendɑ	byltende
bɑʃkɑnlHkʧA	bɑʃkɑnlikʧe	bɑʃkɑnlɯkʧɑ
bildirmAA	bildirmɑɑ	bildirmee
bilginHzA	bilginizɑ	bilginize
bozuklHklArHHn	bozuklikleriin	bozukluklɑrɯɯn
brɑnʃlArDA	brɑnʃlerdɑ	brɑnʃlɑrdɑ
bulunmAmADA	bulunmɑmɑde	bulunmɑmɑtɑ
bujAnA	bujene	bujɑnɑ
dønyʃymHn	dønyʃymin	dønyʃymyn
dørtlH	dørtli	dørtly
demokrɑsiDAn	demokrɑsitɑn	demokrɑsiden
dikmA	dikmɑ	dikme
eɰitimsAl	eɰitimsɑl	eɰitimsel
eksiklAr	eksiklɑr	eksikler
erlAr	erlɑr	erler
etkiDA	etkite	etkide
fikirlArA	fikirlɑrɑ	fikirlere
formlArA	formlere	formlɑrɑ
formlArDA	formlerdɑ	formlɑrdɑ
gøtyrmAA	gøtyrmɑɑ	gøtyrmee
gylmAA	gylmɑɑ	gylmee
gyzergɑhH	gyzergɑhi	gyzergɑhɯ
geliʃmADA	geliʃmɑde	geliʃmede
gereʧlArHn	gereʧlɑrɯn	gereʧlerin
gezmAA	gezmɑɑ	gezmee
gitmAlArH	gitmɑlɑrɯ	gitmeleri
globɑllAʃAn	globɑllɑʃɑn	globɑlleʃen
hɑberleʃmAHn	hɑberleʃmɑɯn	hɑberleʃmein
hɑstɑlɯksHz	hɑstɑlɯksiz	hɑstɑlɯksɯz
hɑzɯrlɯksHz	hɑzɯrlɯksiz	hɑzɯrlɯksɯz
husulA	husulɑ	husule
ihɑleDA	ihɑlete	ihɑlede
ikɑmetgɑhH	ikɑmetgɑhi	ikɑmetgɑhɯ
iklimA	iklimɑ	iklime
kɯlɑvuzlArH	kɯlɑvuzleri	kɯlɑvuzlɑrɯ
køʃeDAki	køʃeteki	køʃedeki
kytyphɑnemHzA	kytyphɑnemizɑ	kytyphɑnemize
kɑmpʧHlHk	kɑmpʧilik	kɑmpʧɯlɯk
kɑjnɑkDA	kɑjnɑkte	kɑjnɑktɑ
kesinlAʃmAH	kesinlɑʃmɑɯ	kesinleʃmei
koʃullArDAn	koʃullɑrden	koʃullɑrdɑn
kopHp	kopip	kopup
koruAbilmA	koruɑbilmɑ	koruɑbilme
mykelleflAr	mykelleflɑr	mykellefler
mɑɑʃlArH	mɑɑʃleri	mɑɑʃlɑrɯ
meslektɑʃlArm	meslektɑʃlerm	meslektɑʃlɑrm
noterlAr	noterlɑr	noterler
okullArmHzHn	okullɑrmizin	okullɑrmɯzɯn
ojlArDA	ojlerdɑ	ojlɑrdɑ
ojunHHn	ojuniin	ojunuun
pɑrʧɑlArDAn	pɑrʧɑlɑrden	pɑrʧɑlɑrdɑn
penʤereDAki	penʤereteki	penʤeredeki
puɑnlArHHn	puɑnleriin	puɑnlɑrɯɯn
søjlemADAn	søjlemeden	søjlemeten
sɑnɯklArDAn	sɑnɯklɑrden	sɑnɯklɑrdɑn
seferlAr	seferlɑr	seferler
serbestlAʃmA	serbestlɑʃmɑ	serbestleʃme
sorumlulHklArHHn	sorumlulikleriin	sorumluluklɑrɯɯn
tørenlArDA	tørenlɑrdɑ	tørenlerde
tyfA	tyfɑ	tyfe
tɑrɑfnHzDAn	tɑrɑfnizden	tɑrɑfnɯzdɑn
tɑtbikɑtH	tɑtbikɑtu	tɑtbikɑtɯ
tebliɰlArH	tebliɰlɑrɯ	tebliɰleri
tehlikeDA	tehlikete	tehlikede
telefonnHzDAn	telefonnɯzden	telefonnuzdɑn
tiplArDA	tiplɑrdɑ	tiplerde
toplɑDHklArH	toplɑtiklɑrɯ	toplɑdɯklɑrɯ
tozlArH	tozleri	tozlɑrɯ
ujgulɑmɑDAki	ujgulɑmɑtɑki	ujgulɑmɑdɑki
jønetimlArDA	jønetimlerdɑ	jønetimlerde
jønetmeliklArDA	jønetmeliklɑrdɑ	jønetmeliklerde
jyklAnAʤAk	jyklɑnɑʤɑk	jykleneʤek
jɑʃɑmmHzDA	jɑʃɑmmizde	jɑʃɑmmɯzdɑ
jɑsɑlArHHn	jɑsɑleriin	jɑsɑlɑrɯɯn
jɑtɯrɯmlArDAn	jɑtɯrɯmlerden	jɑtɯrɯmlɑrdɑn
jerleʃimA	jerleʃimɑ	jerleʃime
jeteneklArHn	jeteneklɑrɯn	jeteneklerin
zɑrɑrlArHHn	zɑrɑrleriin	zɑrɑrlɑrɯɯn
zorlHklArHn	zorliklɑrɯn	zorluklɑrɯn
ʧøkHʃH	ʧøkiʃi	ʧøkyʃy
ʧyrymAA	ʧyrymɑɑ	ʧyrymee
ʧɑlɯʃɑnlArmHzA	ʧɑlɯʃɑnlɑrmizɑ	ʧɑlɯʃɑnlɑrmɯzɑ
ʧiʧeklAnmA	ʧiʧeklɑnmɑ	ʧiʧeklenme
ʧoʤuklArDAki	ʧoʤuklɑrtɑki	ʧoʤuklɑrdɑki
ølmADAn	ølmɑden	ølmeden
ønHHn	øniin	ønyyn
øzgyrlHkʧH	øzgyrlikʧu	øzgyrlykʧy
ʃɑirlArH	ʃɑirlɑrɯ	ʃɑirleri
ɑʧɯklArHHn	ɑʧɯkleriin	ɑʧɯklɑrɯɯn
ɑʧɯmHzDAn	ɑʧɯmɯzden	ɑʧɯmɯzdɑn
ɑɰɑʧlArHHn	ɑɰɑʧleriin	ɑɰɑʧlɑrɯɯn
ɑksɑklHklArn	ɑksɑkliklern	ɑksɑklɯklɑrn
ɑntenlAr	ɑntenlɑr	ɑntenler
ɑtɯlɯmlAr	ɑtɯlɯmler	ɑtɯlɯmlɑr
ɑjɯrHp	ɑjɯrup	ɑjɯrɯp
bɑʃvurAnA	bɑʃvurene	bɑʃvurɑnɑ
bilgisɑjɑrDAki	bilgisɑjɑrtɑki	bilgisɑjɑrdɑki
bozuklHklArA	bozukliklɑrɑ	bozukluklɑrɑ
broʃyrH	broʃyri	broʃyry
bulutlH	bulutli	bulutlu
ʤɑmlH	ʤɑmli	ʤɑmlɯ
ʤɑzHn	ʤɑzin	ʤɑzɯn
ʤebirsAl	ʤebirsɑl	ʤebirsel
døkymHn	døkymin	døkymyn
døkArAk	døkɑrɑk	døkerek
dɑvrɑnHʃlArDAn	dɑvrɑniʃlerden	dɑvrɑnɯʃlɑrdɑn
denejlArDA	denejlerdɑ	denejlerde
depremlArDA	depremlerdɑ	depremlerde
direktiflAr	direktiflɑr	direktifler
dostlArmHz	dostlermiz	dostlɑrmɯz
eɰitimlArDA	eɰitimlerdɑ	eɰitimlerde
edinDHklArH	edindiklɑrɯ	edindikleri
ekimDA	ekimdɑ	ekimde
ekrɑnlH	ekrɑnli	ekrɑnlɯ
eriʃmA	eriʃmɑ	eriʃme
erimAH	erimɑɯ	erimei
etmAArAk	etmɑɑrɑk	etmeerek
finɑlA	finɑlɑ	finɑle
fonlArHHn	fonleriin	fonlɑrɯɯn
fotoɰrɑfHHn	fotoɰrɑfiin	fotoɰrɑfɯɯn
frenlAr	frenlɑr	frenler
geʧmADHkʧA	geʧmetikʧe	geʧmedikʧe
gelAbilmAH	gelɑbilmɑɯ	gelebilmei
girAlHm	girɑlim	girelim
girmADAn	girmɑden	girmeten
gitDHkDAn	gittiktɑn	gittikten
hɑberleʃmAA	hɑberleʃmɑɑ	hɑberleʃmee
iʃlAnArAk	iʃlɑnɑrɑk	iʃlenerek
ilmHzA	ilmyze	ilmize
kɑdɯnlArHHn	kɑdɯnleriin	kɑdɯnlɑrɯɯn
kɑdɑrlHk	kɑdɑrlik	kɑdɑrlɯk
kɑrɑkolDA	kɑrɑkolde	kɑrɑkoldɑ
kɑtɯnDAki	kɑtɯnteki	kɑtɯndɑki
kesmAA	kesmɑɑ	kesmee
kliniklArH	kliniklɑrɯ	klinikleri
konuʃmAlArDAn	konuʃmɑlɑrden	konuʃmɑlɑrdɑn
mɑsɑʒH	mɑsɑʒi	mɑsɑʒɯ
mɑsrɑflArHHn	mɑsrɑfleriin	mɑsrɑflɑrɯɯn
merdivenlArH	merdivenlɑrɯ	merdivenleri
mesɑʒlArA	mesɑʒlere	mesɑʒlɑrɑ
miniklAr	miniklɑr	minikler
okumADAn	okumɑden	okumɑdɑn
olDHklArHHn	oldikleriin	olduklɑrɯɯn
olmAmHzA	olmɑmyze	olmɑmɯzɑ
oluʃumlArHn	oluʃumlerin	oluʃumlɑrɯn
orgɑnizɑsjonHHn	orgɑnizɑsjoniin	orgɑnizɑsjonuun
otomobillArHn	otomobillɑrɯn	otomobillerin
pɑrɑgrɑfH	pɑrɑgrɑfi	pɑrɑgrɑfɯ
pɑrlɑHʤH	pɑrlɑiʤi	pɑrlɑɯʤɯ
pilɑvH	pilɑvi	pilɑvɯ
pillArH	pillɑrɯ	pilleri
portføjA	portføjɑ	portføje
profesørlHk	profesørlik	profesørlyk
protokolHHn	protokoliin	protokolyyn
rɑkɑmlArHHn	rɑkɑmleriin	rɑkɑmlɑrɯɯn
syreʧDAn	syreʧtɑn	syreʧten
sɑhɑDAki	sɑhɑtɑki	sɑhɑdɑki
sɑhɑlArHHn	sɑhɑleriin	sɑhɑlɑrɯɯn
sɑlonHHn	sɑloniin	sɑlonuun
sejɑhɑtH	sejɑhɑtu	sejɑhɑti
sorHnʤA	sorinʤe	sorunʤɑ
sorunlArmHzH	sorunlɑrmizi	sorunlɑrmɯzɯ
suʧlHlArHn	suʧlilerin	suʧlulɑrɯn
tɑsɑrrufDA	tɑsɑrrufdɑ	tɑsɑrruftɑ
teʃekkyllH	teʃekkylli	teʃekkylly
tebliɰDA	tebliɰdɑ	tebliɰde
tebligɑtH	tebligɑtu	tebligɑtɯ
tulumH	tulumɯ	tulumu
tutmADA	tutmɑde	tutmɑtɑ
jɯllArHHn	jɯlleriin	jɯllɑrɯɯn
jønelmA	jønelmɑ	jønelme
jyklAnmA	jyklɑnmɑ	jyklenme
jɑʃɑmmHzA	jɑʃɑmmyze	jɑʃɑmmɯzɑ
jetinmAHp	jetinmɑɯp	jetinmeip
jolluksHz	jolluksiz	jolluksuz
zɑrfHn	zɑrfin	zɑrfɯn
zeminlArHn	zeminlɑrɯn	zeminlerin
zinʤirlArH	zinʤirlɑrɯ	zinʤirleri
ʧoklHk	ʧoklik	ʧokluk
ʧubuklH	ʧubukli	ʧubuklu
ørgytlAnmAlArH	ørgytlɑnmɑlɑrɯ	ørgytlenmeleri
ʃokH	ʃoki	ʃoku
ʃuurlH	ʃuurli	ʃuurlu
ɑrkɑdɑʃlArnHzA	ɑrkɑdɑʃlernizɑ	ɑrkɑdɑʃlɑrnɯzɑ
ɑrterlAr	ɑrterlɑr	ɑrterler
ɑtɑlArmHz	ɑtɑlɑrmiz	ɑtɑlɑrmɯz
bɑʃvurunHzH	bɑʃvurunizi	bɑʃvurunuzu
bɑnkɑmHzA	bɑnkɑmyze	bɑnkɑmɯzɑ
bɑsɯnʧDA	bɑsɯnʧdɑ	bɑsɯnʧtɑ
bilgilAnmA	bilgilenmɑ	bilgilenme
birliklArA	birliklɑrɑ	birliklere
bulmAnHz	bulmɑniz	bulmɑnɯz
ʤɑmlArHn	ʤɑmlerin	ʤɑmlɑrɯn
ʤemɑɑtH	ʤemɑɑtu	ʤemɑɑti
ʤevherlArH	ʤevherlɑrɯ	ʤevherleri
dyɰynlArDA	dyɰynlɑrdɑ	dyɰynlerde
dyʃHʃlAr	dyʃiʃler	dyʃyʃler
dyzeltmAlArH	dyzeltmɑlɑrɯ	dyzeltmeleri
dɑnslArH	dɑnsleri	dɑnslɑrɯ
deɰiʃmAHn	deɰiʃmɑɯn	deɰiʃmein
demirbɑʃlArHn	demirbɑʃlerin	demirbɑʃlɑrɯn
derlemAlAr	derlemɑlɑr	derlemeler
dernekDAn	dernektɑn	dernekten
devletlArDAn	devletlɑrden	devletlerden
dinlenmAA	dinlenmɑɑ	dinlenmee
editørDAn	editørtɑn	editørden
erenlAr	erenlɑr	erenler
fɯkrɑDAki	fɯkrɑtɑki	fɯkrɑdɑki
fiksA	fiksɑ	fikse
frekɑnsDA	frekɑnste	frekɑnstɑ
gøzetAn	gøzetɑn	gøzeten
gøzlArDAn	gøzlɑrden	gøzlerden
geʧHʃlH	geʧiʃlɯ	geʧiʃli
gelmAHHn	gelmɑɯɯn	gelmeiin
hɑlklArHHn	hɑlkleriin	hɑlklɑrɯɯn
hɑreketlArDAn	hɑreketlɑrden	hɑreketlerden
hɑjɑtlArHHn	hɑjɑtleriin	hɑjɑtlɑrɯɯn
hɑjvɑnlArHHn	hɑjvɑnleriin	hɑjvɑnlɑrɯɯn
iʧerDHklArH	iʧerdiklɑrɯ	iʧerdikleri
imɑlH	imɑlɯ	imɑli
inʃɑɑtHHn	inʃɑɑtiin	inʃɑɑtɯɯn
ispɑtH	ispɑtu	ispɑtɯ
kɑdɑstroH	kɑdɑstroi	kɑdɑstrou
kɑjɯtlArDAn	kɑjɯtlɑrden	kɑjɯtlɑrdɑn
kɑjɯtDA	kɑjɯtte	kɑjɯttɑ
kollArHHn	kolleriin	kollɑrɯɯn
kongrelArDA	kongrelerdɑ	kongrelerde
konserlArH	konserlɑrɯ	konserleri
kullAnHʤHDAn	kullɑnɯʤiden	kullɑnɯʤɯdɑn
kursDA	kurste	kurstɑ
listelAnAn	listelɑnɑn	listelenen
mɑkbuzlAr	mɑkbuzler	mɑkbuzlɑr
mɑlzemelArDA	mɑlzemelerdɑ	mɑlzemelerde
mesɑʒlArnHzH	mesɑʒlernizi	mesɑʒlɑrnɯzɯ
oluʃmADAn	oluʃmɑden	oluʃmɑdɑn
onɑjlAAn	onɑjleen	onɑjlɑɑn
ordulArHHn	orduleriin	ordulɑrɯɯn
otellArHn	otellɑrɯn	otellerin
potɑnsijellAr	potɑnsijellɑr	potɑnsijeller
ryzgɑrDAn	ryzgɑrden	ryzgɑrdɑn
søjlemAH	søjlemɑɯ	søjlemei
sɑnɑtʧHlArA	sɑnɑtʧilere	sɑnɑtʧɯlɑrɑ
sɑrfijɑtH	sɑrfijɑtu	sɑrfijɑtɯ
sɑtHʃlArHHn	sɑtiʃleriin	sɑtɯʃlɑrɯɯn
sɑtHʃDA	sɑtuʃdɑ	sɑtɯʃtɑ
sɑtɯrDAki	sɑtɯrtɑki	sɑtɯrdɑki
sɑjfɑlArDAn	sɑjfɑlɑrden	sɑjfɑlɑrdɑn
sektørlArDAki	sektørlɑrtɑki	sektørlerdeki
servislArDA	servislerdɑ	servislerde
sorunlArnHzH	sorunlernizi	sorunlɑrnɯzɯ
stɑndDA	stɑndde	stɑnddɑ
tɑkvimA	tɑkvimɑ	tɑkvime
tɑleplArA	tɑleplɑrɑ	tɑleplere
tɑmɑmlɑnmADAn	tɑmɑmlɑnmɑden	tɑmɑmlɑnmɑdɑn
tɑsɑrɯmDAn	tɑsɑrɯmden	tɑsɑrɯmdɑn
tɑsɑrɯmlArHn	tɑsɑrɯmlerin	tɑsɑrɯmlɑrɯn
tɑslɑkDA	tɑslɑkte	tɑslɑktɑ
tekneDA	teknete	teknede
tekrɑrDAn	tekrɑrden	tekrɑrdɑn
temellArA	temellɑrɑ	temellere
trɑnsferlArH	trɑnsferlɑrɯ	trɑnsferleri
vermAnHzH	vermɑnizi	vermenizi
virysHHn	virysiin	virysyyn
jɑpmAksHzHn	jɑpmɑksizin	jɑpmɑksɯzɯn
jɑrdɯmlArDAn	jɑrdɯmlerden	jɑrdɯmlɑrdɑn
jolmHzA	jolmyze	jolmuzɑ
ʧøzynyrlyklH	ʧøzynyrlykli	ʧøzynyrlykly
ʧizimDA	ʧizimdɑ	ʧizimde
øɰretmenlArDAn	øɰretmenlɑrden	øɰretmenlerden
ønmA	ønmɑ	ønme
ʃeflArH	ʃeflɑrɯ	ʃefleri
ʃiirDA	ʃiirdɑ	ʃiirde
ɑʃɯHHn	ɑʃɯiin	ɑʃɯɯɯn
ɑʃɑɰɯlAHʤH	ɑʃɑɰɯleiʤi	ɑʃɑɰɯlɑɯʤɯ
ɑdɯmDAn	ɑdɯmden	ɑdɯmdɑn
ɑltlHk	ɑltlik	ɑltlɯk
ɑrɑDHklArH	ɑrɑtiklɑrɯ	ɑrɑdɯklɑrɯ
ɑskerlArA	ɑskerlɑrɑ	ɑskerlere
ɑvukɑtlArHHn	ɑvukɑtleriin	ɑvukɑtlɑrɯɯn
byroHn	byroin	byroun
bɑɰɯʃDA	bɑɰɯʃdɑ	bɑɰɯʃtɑ
benzerlHklArH	benzerliklɑrɯ	benzerlikleri
bizlerDA	bizlerdɑ	bizlerde
ʤevɑplAmAnHzDAn	ʤevɑplɑmɑnɯzden	ʤevɑplɑmɑnɯzdɑn
dønmAH	dønmɑɯ	dønmei
dyʃmADAn	dyʃmɑden	dyʃmeden
dyzenlemADA	dyzenlemete	dyzenlemede
deɰerlendirmAlArHn	deɰerlendirmɑlɑrɯn	deɰerlendirmelerin
detɑjlArA	detɑjlere	detɑjlɑrɑ
dinlenmAH	dinlenmɑɯ	dinlenmei
dujgulArmH	dujgulɑrmi	dujgulɑrmɯ
dujgulArHHn	dujguleriin	dujgulɑrɯɯn
eklemAlAr	eklemɑlɑr	eklemeler
enerʒiDA	enerʒite	enerʒide
filoH	filoi	filou
fotoɰrɑfʧHlArH	fotoɰrɑfʧileri	fotoɰrɑfʧɯlɑrɯ
fotoɰrɑfʧHlArHn	fotoɰrɑfʧilerin	fotoɰrɑfʧɯlɑrɯn
geʧirmADA	geʧirmɑde	geʧirmete
germA	germɑ	germe
hesɑplAmADA	hesɑplɑmɑde	hesɑplɑmɑdɑ
hoʃA	hoʃe	hoʃɑ
iʃgɑlA	iʃgɑlɑ	iʃgɑle
ihmɑlH	ihmɑlɯ	ihmɑli
inɑtʧH	inɑtʧi	inɑtʧɯ
kɯsɑsH	kɯsɑsi	kɯsɑsɯ
kɑmpHn	kɑmpin	kɑmpɯn
kɑrɯʃɯklHklAr	kɑrɯʃɯkliklɑr	kɑrɯʃɯklɯklɑr
kɑrɑrgɑhH	kɑrɑrgɑhi	kɑrɑrgɑhɯ
kɑrtlArA	kɑrtlere	kɑrtlɑrɑ
kɑtɑloglArH	kɑtɑlogleri	kɑtɑloglɑrɯ
kesilmA	kesilmɑ	kesilme
killAr	killɑr	killer
komutHHn	komutiin	komutuun
kovAn	koven	kovɑn
kurumlArDAki	kurumlɑrtɑki	kurumlɑrdɑki
mɑmullAr	mɑmullɑr	mɑmuller
merɑkH	merɑki	merɑkɯ
mesɑʒnHz	mesɑʒniz	mesɑʒnɯz
metreDA	metrete	metrede
mitingDA	mitingdɑ	mitingde
okulmHzA	okulmyze	okulmuzɑ
okuHnʤA	okuinʤe	okuunʤɑ
ormɑnlArHHn	ormɑnleriin	ormɑnlɑrɯɯn
otobysHn	otobysin	otobysyn
pɑketlArHn	pɑketlɑrɯn	pɑketlerin
pɑnellArHn	pɑnellɑrɯn	pɑnellerin
pɑrsellAr	pɑrsellɑr	pɑrseller
pɑjlɑʃɯmlH	pɑjlɑʃɯmli	pɑjlɑʃɯmlɯ
rɑdjɑsjonA	rɑdjɑsjone	rɑdjɑsjonɑ
sɯkɯntɯlArDAn	sɯkɯntɯlɑrden	sɯkɯntɯlɑrdɑn
serɑmiklAr	serɑmiklɑr	serɑmikler
sigortɑlHlArHn	sigortɑlilerin	sigortɑlɯlɑrɯn
sinDA	sindɑ	sinde
sivillAr	sivillɑr	siviller
sohbetlAr	sohbetlɑr	sohbetler
sorumluHHn	sorumluiin	sorumluuun
sojɑdnHz	sojɑdniz	sojɑdnɯz
suʧlHlArH	suʧlileri	suʧlulɑrɯ
sunuʤuDAn	sunuʤutɑn	sunuʤudɑn
tymørlArHn	tymørlɑrɯn	tymørlerin
tɑʃHHn	tɑʃiin	tɑʃɯɯn
tɑʃɯtlArH	tɑʃɯtleri	tɑʃɯtlɑrɯ
tɑnɯAlHm	tɑnɯelim	tɑnɯɑlɯm
teʧhizɑtH	teʧhizɑtu	teʧhizɑtɯ
teʃekkyrlArmHzH	teʃekkyrlɑrmizi	teʃekkyrlermizi
teʃkilɑtmHz	teʃkilɑtmiz	teʃkilɑtmɯz
tellAr	tellɑr	teller
toplumlArHHn	toplumleriin	toplumlɑrɯɯn
uɰrɑDHklArH	uɰrɑtiklɑrɯ	uɰrɑdɯklɑrɯ
ulɑʃmADAn	ulɑʃmɑden	ulɑʃmɑdɑn
unsurHHn	unsuriin	unsuruun
vyʤutlArH	vyʤutleri	vyʤutlɑrɯ
vizjonA	vizjone	vizjonɑ
jyʤelAn	jyʤelɑn	jyʤelen
jyklAmAH	jyklɑmɑɯ	jyklemei
jyklAnHʤHnHn	jyklɑnɯʤɯnɯn	jykleniʤinin
jɑjgɯnlHk	jɑjgɯnlik	jɑjgɯnlɯk
jɑzɯlArDAn	jɑzɯlɑrden	jɑzɯlɑrdɑn
jorumlArA	jorumlere	jorumlɑrɑ
zɑmɑnnHzH	zɑmɑnnizi	zɑmɑnnɯzɯ
zɑtHn	zɑtin	zɑtɯn
zɑjɯflHk	zɑjɯflik	zɑjɯflɯk
ʧɯkɑrmɑDAn	ʧɯkɑrmɑden	ʧɯkɑrmɑdɑn
ʧøplArH	ʧøplɑrɯ	ʧøpleri
ʧɑɰmHz	ʧɑɰmiz	ʧɑɰmɯz
ʧiftlArHn	ʧiftlɑrɯn	ʧiftlerin
øzetlAnAn	øzetlɑnɑn	øzetlenen
ʃɑhitlAr	ʃɑhitlɑr	ʃɑhitler
ʃerhlAr	ʃerhlɑr	ʃerhler
ystlenmA	ystlenmɑ	ystlenme
ɑɰɑʧlArDAn	ɑɰɑʧlɑrden	ɑɰɑʧlɑrdɑn
ɑkʤiɰerlArA	ɑkʤiɰerlɑrɑ	ɑkʤiɰerlere
ɑrɑmAnHz	ɑrɑmɑniz	ɑrɑmɑnɯz
bɑbɑlArHHn	bɑbɑleriin	bɑbɑlɑrɯɯn
belirsizlHklAr	belirsizliklɑr	belirsizlikler
belirtmAH	belirtmɑɯ	belirtmei
bejinDAki	bejinteki	bejindeki
bildirmAnHz	bildirmɑniz	bildirmeniz
bojutlArDAki	bojutlɑrtɑki	bojutlɑrdɑki
ʤezɑDAn	ʤezɑden	ʤezɑdɑn
døngyHn	døngyin	døngyyn
dyzelmAH	dyzelmɑɯ	dyzelmei
deɰerlArmHz	deɰerlɑrmiz	deɰerlermiz
deDHkDAn	detiktɑn	dedikten
defɑDAn	defɑden	defɑdɑn
denklAr	denklɑr	denkler
desenlAr	desenlɑr	desenler
dilsAl	dilsɑl	dilsel
doktornHzHn	doktornizin	doktornuzun
eʃitsizliklAr	eʃitsizliklɑr	eʃitsizlikler
edilAmAmAH	edilemɑmɑɯ	edilememei
ellArmH	ellɑrmi	ellermi
eriʃimA	eriʃimɑ	eriʃime
fɑbrikɑmHzDA	fɑbrikɑmɯzde	fɑbrikɑmɯzdɑ
fɑktørHn	fɑktørɯn	fɑktøryn
filozofH	filozofi	filozofu
fosforlH	fosforli	fosforlu
frekɑnslArH	frekɑnsleri	frekɑnslɑrɯ
gørynyrDA	gørynyrdɑ	gørynyrde
gørmAmAH	gørmɑmɑɯ	gørmemei
gøzmHn	gøzmin	gøzmyn
gyzellHklArA	gyzelliklɑrɑ	gyzelliklere
gebelArDA	gebelerdɑ	gebelerde
geʤikAn	geʤikɑn	geʤiken
gelmAnHz	gelmɑniz	gelmeniz
gemilArDA	gemilerdɑ	gemilerde
genlAr	genlɑr	genler
gezegenlAr	gezegenlɑr	gezegenler
gezegenlArHn	gezegenlɑrɯn	gezegenlerin
giriʃlH	giriʃlɯ	giriʃli
gitmADAn	gitmɑden	gitmeten
hɑjɑtnHzHn	hɑjɑtnizin	hɑjɑtnɯzɯn
hedeflArmHz	hedeflɑrmiz	hedeflermiz
hejkellAr	hejkellɑr	hejkeller
hiʧDA	hiʧdɑ	hiʧte
hoʃʧA	hoʃʧe	hoʃʧɑ
istɑtistiklArA	istɑtistiklɑrɑ	istɑtistiklere
isteklArHn	isteklɑrɯn	isteklerin
istemDA	istemdɑ	istemde
kyltyrmHz	kyltyrmiz	kyltyrmyz
kɑnserlAr	kɑnserlɑr	kɑnserler
kɑnunsHz	kɑnunsiz	kɑnunsuz
kiʃiliklArH	kiʃiliklɑrɯ	kiʃilikleri
komisjonmHz	komisjonmyz	komisjonmuz
komutHn	komutin	komutun
koridorDA	koridortɑ	koridordɑ
kujrukDA	kujrukte	kujruktɑ
lisɑnslAr	lisɑnsler	lisɑnslɑr
mɑkɑmlArDAn	mɑkɑmlerden	mɑkɑmlɑrdɑn
numɑrɑDAn	numɑrɑden	numɑrɑdɑn
odɑmHzH	odɑmizi	odɑmɯzɯ
ortɑklH	ortɑkli	ortɑklɯ
pyryzlH	pyryzli	pyryzly
pɑzɑrDAn	pɑzɑrden	pɑzɑrdɑn
reʒimA	reʒimɑ	reʒime
ruhsɑtHn	ruhsɑtin	ruhsɑtɯn
sɯnɯrA	sɯnɯre	sɯnɯrɑ
sɯnɯrlAHʤH	sɯnɯrleiʤi	sɯnɯrlɑɯʤɯ
sɑplH	sɑpli	sɑplɯ
sɑtɯrlHk	sɑtɯrlik	sɑtɯrlɯk
sempozjumlAr	sempozjumler	sempozjumlɑr
senɑtoHHn	senɑtoiin	senɑtouun
sensørlAr	sensørlɑr	sensørler
sijɑsetDAn	sijɑsettɑn	sijɑsetten
sorumlHlAr	sorumliler	sorumlulɑr
sunuʤuHHn	sunuʤuiin	sunuʤuuun
tyzyklAr	tyzyklɑr	tyzykler
tɑɑrruzH	tɑɑrruzi	tɑɑrruzu
tɑburH	tɑburi	tɑburu
tɑvukʧHlHk	tɑvukʧilik	tɑvukʧuluk
vɑtɑndɑʃlArDAn	vɑtɑndɑʃlerden	vɑtɑndɑʃlɑrdɑn
vitɑminlArH	vitɑminlɑrɯ	vitɑminleri
jɑʃɑmnHzH	jɑʃɑmnizi	jɑʃɑmnɯzɯ
jɑklɑʃɯmlArA	jɑklɑʃɯmlere	jɑklɑʃɯmlɑrɑ
jolsuzlHklAr	jolsuzliklɑr	jolsuzluklɑr
zorunlulHklAr	zorunluliklɑr	zorunluluklɑr
ʧɯkɑrDHklArH	ʧɯkɑrdiklɑrɯ	ʧɯkɑrdɯklɑrɯ
ʧɑrlHk	ʧɑrlik	ʧɑrlɯk
ʃiirsAl	ʃiirsɑl	ʃiirsel
ʃirketmHzA	ʃirketmyze	ʃirketmize
yremAH	yremɑɯ	yremei
ɑlɑrmH	ɑlɑrmi	ɑlɑrmɯ
ɑvɑntɑʒlArA	ɑvɑntɑʒlere	ɑvɑntɑʒlɑrɑ
ɑvDAn	ɑvden	ɑvdɑn
ɑjgɯtlArH	ɑjgɯtleri	ɑjgɯtlɑrɯ
bølAn	bølɑn	bølen
byjymADA	byjymɑde	byjymete
bɑʃlɑmADA	bɑʃlɑmɑde	bɑʃlɑmɑtɑ
bɑlɯklH	bɑlɯkli	bɑlɯklɯ
bɑromHz	bɑromiz	bɑromuz
boɰHʤH	boɰuʤi	boɰuʤu
dyzlemsAl	dyzlemsɑl	dyzlemsel
deɰiʃkenlArA	deɰiʃkenlɑrɑ	deɰiʃkenlere
defterlArA	defterlɑrɑ	defterlere
devretmA	devretmɑ	devretme
dinlenDHkDAn	dinlendiktɑn	dinlendikten
edebijɑtHn	edebijɑtin	edebijɑtɯn
etydlArH	etydlɑrɯ	etydleri
etkilAnAʤAk	etkileneʤɑk	etkileneʤek
etmAksHzHn	etmɑksizin	etmeksizin
fɑjlAr	fɑjler	fɑjlɑr
formylHn	formylin	formylyn
gørynAʤAk	gøryneʤɑk	gøryneʤek
gyneʃDA	gyneʃdɑ	gyneʃte
gyzellAr	gyzellɑr	gyzeller
gerʧeklArDAn	gerʧeklɑrden	gerʧeklerden
getirAlHm	getirɑlim	getirelim
girAbilmAH	girɑbilmɑɯ	girebilmei
girHnʤAA	girinʤɑɑ	girinʤee
hɑʤimDA	hɑʤimdɑ	hɑʤimde
hɑkimA	hɑkimɑ	hɑkime
hɑlmA	hɑlmɑ	hɑlme
hususlArDAn	hususlerden	hususlɑrdɑn
iʧmAH	iʧmɑɯ	iʧmei
iʃmHzA	iʃmizɑ	iʃmize
ilʧemHzA	ilʧemizɑ	ilʧemize
ithɑlɑtHn	ithɑlɑtin	ithɑlɑtɯn
kɯsɯmlArHn	kɯsɯmlerin	kɯsɯmlɑrɯn
kɯskɑnʧlHk	kɯskɑnʧlik	kɯskɑnʧlɯk
kømyrlAr	kømyrlɑr	kømyrler
køpyklH	køpykli	køpykly
kytyphɑnelArDA	kytyphɑnelerdɑ	kytyphɑnelerde
kɑinɑtHn	kɑinɑtin	kɑinɑtɯn
kistlAr	kistlɑr	kistler
koltukDA	koltukte	koltuktɑ
kortH	kortɯ	kortu
kristɑllArH	kristɑllɑrɯ	kristɑlleri
kumHn	kumin	kumun
mylkH	mylki	mylky
mɑmulHn	mɑmulun	mɑmulyn
modyllArHn	modyllɑrɯn	modyllerin
molekylH	molekyli	molekyly
mukozɑDA	mukozɑde	mukozɑdɑ
ordumHzHn	ordumizin	ordumuzun
pɑsɑportH	pɑsɑportɯ	pɑsɑportu
posterlAr	posterlɑr	posterler
progrɑmmHzHn	progrɑmmizin	progrɑmmɯzɯn
rɑhɑtsHzlHklArH	rɑhɑtsizliklɑrɯ	rɑhɑtsɯzlɯklɑrɯ
søzmHz	søzmiz	søzmyz
sellAr	sellɑr	seller
sensørH	sensøri	sensøry
sivillArA	sivillɑrɑ	sivillere
sivillArHn	sivillɑrɯn	sivillerin
sonHHn	soniin	sonuun
sorulArmHzH	sorulɑrmizi	sorulɑrmɯzɯ
sporHHn	sporiin	sporuun
stɑtyHHn	stɑtyiin	stɑtyyyn
tɑnɯmlAArAk	tɑnɯmleerek	tɑnɯmlɑɑrɑk
teknisjenlAr	teknisjenlɑr	teknisjenler
televizjonA	televizjone	televizjonɑ
tijɑtroH	tijɑtroi	tijɑtrou
turnuvɑDA	turnuvɑde	turnuvɑdɑ
tutɑrlArHHn	tutɑrleriin	tutɑrlɑrɯɯn
tutumHn	tutumin	tutumun
uʧHʃH	uʧiʃi	uʧuʃu
jønetAnlArHn	jønetɑnlɑrɯn	jønetenlerin
jyklAnArAk	jyklɑnɑrɑk	jyklenerek
jɑʃɑmmHzHn	jɑʃɑmmizin	jɑʃɑmmɯzɯn
jɑnmDAki	jɑnmtɑki	jɑnmdɑki
jɑpɯtHn	jɑpɯtin	jɑpɯtɯn
jɑsɑklH	jɑsɑkli	jɑsɑklɯ
jɑvɑʃlAr	jɑvɑʃler	jɑvɑʃlɑr
jɑzmADAn	jɑzmeden	jɑzmɑtɑn
jemeklArDAn	jemeklɑrden	jemeklerden
zɑmɑnmHz	zɑmɑnmyz	zɑmɑnmɯz
zɑmɑnlArDAki	zɑmɑnlɑrtɑki	zɑmɑnlɑrdɑki
zehirlAnmAH	zehirlɑnmɑɯ	zehirlenmei
ʧɯkHʃHHn	ʧɯkiʃiin	ʧɯkɯʃɯɯn
ʧøkelmA	ʧøkelmɑ	ʧøkelme
øɰrenmAnHz	øɰrenmɑniz	øɰrenmeniz
øɰretmenDAn	øɰretmendɑn	øɰretmenden
ørtyHn	ørtyin	ørtyyn
ʃɑmpijonlHk	ʃɑmpijonlik	ʃɑmpijonluk
ɑhlɑkHn	ɑhlɑkin	ɑhlɑkɯn
ɑkɯmlArHn	ɑkɯmlerin	ɑkɯmlɑrɯn
ɑkʤiɰerlAr	ɑkʤiɰerlɑr	ɑkʤiɰerler
ɑktørlAr	ɑktørlɑr	ɑktørler
ɑnɑlizlArDA	ɑnɑlizlɑrdɑ	ɑnɑlizlerde
ɑnlɑʃmɑDA	ɑnlɑʃmɑde	ɑnlɑʃmɑdɑ
ɑrɑʃtɯrmɑlArHHn	ɑrɑʃtɯrmɑleriin	ɑrɑʃtɯrmɑlɑrɯɯn
ɑtDHklArH	ɑttiklɑrɯ	ɑttɯklɑrɯ
bykmA	bykmɑ	bykme
byjyklHklAr	byjykliklɑr	byjyklykler
byjyklArA	byjyklɑrɑ	byjyklere
bɑkɑnlɯkDA	bɑkɑnlɯkte	bɑkɑnlɯktɑ
bejliklAr	bejliklɑr	bejlikler
bilgisɑjɑrnHzDAki	bilgisɑjɑrnizdeki	bilgisɑjɑrnɯzdɑki
bilmADHklArH	bilmɑdɯklɑrɯ	bilmedikleri
bulHnʤA	bulunʤe	bulunʤɑ
ʤevɑpDA	ʤevɑpte	ʤevɑptɑ
dyʃHʃA	dyʃiʃe	dyʃyʃe
dyʃmAAn	dyʃmɑɑn	dyʃmeen
dyzenlemAlArDAn	dyzenlemɑlɑrden	dyzenlemelerden
dɑmɑrDAn	dɑmɑrden	dɑmɑrdɑn
delikDAn	deliktɑn	delikten
demirjoluHn	demirjoluin	demirjoluun
derinlArA	derinlɑrɑ	derinlere
eʃjɑlArHHn	eʃjɑleriin	eʃjɑlɑrɯɯn
eklArHn	eklɑrɯn	eklerin
esnɑfHHn	esnɑfiin	esnɑfɯɯn
evmHzA	evmyze	evmize
geʤikmAA	geʤikmɑɑ	geʤikmee
hɑriʧDAn	hɑriʧtɑn	hɑriʧten
hɑstɑmHzHn	hɑstɑmizin	hɑstɑmɯzɯn
huzurnHzDA	huzurnizde	huzurnuzdɑ
iʧmAAn	iʧmɑɑn	iʧmeen
ilerlemAH	ilerlemɑɯ	ilerlemei
ilklArA	ilklɑrɑ	ilklere
imtijɑzlH	imtijɑzli	imtijɑzlɯ
inʃɑɑtA	inʃɑɑte	inʃɑɑtɑ
izlemAH	izlemɑɯ	izlemei
køʃkH	køʃki	køʃky
køpryDAn	køprydɑn	køpryden
kɑlmADAn	kɑlmɑden	kɑlmɑtɑn
kɑnɯtlArn	kɑnɯtlern	kɑnɯtlɑrn
kɑrɑmsɑrlHk	kɑrɑmsɑrlik	kɑrɑmsɑrlɯk
kɑsHHn	kɑsiin	kɑsɯɯn
kolDAn	kolden	koldɑn
konutlArA	konutlere	konutlɑrɑ
kojDHklArH	kojtiklɑrɯ	kojduklɑrɯ
kojmADAn	kojmɑden	kojmɑdɑn
kuʃHn	kuʃin	kuʃun
lokɑntɑDA	lokɑntɑde	lokɑntɑdɑ
mɑlHHn	mɑliin	mɑlɯɯn
medenijetlArHn	medenijetlɑrɯn	medenijetlerin
nikA	nikɑ	nike
noterDA	noterdɑ	noterde
oʤɑklArDAn	oʤɑklɑrden	oʤɑklɑrdɑn
odɑDAki	odɑtɑki	odɑdɑki
olumsuzlHklArn	olumsuzliklern	olumsuzluklɑrn
plɑtformHHn	plɑtformiin	plɑtformuun
primA	primɑ	prime
progrɑmmHzDA	progrɑmmizde	progrɑmmɯzdɑ
reddetmA	reddetmɑ	reddetme
referɑnslArH	referɑnsleri	referɑnslɑrɯ
reklɑmlArH	reklɑmleri	reklɑmlɑrɯ
reseptørlArH	reseptørlɑrɯ	reseptørleri
ruhsɑtHHn	ruhsɑtiin	ruhsɑtɯɯn
sɑrɑjlAr	sɑrɑjler	sɑrɑjlɑr
sɑtHʃDAn	sɑtuʃden	sɑtɯʃtɑn
sɑjfɑmHzH	sɑjfɑmizi	sɑjfɑmɯzɯ
sɑjfɑnHzH	sɑjfɑnizi	sɑjfɑnɯzɯ
sebeplArA	sebeplɑrɑ	sebeplere
sektørmHz	sektørmiz	sektørmyz
siʤillArH	siʤillɑrɯ	siʤilleri
suʧsHz	suʧsiz	suʧsuz
tɑʃlHk	tɑʃlik	tɑʃlɯk
tɑʃlArDAn	tɑʃlerden	tɑʃlɑrdɑn
tɑtsHz	tɑtsiz	tɑtsɯz
tijɑtroHHn	tijɑtroiin	tijɑtrouun
toplAHʤH	topleiʤi	toplɑɯʤɯ
toprɑklArDAn	toprɑklɑrden	toprɑklɑrdɑn
tutɑrsHz	tutɑrsiz	tutɑrsɯz
ulɑʃmAnHz	ulɑʃmɑniz	ulɑʃmɑnɯz
usɑnmADAn	usɑnmɑden	usɑnmɑdɑn
usulsHz	usulsiz	usulsyz
uzɑtHp	uzɑtup	uzɑtɯp
vɑzgeʧmAH	vɑzgeʧmɑɯ	vɑzgeʧmei
jyzjɯlDAki	jyzjɯldeki	jyzjɯldɑki
jɑkHʃ	jɑkiʃ	jɑkɯʃ
jɑndɑʃlArH	jɑndɑʃleri	jɑndɑʃlɑrɯ
jɑnlɯʃlArHn	jɑnlɯʃlerin	jɑnlɯʃlɑrɯn
jijeʤeklArDAn	jijeʤeklɑrden	jijeʤeklerden
jolʤuHn	jolʤuin	jolʤuun
jumurtɑDAn	jumurtɑden	jumurtɑdɑn
ʧɑjlAr	ʧɑjler	ʧɑjlɑr
ʧekmADAn	ʧekmɑden	ʧekmeden
ʧoʤuklArnHzH	ʧoʤuklernizi	ʧoʤuklɑrnɯzɯ
ʧoʤuklHkDAn	ʧoʤukliktɑn	ʧoʤukluktɑn
ønlemADA	ønlemete	ønlemede
ørgytlAnmAA	ørgytlɑnmɑɑ	ørgytlenmee
ʃɑnsHHn	ʃɑnsiin	ʃɑnsɯɯn
ʃekillAnAn	ʃekillɑnɑn	ʃekillenen
ʃenliklAr	ʃenliklɑr	ʃenlikler
ystlenmAH	ystlenmɑɯ	ystlenmei
yzerlArH	yzerlɑrɯ	yzerleri
ɑʧɯklɑmADAn	ɑʧɯklɑmɑden	ɑʧɯklɑmɑdɑn
ɑʧɯlɯmlAr	ɑʧɯlɯmler	ɑʧɯlɯmlɑr
ɑʧDHkDAn	ɑʧdiktɑn	ɑʧtɯktɑn
ɑksɑmADAn	ɑksɑmɑden	ɑksɑmɑdɑn
ɑlɯʃveriʃDA	ɑlɯʃveriʃdɑ	ɑlɯʃveriʃte
ɑlkolsHz	ɑlkolsiz	ɑlkolsyz
ɑrɑʃtɯrmAlArDAn	ɑrɑʃtɯrmɑlɑrden	ɑrɑʃtɯrmɑlɑrdɑn
ɑtøljeDA	ɑtøljete	ɑtøljede
byjymA	byjymɑ	byjyme
bɑrɑʒlArH	bɑrɑʒleri	bɑrɑʒlɑrɯ
bulunDHkDAn	bulundiktɑn	bulunduktɑn
dyʃynmAHn	dyʃynmɑɯn	dyʃynmein
dɑɰɯtHʤHH	dɑɰɯtiʤii	dɑɰɯtɯʤɯɯ
dɑɰlArDAn	dɑɰlɑrden	dɑɰlɑrdɑn
dɑmɑrlArHHn	dɑmɑrleriin	dɑmɑrlɑrɯɯn
dɑrlHk	dɑrlik	dɑrlɯk
deɰiʃiklHklArDA	deɰiʃikliklɑrdɑ	deɰiʃikliklerde
denklArHn	denklɑrɯn	denklerin
depolArHHn	depoleriin	depolɑrɯɯn
dokulArHHn	dokuleriin	dokulɑrɯɯn
durumnHz	durumniz	durumnuz
eriʃimDA	eriʃimdɑ	eriʃimde
esɑslArHn	esɑslerin	esɑslɑrɯn
fɑbrikɑmHz	fɑbrikɑmiz	fɑbrikɑmɯz
fɑkyltemHzA	fɑkyltemizɑ	fɑkyltemize
fɑturɑDA	fɑturɑde	fɑturɑdɑ
felɑketlAr	felɑketlɑr	felɑketler
gøstermAH	gøstermɑɯ	gøstermei
gøtyrArAk	gøtyrɑrɑk	gøtyrerek
gøzmHz	gøzmiz	gøzmyz
gøzetmA	gøzetmɑ	gøzetme
geʧinAn	geʧinɑn	geʧinen
genlAʃmA	genlɑʃmɑ	genleʃme
getirAbilmAH	getirɑbilmɑɯ	getirebilmei
getirmADA	getirmɑde	getirmede
girmAHn	girmɑɯn	girmein
hɯrsɯzlAr	hɯrsɯzler	hɯrsɯzlɑr
hɑberlArDA	hɑberlɑrdɑ	hɑberlerde
hɑlkʧH	hɑlkʧu	hɑlkʧɯ
hɑllArHn	hɑllɑrɯn	hɑllerin
hɑmɑmlAr	hɑmɑmler	hɑmɑmlɑr
hɑvɑsHz	hɑvɑsiz	hɑvɑsɯz
iʧeriDAki	iʧeriteki	iʧerideki
imzɑlAmHʃ	imzɑlemiʃ	imzɑlɑmɯʃ
inʤeleDHkDAn	inʤeletiktɑn	inʤeledikten
ipekʧH	ipekʧu	ipekʧi
itirɑzHn	itirɑzin	itirɑzɯn
kyrsyDAn	kyrsytɑn	kyrsyden
kɑlAbilmA	kɑlɑbilmɑ	kɑlɑbilme
kɑnɑɑtH	kɑnɑɑtu	kɑnɑɑti
kɑsɑDA	kɑsɑde	kɑsɑdɑ
kɑtilmH	kɑtilmɯ	kɑtilmi
kɑtkɯlArDAn	kɑtkɯlɑrden	kɑtkɯlɑrdɑn
kereDA	kerete	kerede
klɑsørlAr	klɑsørlɑr	klɑsørler
konumHHn	konumiin	konumuun
kurʃunlH	kurʃunli	kurʃunlu
kurɑlHn	kurɑlin	kurɑlɯn
mɑkinelArDA	mɑkinelerdɑ	mɑkinelerde
mɑrketlArDA	mɑrketlɑrdɑ	mɑrketlerde
memeDA	memete	memede
menfɑɑtlAr	menfɑɑtlɑr	menfɑɑtler
metinlArDAn	metinlɑrden	metinlerden
mezunlArmHzHn	mezunlɑrmizin	mezunlɑrmɯzɯn
millAr	millɑr	miller
morɑlH	morɑlɯ	morɑli
olimpijɑtlArH	olimpijɑtleri	olimpijɑtlɑrɯ
olHʃHHn	oliʃiin	oluʃuun
ovɑDA	ovɑde	ovɑdɑ
ovɑlHk	ovɑlik	ovɑlɯk
pɑletlAr	pɑletlɑr	pɑletler
pɑrɑnHzH	pɑrɑnizi	pɑrɑnɯzɯ
pɑrtimHzA	pɑrtimizɑ	pɑrtimize
plɑʒH	plɑʒi	plɑʒɯ
profesørlAr	profesørlɑr	profesørler
progrɑmlArmHz	progrɑmlermiz	progrɑmlɑrmɯz
progrɑmlArDAki	progrɑmlɑrtɑki	progrɑmlɑrdɑki
rɑkɑmlArDAn	rɑkɑmlerden	rɑkɑmlɑrdɑn
reformHHn	reformiin	reformuun
rekɑbetDAn	rekɑbettɑn	rekɑbetten
renklArDAn	renklɑrden	renklerden
sɯnɯflArDAn	sɯnɯflɑrden	sɯnɯflɑrdɑn
sɑkɑllH	sɑkɑlli	sɑkɑllɯ
sɑntrɑllArHn	sɑntrɑllɑrɯn	sɑntrɑllerin
semtlArDA	semtlɑrdɑ	semtlerde
sermɑjeDAn	sermɑjetɑn	sermɑjeden
silɑhlArDAn	silɑhlɑrden	silɑhlɑrdɑn
sorunlArmHzHn	sorunlɑrmizin	sorunlɑrmɯzɯn
stɑʒA	stɑʒe	stɑʒɑ
sunmADAn	sunmɑden	sunmɑtɑn
tɑʃɯHp	tɑʃɯup	tɑʃɯɯp
tɑhtɑDAn	tɑhtɑden	tɑhtɑdɑn
tɑnɯtɯmlArH	tɑnɯtɯmleri	tɑnɯtɯmlɑrɯ
tɑrɑfmDAn	tɑrɑfmden	tɑrɑfmdɑn
tekerryrH	tekerryri	tekerryry
tuzHn	tuzin	tuzun
uʧlArHHn	uʧleriin	uʧlɑrɯɯn
ufukDA	ufukte	ufuktɑ
vektørlAr	vektørlɑr	vektørler
viryslH	virysli	virysly
jyreklArH	jyreklɑrɯ	jyrekleri
jɑʃɑmmHzH	jɑʃɑmmizi	jɑʃɑmmɯzɯ
jɑʃɑmnHzHn	jɑʃɑmnizin	jɑʃɑmnɯzɯn
jɑʃɑmADAn	jɑʃɑmɑden	jɑʃɑmɑtɑn
jɑkɯnDAki	jɑkɯnteki	jɑkɯndɑki
jɑlɯtɯmlH	jɑlɯtɯmli	jɑlɯtɯmlɯ
jɑnsHz	jɑnsiz	jɑnsɯz
jɑrɑtHp	jɑrɑtup	jɑrɑtɯp
jɑrɑtmADA	jɑrɑtmɑde	jɑrɑtmɑtɑ
jɑzlAr	jɑzler	jɑzlɑr
jemeklArDA	jemeklɑrdɑ	jemeklerde
zɑrɑrlHlArH	zɑrɑrlileri	zɑrɑrlɯlɑrɯ
ʧizmAA	ʧizmɑɑ	ʧizmee
ɯʃɯkDA	ɯʃɯkte	ɯʃɯktɑ
øɰretmenlArmHzHn	øɰretmenlɑrmizin	øɰretmenlermizin
ølʧmAA	ølʧmɑɑ	ølʧmee
ʃɑhɯslArH	ʃɑhɯsleri	ʃɑhɯslɑrɯ
yzymH	yzymɯ	yzymy
ɑksɑklHk	ɑksɑklik	ɑksɑklɯk
ɑlHnʤAA	ɑlinʤɑɑ	ɑlɯnʤɑɑ
ɑlɑʃɯmlH	ɑlɑʃɯmli	ɑlɑʃɯmlɯ
ɑntrenørlHk	ɑntrenørlik	ɑntrenørlyk
ɑrɑHʃlArA	ɑrɑiʃlere	ɑrɑɯʃlɑrɑ
ɑrmutlH	ɑrmutli	ɑrmutlu
ɑsitlArHn	ɑsitlɑrɯn	ɑsitlerin
ɑtɯmlH	ɑtɯmli	ɑtɯmlɯ
ɑvɑntɑʒlArDAn	ɑvɑntɑʒlɑrden	ɑvɑntɑʒlɑrdɑn
ɑvluHn	ɑvluin	ɑvluun
bøʤeklArH	bøʤeklɑrɯ	bøʤekleri
byroHHn	byroiin	byrouun
bɑɰlArHHn	bɑɰleriin	bɑɰlɑrɯɯn
bɑʃlɯklArHHn	bɑʃlɯkleriin	bɑʃlɯklɑrɯɯn
beledijeDA	beledijete	beledijede
benzemAAn	benzemɑɑn	benzemeen
borsɑDAki	borsɑdeki	borsɑdɑki
bulunmADAn	bulunmɑden	bulunmɑdɑn
ʤihɑzlArDAn	ʤihɑzlɑrden	ʤihɑzlɑrdɑn
dyzeltmAH	dyzeltmɑɯ	dyzeltmei
demADAn	demeden	demeten
desteklAmADA	desteklɑmɑde	desteklemete
devirlArH	devirlɑrɯ	devirleri
devrelArDA	devrelerdɑ	devrelerde
dozlArH	dozleri	dozlɑrɯ
editørHn	editørɯn	editøryn
eklemAH	eklemɑɯ	eklemei
emsɑlH	emsɑlɯ	emsɑli
eriʃkinDA	eriʃkindɑ	eriʃkinde
eriAn	eriɑn	erien
etmADHkʧA	etmetikʧe	etmedikʧe
etmAmAA	etmɑmɑɑ	etmemee
fɑbrikɑDAn	fɑbrikɑden	fɑbrikɑdɑn
fɑrksHz	fɑrksiz	fɑrksɯz
fenerlAr	fenerlɑr	fenerler
fijɑtlArDAn	fijɑtlɑrden	fijɑtlɑrdɑn
gøllArHn	gøllɑrɯn	gøllerin
gønyllAr	gønyllɑr	gønyller
gøzmHzHn	gøzmizin	gøzmyzyn
gyʧlAnAn	gyʧlɑnɑn	gyʧlenen
gɑzHHn	gɑziin	gɑzɯɯn
geʧmAnHz	geʧmɑniz	geʧmeniz
geʤelArDA	geʤelerdɑ	geʤelerde
geliʃmADAn	geliʃmɑden	geliʃmeden
genʧlArmHzA	genʧlermizɑ	genʧlermize
gereksinmAlArH	gereksinmɑlɑrɯ	gereksinmeleri
hɑreketDAn	hɑrekettɑn	hɑreketten
hɑzɯrlAmADA	hɑzɯrlɑmɑde	hɑzɯrlɑmɑdɑ
hissetmAA	hissetmɑɑ	hissetmee
iʧimDAki	iʧimdɑki	iʧimdeki
iddiɑlArHHn	iddiɑleriin	iddiɑlɑrɯɯn
ihrɑʤɑtmHz	ihrɑʤɑtmiz	ihrɑʤɑtmɯz
ikiDA	ikite	ikide
illArmHzDA	illɑrmizde	illermizde
imkɑnmHz	imkɑnmyz	imkɑnmɯz
inʤelemAlArnH	inʤelemelernɯ	inʤelemelerni
istikrɑrsHzlHk	istikrɑrsizlik	istikrɑrsɯzlɯk
izɑhH	izɑhi	izɑhɯ
kɯzlArA	kɯzlere	kɯzlɑrɑ
kɑɰɯtlArA	kɑɰɯtlere	kɑɰɯtlɑrɑ
kɑnunlArHHn	kɑnunleriin	kɑnunlɑrɯɯn
kɑpɑklArHHn	kɑpɑkleriin	kɑpɑklɑrɯɯn
kɑrɑkterDA	kɑrɑkterdɑ	kɑrɑkterde
kɑrɑrnɑmeDA	kɑrɑrnɑmete	kɑrɑrnɑmede
kɑtɯlɯmlArH	kɑtɯlɯmleri	kɑtɯlɯmlɑrɯ
kelimelArDA	kelimelerdɑ	kelimelerde
konuklArmHz	konuklɑrmiz	konuklɑrmɯz
kujumʤulHk	kujumʤulik	kujumʤuluk
mɯsɯrlH	mɯsɯrli	mɯsɯrlɯ
mydyrlyklArA	mydyrlyklɑrɑ	mydyrlyklere
mɑkbuzlArHn	mɑkbuzlerin	mɑkbuzlɑrɯn
menyHn	menyin	menyyn
merɑklHlArH	merɑklileri	merɑklɯlɑrɯ
mevʤutlArH	mevʤutleri	mevʤutlɑrɯ
niteliklArHn	niteliklɑrɯn	niteliklerin
obʒektiflAr	obʒektiflɑr	obʒektifler
okumADA	okumɑde	okumɑtɑ
okumADAn	okumɑden	okumɑtɑn
onurHHn	onuriin	onuruun
operɑtørlArA	operɑtørlɑrɑ	operɑtørlere
ortɑklArDAn	ortɑklɑrden	ortɑklɑrdɑn
oturumlArH	oturumleri	oturumlɑrɯ
pɑjlH	pɑjli	pɑjlɯ
petrolH	petrolu	petroly
politikɑDAn	politikɑden	politikɑdɑn
portføjHHn	portføjiin	portføjyyn
reklɑmlArDA	reklɑmlerdɑ	reklɑmlɑrdɑ
sytunlH	sytunli	sytunlu
sɑflHk	sɑflik	sɑflɯk
sɑhɑDAn	sɑhɑtɑn	sɑhɑdɑn
sɑjfɑlArmHz	sɑjfɑlɑrmiz	sɑjfɑlɑrmɯz
seɑnsDA	seɑnste	seɑnstɑ
sevDHklArnHzA	sevdiklernizɑ	sevdiklernize
sorumlHlArHHn	sorumlileriin	sorumlulɑrɯɯn
sponsorlHk	sponsorlik	sponsorluk
tyketimDA	tyketimdɑ	tyketimde
tɑlimɑtHn	tɑlimɑtin	tɑlimɑtɯn
tɑlimɑtA	tɑlimɑte	tɑlimɑtɑ
tɑrɑHʤHH	tɑrɑiʤii	tɑrɑɯʤɯɯ
teʃebbysHn	teʃebbysin	teʃebbysyn
teʃkilɑtlArH	teʃkilɑtleri	teʃkilɑtlɑrɯ
tiʤɑretDAn	tiʤɑrettɑn	tiʤɑretten
ulɑʃmAmHz	ulɑʃmemiz	ulɑʃmɑmɯz
vɑrsɑjAlHm	vɑrsɑjɑlim	vɑrsɑjɑlɯm
jɯldɯzlArA	jɯldɯzlere	jɯldɯzlɑrɑ
jønelmA	jønelmɑ	jønelme
jɑkɯtlH	jɑkɯtli	jɑkɯtlɯ
jɑpmADA	jɑpmɑde	jɑpmɑdɑ
jɑrHn	jɑrɯn	jɑrin
jɑtkɯnlHk	jɑtkɯnlik	jɑtkɯnlɯk
jerleʃmAA	jerleʃmɑɑ	jerleʃmee
ʧekiʃmAlH	ʧekiʃmɑlɯ	ʧekiʃmeli
ølʧymlArDA	ølʧymlerdɑ	ølʧymlerde
ølyHn	ølyin	ølyyn
ølAnlArA	ølɑnlɑrɑ	ølenlere
ʃuHn	ʃuin	ʃuun
yʤretDAn	yʤrettɑn	yʤretten
yjelHklAr	yjeliklɑr	yjelikler
ɑʃɑmɑlArHHn	ɑʃɑmɑleriin	ɑʃɑmɑlɑrɯɯn
ɑkʤiɰerlArDA	ɑkʤiɰerlɑrdɑ	ɑkʤiɰerlerde
ɑnlɑmAmHz	ɑnlɑmemiz	ɑnlɑmɑmɯz
ɑnlɑtmADA	ɑnlɑtmɑde	ɑnlɑtmɑtɑ
ɑrkɑDAki	ɑrkɑtɑki	ɑrkɑdɑki
bølymmHzHn	bølymmizin	bølymmyzyn
bølgemHzA	bølgemizɑ	bølgemize
bytynlAʃAn	bytynlɑʃɑn	bytynleʃen
byjyklArmHz	byjyklɑrmiz	byjyklermiz
belirleDHklArH	belirletiklɑrɯ	belirledikleri
belirleDHkDAn	belirletiktɑn	belirledikten
biʧmA	biʧmɑ	biʧme
bilɑnʧoHn	bilɑnʧoin	bilɑnʧoun
bilmADA	bilmɑde	bilmete
birikmAH	birikmɑɯ	birikmei
bitmA	bitmɑ	bitme
ʤivɑrDAki	ʤivɑrtɑki	ʤivɑrdɑki
dyɰynH	dyɰyni	dyɰyny
dyzeltmAH	dyzeltmɑɯ	dyzeltmei
dyzenlemAlArnH	dyzenlemelernɯ	dyzenlemelerni
demokrɑsiDA	demokrɑsite	demokrɑside
desteklArHn	desteklɑrɯn	desteklerin
dostlArm	dostlerm	dostlɑrm
dozlAr	dozler	dozlɑr
duvɑrDAki	duvɑrtɑki	duvɑrdɑki
ebevejnlAr	ebevejnlɑr	ebevejnler
enfeksijonlArHHn	enfeksijonleriin	enfeksijonlɑrɯɯn
erDHkDAn	erdiktɑn	erdikten
etmAnHzA	etmɑnɯzɑ	etmenize
federɑsjonA	federɑsjone	federɑsjonɑ
gøklArDA	gøklɑrdɑ	gøklerde
gøllArDA	gøllɑrdɑ	gøllerde
gørynmA	gørynmɑ	gørynme
gyʧlyklArA	gyʧlyklɑrɑ	gyʧlyklere
geʧirmAlArH	geʧirmɑlɑrɯ	geʧirmeleri
geleʤekDAn	geleʤektɑn	geleʤekten
girmAmAH	girmɑmɑɯ	girmemei
hɑkʧA	hɑkʧe	hɑkʧɑ
hɑvuzDA	hɑvuzde	hɑvuzdɑ
hɑzɯrlAHʤH	hɑzɯrleiʤi	hɑzɯrlɑɯʤɯ
hedefmHzA	hedefmyze	hedefmize
hemʃehrilArmHzA	hemʃehrilermizɑ	hemʃehrilermize
hejkellArH	hejkellɑrɯ	hejkelleri
iʧAnlArHn	iʧɑnlɑrɯn	iʧenlerin
istemADHklArH	istemetiklɑrɯ	istemedikleri
istemAArAk	istemɑɑrɑk	istemeerek
ithɑlɑtHHn	ithɑlɑtiin	ithɑlɑtɯɯn
izleDHklArH	izletiklɑrɯ	izledikleri
kɯrHp	kɯrup	kɯrɯp
kyresAllAʃmAH	kyresellɑʃmɑɯ	kyreselleʃmei
kɑrʃɯlɑʃHnʤA	kɑrʃɯlɑʃinʤe	kɑrʃɯlɑʃɯnʤɑ
kɑtɯlɯmʤɯlArHHn	kɑtɯlɯmʤɯleriin	kɑtɯlɯmʤɯlɑrɯɯn
kɑtHp	kɑtup	kɑtɯp
kɑjbetDHklArH	kɑjbettiklɑrɯ	kɑjbettikleri
kɑjmɑkɑmlAr	kɑjmɑkɑmler	kɑjmɑkɑmlɑr
kenɑrlH	kenɑrli	kenɑrlɯ
komiteDA	komitete	komitede
konferɑnslArDA	konferɑnslerdɑ	konferɑnslɑrdɑ
konumDAki	konumtɑki	konumdɑki
kuʃʧH	kuʃʧɯ	kuʃʧu
kurslArHHn	kursleriin	kurslɑrɯɯn
kurummHzHn	kurummizin	kurummuzun
listelAnAʤAk	listeleneʤɑk	listeleneʤek
myhyrlH	myhyrli	myhyrly
mekɑnlArDAn	mekɑnlɑrden	mekɑnlɑrdɑn
merkezlArDAn	merkezlɑrden	merkezlerden
mesɑfelArDA	mesɑfelerdɑ	mesɑfelerde
metodlArHHn	metodleriin	metodlɑrɯɯn
metodHHn	metodiin	metoduun
nehirlArH	nehirlɑrɯ	nehirleri
oɰuzlAr	oɰuzler	oɰuzlɑr
oksitlAr	oksitlɑr	oksitler
okumAnHzH	okumɑnizi	okumɑnɯzɯ
okjɑnusH	okjɑnusi	okjɑnusu
olAbilmAnHn	olɑbilmɑnɯn	olɑbilmenin
olgulArHHn	olguleriin	olgulɑrɯɯn
olmAmHzH	olmemizi	olmɑmɯzɯ
olurH	oluri	oluru
ortɑlɑmɑlArHHn	ortɑlɑmɑleriin	ortɑlɑmɑlɑrɯɯn
pɑrtikyllAr	pɑrtikyllɑr	pɑrtikyller
piʃmA	piʃmɑ	piʃme
pilotHn	pilotin	pilotun
plɑnlAmADA	plɑnlɑmɑde	plɑnlɑmɑdɑ
prensiplArA	prensiplɑrɑ	prensiplere
proʒeDAki	proʒeteki	proʒedeki
purolHk	purolik	puroluk
rɑportørlHk	rɑportørlik	rɑportørlyk
rezistɑnsH	rezistɑnsi	rezistɑnsɯ
søzlArDAn	søzlɑrden	søzlerden
syrmAA	syrmɑɑ	syrmee
sɑldɯrgɑnlHk	sɑldɯrgɑnlik	sɑldɯrgɑnlɯk
sɑnɑjiDAki	sɑnɑjiteki	sɑnɑjideki
sigortɑDAn	sigortɑden	sigortɑdɑn
sigortɑlHlAr	sigortɑliler	sigortɑlɯlɑr
sorunnHz	sorunniz	sorunnuz
sosjɑlizmH	sosjɑlizmɯ	sosjɑlizmi
stresDAn	strestɑn	stresten
suʧlHH	suʧlii	suʧluu
tyjH	tyji	tyjy
tɑʃɯnmɑzlAr	tɑʃɯnmɑzler	tɑʃɯnmɑzlɑr
tɑbɑkɑDA	tɑbɑkɑde	tɑbɑkɑdɑ
tɑhlillAr	tɑhlillɑr	tɑhliller
tɑnɯmlArHHn	tɑnɯmleriin	tɑnɯmlɑrɯɯn
tɑrɯmDAn	tɑrɯmden	tɑrɯmdɑn
teʤɑvyzHn	teʤɑvyzin	teʤɑvyzyn
telgrɑfDA	telgrɑfte	telgrɑftɑ
temizlAnAn	temizlɑnɑn	temizlenen
tepkimA	tepkimɑ	tepkime
uzɑDHkʧA	uzɑdɯkʧe	uzɑdɯkʧɑ
uzɑjlAr	uzɑjler	uzɑjlɑr
vermAm	vermɑm	vermem
jøntemlArDA	jøntemlerdɑ	jøntemlerde
jynlH	jynli	jynly
jyrymADA	jyrymɑde	jyrymete
jɑʃɑHʃ	jɑʃɑiʃ	jɑʃɑɯʃ
jɑpHnʤA	jɑpɯnʤe	jɑpɯnʤɑ
jɑrɯʃlAr	jɑrɯʃler	jɑrɯʃlɑr
jɑtmADAn	jɑtmɑden	jɑtmɑdɑn
jɑzɯlɯmlArA	jɑzɯlɯmlere	jɑzɯlɯmlɑrɑ
jɑzɯlArHHn	jɑzɯleriin	jɑzɯlɑrɯɯn
jɑzɯmHzHn	jɑzɯmizin	jɑzɯmɯzɯn
ʧɯkHʃHn	ʧɯkiʃin	ʧɯkɯʃɯn
ʧɯkDHklArH	ʧɯktiklɑrɯ	ʧɯktɯklɑrɯ
ʧøzymDA	ʧøzymdɑ	ʧøzymde
ʧɑlɯʃɑnlArDAn	ʧɑlɯʃɑnlɑrden	ʧɑlɯʃɑnlɑrdɑn
ʧɑlɯʃmAmHzHn	ʧɑlɯʃmemizin	ʧɑlɯʃmɑmɯzɯn
ʧekiʃmA	ʧekiʃmɑ	ʧekiʃme
ʧimentoHn	ʧimentoin	ʧimentoun
ʧizgisAl	ʧizgisɑl	ʧizgisel
ɯrkʧHlHk	ɯrkʧilik	ɯrkʧɯlɯk
ødA	ødɑ	øde
ødeneklAr	ødeneklɑr	ødenekler
ølmAA	ølmɑɑ	ølmee
øzetlAAn	øzetlɑɑn	øzetleen
ʃiʃlHklAr	ʃiʃlɯklɑr	ʃiʃlikler
yzernDAken	yzernteken	yzerndeken
ɑʧɯklɑmAlArDAn	ɑʧɯklɑmɑlɑrden	ɑʧɯklɑmɑlɑrdɑn
ɑfetlArDA	ɑfetlɑrdɑ	ɑfetlerde
ɑmbɑlɑʒlH	ɑmbɑlɑʒli	ɑmbɑlɑʒlɯ
ɑnormɑllHklAr	ɑnormɑlliklɑr	ɑnormɑllikler
ɑjlArHHn	ɑjleriin	ɑjlɑrɯɯn
ɑjrɯlɯkʧH	ɑjrɯlɯkʧu	ɑjrɯlɯkʧɯ
bølArAk	bølɑrɑk	bølerek
bɑntlArH	bɑntleri	bɑntlɑrɯ
bɑrɯʃDA	bɑrɯʃdɑ	bɑrɯʃtɑ
bebekDAn	bebektɑn	bebekten
bekleDHklArH	bekletiklɑrɯ	bekledikleri
birɑzDA	birɑzde	birɑzdɑ
birlikDAn	birliktɑn	birlikten
bojlArHHn	bojleriin	bojlɑrɯɯn
bulɑnɯklHk	bulɑnɯklik	bulɑnɯklɯk
bulmAmHz	bulmɑmiz	bulmɑmɯz
bulunHʃH	buluniʃi	bulunuʃu
ʤɑmiDA	ʤɑmite	ʤɑmide
ʤumhurijetDAn	ʤumhurijettɑn	ʤumhurijetten
dyʃmH	dyʃmi	dyʃmy
dyʃmADA	dyʃmɑde	dyʃmete
dyʃmAmA	dyʃmɑmɑ	dyʃmeme
dyʃmAmAH	dyʃmɑmɑɯ	dyʃmemei
deɰiʃmA	deɰiʃmɑ	deɰiʃme
deɰiʃmAlArA	deɰiʃmɑlɑrɑ	deɰiʃmelere
deɰiʃmAlArHn	deɰiʃmɑlɑrɯn	deɰiʃmelerin
deneArAk	deneɑrɑk	deneerek
diʃlArDA	diʃlerdɑ	diʃlerde
dinlAAlHm	dinlɑelim	dinleelim
doɰmADAn	doɰmeden	doɰmɑdɑn
doɰumHHn	doɰumiin	doɰumuun
doksɑnlH	doksɑnli	doksɑnlɯ
eɰlenmA	eɰlenmɑ	eɰlenme
ekiplArmHz	ekiplɑrmiz	ekiplermiz
figyrlArH	figyrlɑrɯ	figyrleri
fonlArDAn	fonlɑrden	fonlɑrdɑn
fonHHn	foniin	fonuun
formɑtlArH	formɑtleri	formɑtlɑrɯ
gønderAʤAk	gøndereʤɑk	gøndereʤek
gøndermAnHzH	gøndermɑnizi	gøndermenizi
gøzlAmA	gøzlɑmɑ	gøzleme
geliʃmA	geliʃmɑ	geliʃme
gerekAnDAn	gerekendɑn	gerekenden
gerilArDA	gerilerdɑ	gerilerde
girmAHHn	girmɑɯɯn	girmeiin
hɑmurHn	hɑmurɯn	hɑmurun
hɑrʤɑmAlArnA	hɑrʤɑmɑlɑrne	hɑrʤɑmɑlɑrnɑ
hɑtlArDAn	hɑtlɑrden	hɑtlɑrdɑn
iʃɑretlAnmAH	iʃɑretlɑnmɑɯ	iʃɑretlenmei
ihtilɑlH	ihtilɑlɯ	ihtilɑli
ilɑʧlArHHn	ilɑʧleriin	ilɑʧlɑrɯɯn
insɑnlArmHzA	insɑnlɑrmizɑ	insɑnlɑrmɯzɑ
isteDHklArnHzH	istetiklernizi	istediklernizi
izlAnmADA	izlɑnmɑde	izlenmete
kørlAr	kørlɑr	kørler
kyltyrmHzH	kyltyrmizi	kyltyrmyzy
kɑlkArAk	kɑlkerek	kɑlkɑrɑk
kɑpsylH	kɑpsyli	kɑpsyly
kɑpsɑmADA	kɑpsɑmɑde	kɑpsɑmɑtɑ
kɑrɑrsHzlHk	kɑrɑrsizlik	kɑrɑrsɯzlɯk
kɑtɯlmADA	kɑtɯlmɑde	kɑtɯlmɑtɑ
kemerlAr	kemerlɑr	kemerler
kesilmA	kesilmɑ	kesilme
kolDA	kolde	koldɑ
konsolosH	konsolosi	konsolosu
kontrollArA	kontrollɑrɑ	kontrollere
kojmADA	kojmɑde	kojmɑtɑ
kulyplArA	kulyplɑrɑ	kulyplere
kumlAr	kumler	kumlɑr
kurɑmHHn	kurɑmiin	kurɑmɯɯn
kurulDAn	kurulden	kuruldɑn
kurultɑjDA	kurultɑjde	kurultɑjdɑ
kujruklH	kujrukli	kujruklu
kujuDAn	kujutɑn	kujudɑn
kujuHn	kujuin	kujuun
mɑhpuslAr	mɑhpusler	mɑhpuslɑr
mɑkbulA	mɑkbulɑ	mɑkbule
mɑkinɑDA	mɑkinɑde	mɑkinɑdɑ
mɑmyllAr	mɑmyllɑr	mɑmyller
mɑsrɑflH	mɑsrɑfli	mɑsrɑflɯ
mesɑfeDAki	mesɑfeteki	mesɑfedeki
modylHHn	modyliin	modylyyn
mutɑbɑkɑtA	mutɑbɑkɑte	mutɑbɑkɑtɑ
nøbetlArHn	nøbetlɑrɯn	nøbetlerin
nyfuslArH	nyfusleri	nyfuslɑrɯ
nehirlAr	nehirlɑr	nehirler
pɑjlɑʃmADAn	pɑjlɑʃmɑden	pɑjlɑʃmɑtɑn
polimerlArHn	polimerlɑrɯn	polimerlerin
profillAr	profillɑr	profiller
sɯfɑtlArH	sɯfɑtleri	sɯfɑtlɑrɯ
søzlyklAr	søzlyklɑr	søzlykler
sɑbɑhlArA	sɑbɑhlere	sɑbɑhlɑrɑ
sɑltɑnɑtH	sɑltɑnɑtu	sɑltɑnɑtɯ
sɑnɑjilAʃmAHn	sɑnɑjileʃmɑɯn	sɑnɑjileʃmein
sɑvH	sɑvi	sɑvɯ
sigortɑlHlHk	sigortɑlilik	sigortɑlɯlɯk
sinjɑllArHn	sinjɑllɑrɯn	sinjɑllerin
sistemmHzA	sistemmyze	sistemmize
soɰuklHk	soɰuklik	soɰukluk
tɑɑhhytlAr	tɑɑhhytlɑr	tɑɑhhytler
tɑrihlAnAn	tɑrihlɑnɑn	tɑrihlenen
tɑtillAr	tɑtillɑr	tɑtiller
tɑvsijeDA	tɑvsijete	tɑvsijede
tɑzminɑtHHn	tɑzminɑtiin	tɑzminɑtɯɯn
tɑzminɑtlArH	tɑzminɑtleri	tɑzminɑtlɑrɯ
tekerleklAr	tekerleklɑr	tekerlekler
ulɑʃmAnHzH	ulɑʃmɑnizi	ulɑʃmɑnɯzɯ
vekillAr	vekillɑr	vekiller
velilArmHzA	velilermizɑ	velilermize
vermAHHn	vermɑɯɯn	vermeiin
jyklAnmA	jyklɑnmɑ	jyklenme
jykselmA	jykselmɑ	jykselme
jɑʃɑmADAn	jɑʃɑmɑden	jɑʃɑmɑdɑn
jɑʃlArDAn	jɑʃlerden	jɑʃlɑrdɑn
jɑpɯtlArHHn	jɑpɯtleriin	jɑpɯtlɑrɯɯn
jɑpDHklArHHn	jɑptikleriin	jɑptɯklɑrɯɯn
jeʃillHklAr	jeʃilliklɑr	jeʃillikler
jemAH	jemɑɯ	jemei
jerjyzynDAn	jerjyzyndɑn	jerjyzynden
jolmHz	jolmiz	jolmuz
jolmHzH	jolmizi	jolmuzu
ʧimentoH	ʧimentoi	ʧimentou
ʃubelArDA	ʃubelerdɑ	ʃubelerde
ʃurɑDA	ʃurɑde	ʃurɑdɑ
ynitelArDA	ynitelerdɑ	ynitelerde
yreAn	yreɑn	yreen
ɑlɯnmADHkʧA	ɑlɯnmetikʧe	ɑlɯnmɑdɯkʧɑ
ɑrkɑdɑʃnHzHn	ɑrkɑdɑʃnizin	ɑrkɑdɑʃnɯzɯn
ɑrkɑdɑʃnHzA	ɑrkɑdɑʃnizɑ	ɑrkɑdɑʃnɯzɑ
ɑrkɑdɑʃlArnHzHn	ɑrkɑdɑʃlernizin	ɑrkɑdɑʃlɑrnɯzɯn
ɑrtɯklArHHn	ɑrtɯkleriin	ɑrtɯklɑrɯɯn
ɑtlArH	ɑtleri	ɑtlɑrɯ
ɑvɑntɑʒA	ɑvɑntɑʒe	ɑvɑntɑʒɑ
ɑjɯplH	ɑjɯpli	ɑjɯplɯ
ɑjɑrlArnHzH	ɑjɑrlernizi	ɑjɑrlɑrnɯzɯ
ɑjDAki	ɑjdeki	ɑjdɑki
ɑzɯnlɯkDA	ɑzɯnlɯkte	ɑzɯnlɯktɑ
ɑzɑlDHkʧA	ɑzɑldikʧe	ɑzɑldɯkʧɑ
bɯkmADAn	bɯkmɑden	bɯkmɑdɑn
bɑlɯklArHHn	bɑlɯkleriin	bɑlɯklɑrɯɯn
belirtmADAn	belirtmɑden	belirtmeden
benimseArAk	benimseɑrɑk	benimseerek
benzerlAr	benzerlɑr	benzerler
bitAnH	bitɑnɯ	biteni
bolmH	bolmɯ	bolmu
burɑlArDAki	burɑlɑrtɑki	burɑlɑrdɑki
butonA	butone	butonɑ
ʤevɑpsHz	ʤevɑpsiz	ʤevɑpsɯz
dønyʃymA	dønyʃymɑ	dønyʃyme
dyʃH	dyʃɯ	dyʃy
dyʃHʃHn	dyʃiʃin	dyʃyʃyn
dɑnsH	dɑnsi	dɑnsɯ
deɰerlArmHzH	deɰerlɑrmizi	deɰerlermizi
dergimHzA	dergimizɑ	dergimize
detɑjlArHn	detɑjlerin	detɑjlɑrɯn
dokuDAn	dokutɑn	dokudɑn
dosjɑlArDAn	dosjɑlɑrden	dosjɑlɑrdɑn
eʃjɑlArnHzH	eʃjɑlɑrnizi	eʃjɑlɑrnɯzɯ
ekmeklAr	ekmeklɑr	ekmekler
eleʃtirmA	eleʃtirmɑ	eleʃtirme
emellArH	emellɑrɯ	emelleri
engellArDAn	engellɑrden	engellerden
etkilAmAA	etkilemɑɑ	etkilemee
felɑketDAn	felɑkettɑn	felɑketten
figyrlAr	figyrlɑr	figyrler
gøndermADAn	gøndermɑden	gøndermeden
gørevmH	gørevmɯ	gørevmi
gøzlemlAmA	gøzlemlɑmɑ	gøzlemleme
gynɑhH	gynɑhi	gynɑhɯ
gɑjrimenkulA	gɑjrimenkulɑ	gɑjrimenkule
gelenekʧH	gelenekʧu	gelenekʧi
geniʃliklArH	geniʃliklɑrɯ	geniʃlikleri
genlArHn	genlɑrɯn	genlerin
giriʃimA	giriʃimɑ	giriʃime
hykymsHzlHk	hykymsizlik	hykymsyzlyk
hɑfifA	hɑfifɑ	hɑfife
hɑriʧDA	hɑriʧdɑ	hɑriʧte
hɑritɑDAn	hɑritɑden	hɑritɑdɑn
hoʤɑmHzHn	hoʤɑmizin	hoʤɑmɯzɯn
iʧAnlArDA	iʧɑnlɑrdɑ	iʧenlerde
iʃɑretlAmA	iʃɑretlɑmɑ	iʃɑretleme
iʃtɑhsHzlHk	iʃtɑhsizlik	iʃtɑhsɯzlɯk
ikɑmetgɑhHHn	ikɑmetgɑhiin	ikɑmetgɑhɯɯn
ikrɑmlAr	ikrɑmler	ikrɑmlɑr
insɑnmHzA	insɑnmyze	insɑnmɯzɑ
kɯzgɯnlHk	kɯzgɯnlik	kɯzgɯnlɯk
kytyklArH	kytyklɑrɯ	kytykleri
kɑlplArH	kɑlplɑrɯ	kɑlpleri
kɑmpɑnjɑmHz	kɑmpɑnjɑmiz	kɑmpɑnjɑmɯz
kɑrʃɯlAAbilmA	kɑrʃɯlɑɑbilmɑ	kɑrʃɯlɑɑbilme
kɑrʃɯmHzDAki	kɑrʃɯmɯzdeki	kɑrʃɯmɯzdɑki
kɑtkɯlArnHzH	kɑtkɯlernizi	kɑtkɯlɑrnɯzɯ
kɑjbetmAH	kɑjbetmɑɯ	kɑjbetmei
kɑzɑnAbilmA	kɑzɑnɑbilmɑ	kɑzɑnɑbilme
keʃfetmA	keʃfetmɑ	keʃfetme
kemɑlH	kemɑlɯ	kemɑli
kolesterolHn	kolesterolin	kolesterolyn
konferɑnslArA	konferɑnslere	konferɑnslɑrɑ
konsorsijumH	konsorsijumɯ	konsorsijumu
kontrollArDA	kontrollɑrdɑ	kontrollerde
korkmADAn	korkmɑden	korkmɑdɑn
korumɑsHz	korumɑsiz	korumɑsɯz
kristɑllAr	kristɑllɑr	kristɑller
kursijerlArA	kursijerlɑrɑ	kursijerlere
kuruDHkDAn	kurudiktɑn	kuruduktɑn
kutuDAn	kututɑn	kutudɑn
linkA	linkɑ	linke
mɑmullArHn	mɑmullɑrɯn	mɑmullerin
merʤeklAr	merʤeklɑr	merʤekler
merdivenlArDAn	merdivenlɑrden	merdivenlerden
molekylHn	molekylin	molekylyn
molekyllArHn	molekyllɑrɯn	molekyllerin
okullArmHz	okullɑrmiz	okullɑrmɯz
okulmHzH	okulmizi	okulmuzu
oluʃumlArA	oluʃumlere	oluʃumlɑrɑ
onɑrɯmlArH	onɑrɯmleri	onɑrɯmlɑrɯ
onɑjlAArAk	onɑjleerek	onɑjlɑɑrɑk
oruʧlArHHn	oruʧleriin	oruʧlɑrɯɯn
otelmHzA	otelmyze	otelmize
pɑrɑgrɑfDA	pɑrɑgrɑfte	pɑrɑgrɑftɑ
pɑrtilArDA	pɑrtilerdɑ	pɑrtilerde
pɑtentDAn	pɑtenttɑn	pɑtentten
progrɑmnHz	progrɑmniz	progrɑmnɯz
rɑhɑtA	rɑhɑte	rɑhɑtɑ
rɑkɑmlH	rɑkɑmli	rɑkɑmlɯ
syrgylH	syrgyli	syrgyly
sytDAn	syttɑn	sytten
sɑbunlH	sɑbunli	sɑbunlu
sɑnɑtʧHlArHHn	sɑnɑtʧileriin	sɑnɑtʧɯlɑrɯɯn
sɑvunmADAn	sɑvunmɑden	sɑvunmɑdɑn
seʧmAA	seʧmɑɑ	seʧmee
sevmAAn	sevmɑɑn	sevmeen
sejretmA	sejretmɑ	sejretme
sezgisAl	sezgisɑl	sezgisel
tyrlArA	tyrlɑrɑ	tyrlere
teʃekkyrH	teʃekkyri	teʃekkyry
tebliɰA	tebliɰɑ	tebliɰe
terʤihA	terʤihɑ	terʤihe
tolerɑnsH	tolerɑnsi	tolerɑnsɯ
toplɑmlArHHn	toplɑmleriin	toplɑmlɑrɯɯn
turmHz	turmiz	turmuz
uʧDA	uʧdɑ	uʧtɑ
ulusmHzHn	ulusmizin	ulusmuzun
ujumHHn	ujumiin	ujumuun
verimA	verimɑ	verime
jyklAmAA	jyklɑmɑɑ	jyklemee
jykseklArA	jykseklɑrɑ	jykseklere
jyksekDAn	jyksektɑn	jyksekten
jyryHp	jyryup	jyryyp
jyzjɯllArDAn	jyzjɯllɑrden	jyzjɯllɑrdɑn
jɑɰlArDAn	jɑɰlɑrden	jɑɰlɑrdɑn
jɑpDHklArmHzH	jɑptiklɑrmizi	jɑptɯklɑrmɯzɯ
jɑsɑlArDAn	jɑsɑlɑrden	jɑsɑlɑrdɑn
jɑzAlHm	jɑzelim	jɑzɑlɯm
jenmA	jenmɑ	jenme
jerleʃArAk	jerleʃɑrɑk	jerleʃerek
jerjyzynH	jerjyzyni	jerjyzyny
jetiʃmA	jetiʃmɑ	jetiʃme
jolsuzlHklArH	jolsuzliklɑrɯ	jolsuzluklɑrɯ
jolsuzlHklArA	jolsuzliklɑrɑ	jolsuzluklɑrɑ
jurtlArA	jurtlere	jurtlɑrɑ
ʧøplArHn	ʧøplɑrɯn	ʧøplerin
ʧɑlɯʃmAnHzH	ʧɑlɯʃmɑnizi	ʧɑlɯʃmɑnɯzɯ
ʧemberlArH	ʧemberlɑrɯ	ʧemberleri
øɰrenmADA	øɰrenmɑde	øɰrenmede
øɰretimDAki	øɰretimdɑki	øɰretimdeki
ønemDA	ønemdɑ	ønemde
ʃɑntijeDA	ʃɑntijete	ʃɑntijede
ɑʧɯklɑmAlArHHn	ɑʧɯklɑmɑleriin	ɑʧɯklɑmɑlɑrɯɯn
ɑɰɑʧlArA	ɑɰɑʧlere	ɑɰɑʧlɑrɑ
ɑkɑdemisjenlArHn	ɑkɑdemisjenlɑrɯn	ɑkɑdemisjenlerin
ɑksɑtmADAn	ɑksɑtmɑden	ɑksɑtmɑdɑn
ɑlɯmlArDA	ɑlɯmlerdɑ	ɑlɯmlɑrdɑ
ɑskerlHkDAn	ɑskerliktɑn	ɑskerlikten
ɑzɑDAn	ɑzɑden	ɑzɑdɑn
bɑʃɑrɯlArnHzHn	bɑʃɑrɯlernizin	bɑʃɑrɯlɑrnɯzɯn
bɑkmAmHz	bɑkmemiz	bɑkmɑmɯz
bɑnkɑDAki	bɑnkɑtɑki	bɑnkɑdɑki
bɑjrɑmlAʃmA	bɑjrɑmleʃmɑ	bɑjrɑmlɑʃmɑ
benimsemAH	benimsemɑɯ	benimsemei
bejinlArH	bejinlɑrɯ	bejinleri
bilgisɑjɑrnHzDAn	bilgisɑjɑrnizden	bilgisɑjɑrnɯzdɑn
bilmAnHzH	bilmɑnizi	bilmenizi
bilmAArAk	bilmɑɑrɑk	bilmeerek
binɑmHzHn	binɑmizin	binɑmɯzɯn
bulHʃlArH	buliʃleri	buluʃlɑrɯ
bulHʃlArHn	buliʃlerin	buluʃlɑrɯn
ʤiltDAn	ʤilttɑn	ʤiltten
dyʃynAbiljor	dyʃynɑbiljor	dyʃynebiljor
deɰiʃiklHkDAn	deɰiʃikliktɑn	deɰiʃiklikten
demirbɑʃlAr	demirbɑʃler	demirbɑʃlɑr
denetimDA	denetimdɑ	denetimde
depresjonA	depresjone	depresjonɑ
desteklAnArAk	desteklɑnɑrɑk	desteklenerek
dinlArA	dinlɑrɑ	dinlere
direklAr	direklɑr	direkler
direklArH	direklɑrɯ	direkleri
disklArH	disklɑrɯ	diskleri
dizinlArH	dizinlɑrɯ	dizinleri
doɰumHn	doɰumin	doɰumun
eʃgydymH	eʃgydymɯ	eʃgydymy
eʃjɑlArDAn	eʃjɑlɑrden	eʃjɑlɑrdɑn
eʤzɑneDA	eʤzɑnete	eʤzɑnede
eklemDA	eklemdɑ	eklemde
eksiklArHn	eksiklɑrɯn	eksiklerin
elekDAn	elektɑn	elekten
elektriklAr	elektriklɑr	elektrikler
emperjɑlizmH	emperjɑlizmɯ	emperjɑlizmi
erkekDAn	erkektɑn	erkekten
etmAAlHm	etmɑɑlim	etmeelim
fidɑnlHk	fidɑnlik	fidɑnlɯk
figyrH	figyri	figyry
firmɑmHzDA	firmɑmɯzde	firmɑmɯzdɑ
formlH	formli	formlu
gøsterilArDA	gøsterilerdɑ	gøsterilerde
gyllHk	gyllik	gyllyk
gɑzɑlH	gɑzɑlɯ	gɑzɑli
geʧirmAAn	geʧirmɑɑn	geʧirmeen
gebelHkDAn	gebeliktɑn	gebelikten
gelAbilmA	gelɑbilmɑ	gelebilme
getirDHkDAn	getirdiktɑn	getirdikten
gezilArDA	gezilerdɑ	gezilerde
golH	golu	goly
hɑklArmHzH	hɑklɑrmizi	hɑklɑrmɯzɯ
hɑstɑnemHzA	hɑstɑnemizɑ	hɑstɑnemize
hesɑplAArAk	hesɑpleerek	hesɑplɑɑrɑk
hissetmA	hissetmɑ	hissetme
iʃlAnmA	iʃlɑnmɑ	iʃlenme
imtijɑzlAr	imtijɑzler	imtijɑzlɑr
insɑnmHzH	insɑnmizi	insɑnmɯzɯ
ishɑlA	ishɑlɑ	ishɑle
islAnmAH	islɑnmɑɯ	islenmei
istɑtistiklArHn	istɑtistiklɑrɯn	istɑtistiklerin
ittifɑkH	ittifɑki	ittifɑkɯ
kɯlɯfH	kɯlɯfi	kɯlɯfɯ
kørH	køri	køry
kyltyrmHzA	kyltyrmizɑ	kyltyrmyze
kyresAllAʃmAA	kyresellɑʃmɑɑ	kyreselleʃmee
kɑlDHkʧA	kɑldikʧe	kɑldɯkʧɑ
kɑmpɑnjɑDAn	kɑmpɑnjɑtɑn	kɑmpɑnjɑdɑn
kɑnsHz	kɑnsiz	kɑnsɯz
kɑpɯlArHHn	kɑpɯleriin	kɑpɯlɑrɯɯn
kɑrbonlH	kɑrbonli	kɑrbonlu
kɑtɯlmADAn	kɑtɯlmɑden	kɑtɯlmɑtɑn
kɑjnɑklArmHz	kɑjnɑklɑrmiz	kɑjnɑklɑrmɯz
kɑzɑlArDAn	kɑzɑlɑrden	kɑzɑlɑrdɑn
kesilDHkDAn	kesildiktɑn	kesildikten
kesimDAki	kesimdɑki	kesimdeki
killArH	killɑrɯ	killeri
killArHn	killɑrɯn	killerin
klɑvjeDAki	klɑvjeteki	klɑvjedeki
koʃulHHn	koʃuliin	koʃuluun
kontrollArHn	kontrollɑrɯn	kontrollerin
konuʃAlHm	konuʃelim	konuʃɑlɯm
konumlH	konumli	konumlu
kulyplArHn	kulyplɑrɯn	kulyplerin
kullɑnɯmlArDA	kullɑnɯmlerdɑ	kullɑnɯmlɑrdɑ
kuruluʃnHzHn	kuruluʃnizin	kuruluʃnuzun
lyksH	lyksi	lyksy
linklArA	linklɑrɑ	linklere
myttefiklArHn	myttefiklɑrɯn	myttefiklerin
mɑkroH	mɑkroi	mɑkrou
mɑzeretlAr	mɑzeretlɑr	mɑzeretler
merɑklHH	merɑklii	merɑklɯɯ
mesleklArDA	mesleklɑrdɑ	mesleklerde
meslektɑʃlArH	meslektɑʃleri	meslektɑʃlɑrɯ
mutsuzlHk	mutsuzlik	mutsuzluk
nehirlArHn	nehirlɑrɯn	nehirlerin
noksɑnlHklAr	noksɑnliklɑr	noksɑnlɯklɑr
normH	normi	normu
ordumHz	ordumiz	ordumuz
orgɑnlArDAn	orgɑnlɑrden	orgɑnlɑrdɑn
ojnɑDHklArH	ojnɑtiklɑrɯ	ojnɑdɯklɑrɯ
penʤerelArDA	penʤerelerdɑ	penʤerelerde
perspektifDAn	perspektiftɑn	perspektiften
plɑstikDAn	plɑstiktɑn	plɑstikten
puɑnlHk	puɑnlik	puɑnlɯk
ressɑmlArHn	ressɑmlerin	ressɑmlɑrɯn
sɯrlH	sɯrli	sɯrlɯ
søjleʃiDA	søjleʃite	søjleʃide
søzlArmA	søzlermɑ	søzlerme
sɑhnelAnAn	sɑhnelɑnɑn	sɑhnelenen
sɑntrɑllArDA	sɑntrɑllɑrdɑ	sɑntrɑllerde
sektørmHzDA	sektørmizde	sektørmyzde
sembollArHn	sembollɑrɯn	sembollerin
solunumHn	solunumin	solunumun
sorulArnHzA	sorulɑrnizɑ	sorulɑrnɯzɑ
sojDAn	sojden	sojdɑn
stɑʒlArH	stɑʒleri	stɑʒlɑrɯ
subɑjlArH	subɑjleri	subɑjlɑrɯ
tɑblolArHHn	tɑbloleriin	tɑblolɑrɯɯn
tɑkiplArH	tɑkiplɑrɯ	tɑkipleri
tɑnɯmlArA	tɑnɯmlere	tɑnɯmlɑrɑ
tepkimAlArH	tepkimɑlɑrɯ	tepkimeleri
terørizmH	terørizmɯ	terørizmi
tiplArHn	tiplɑrɯn	tiplerin
tohumHn	tohumin	tohumun
toklHk	toklik	tokluk
toplulukDA	toplulukte	topluluktɑ
uʧHʃA	uʧiʃe	uʧuʃɑ
ulɑʃmADA	ulɑʃmɑde	ulɑʃmɑtɑ
unutmADAn	unutmɑden	unutmɑdɑn
urHn	urɯn	urun
jyzmH	jyzmɯ	jyzmy
jɑʃɑDHkʧA	jɑʃɑtikʧe	jɑʃɑdɯkʧɑ
jɑʃlArA	jɑʃlere	jɑʃlɑrɑ
jɑzɑrlArDAn	jɑzɑrlɑrden	jɑzɑrlɑrdɑn
jemeklArA	jemeklɑrɑ	jemeklere
jerleʃmA	jerleʃmɑ	jerleʃme
zɑmlArH	zɑmleri	zɑmlɑrɯ
zɑjɯflAmHʃ	zɑjɯflemiʃ	zɑjɯflɑmɯʃ
zijɑretlArDA	zijɑretlɑrdɑ	zijɑretlerde
ʧɯkHʃA	ʧɯkiʃe	ʧɯkɯʃɑ
ʧøzmAH	ʧøzmɑɯ	ʧøzmei
ʧɑɰɯrHp	ʧɑɰɯrup	ʧɑɰɯrɯp
ʧɑɰdɑʃlHk	ʧɑɰdɑʃlik	ʧɑɰdɑʃlɯk
ʧiftlAʃmA	ʧiftlɑʃmɑ	ʧiftleʃme
ɯrkH	ɯrki	ɯrkɯ
ølʧeklArDA	ølʧeklɑrdɑ	ølʧeklerde
ølymlH	ølymli	ølymly
ønermA	ønermɑ	ønerme
ørgytlAnmAlAr	ørgytlɑnmɑlɑr	ørgytlenmeler
ørgytlAnmAHn	ørgytlɑnmɑɯn	ørgytlenmein
ʃykrɑnlArmHzH	ʃykrɑnlɑrmizi	ʃykrɑnlɑrmɯzɯ
ʃɑrtDA	ʃɑrtte	ʃɑrttɑ
ʃiirlArHn	ʃiirlɑrɯn	ʃiirlerin
ystlHk	ystlik	ystlyk
yjelArDA	yjelerdɑ	yjelerde
ɑfetlArHn	ɑfetlɑrɯn	ɑfetlerin
ɑʒɑnslArH	ɑʒɑnsleri	ɑʒɑnslɑrɯ
ɑlgɯlAHʤH	ɑlgɯleiʤi	ɑlgɯlɑɯʤɯ
ɑrkɑdɑʃlArmHzDAn	ɑrkɑdɑʃlermizden	ɑrkɑdɑʃlɑrmɯzdɑn
ɑrmɑtyrlAr	ɑrmɑtyrlɑr	ɑrmɑtyrler
ɑstɯmlH	ɑstɯmli	ɑstɯmlɯ
ɑtmADAn	ɑtmɑden	ɑtmɑdɑn
bytynlAʃmAHn	bytynlɑʃmɑɯn	bytynleʃmein
bɑɰɯrHp	bɑɰɯrup	bɑɰɯrɯp
bɑkɯmlArDAn	bɑkɯmlerden	bɑkɯmlɑrdɑn
bɑkmADA	bɑkmɑde	bɑkmɑtɑ
bɑsɯnʧlArH	bɑsɯnʧleri	bɑsɯnʧlɑrɯ
bɑsDHkDAn	bɑstiktɑn	bɑstɯktɑn
bertɑrɑfH	bertɑrɑfi	bertɑrɑfɯ
borulArHHn	boruleriin	borulɑrɯɯn
ʤerrɑhiDA	ʤerrɑhite	ʤerrɑhide
dɯʃmHzDA	dɯʃmizde	dɯʃmɯzdɑ
dyʃynHnʤA	dyʃyninʤe	dyʃynynʤe
dynjɑmHzH	dynjɑmizi	dynjɑmɯzɯ
deɰerlendirmAlArA	deɰerlendirmɑlɑrɑ	deɰerlendirmelere
defterDA	defterdɑ	defterde
dermA	dermɑ	derme
diDA	dite	dide
doɰɑlgɑzHn	doɰɑlgɑzin	doɰɑlgɑzɯn
dostA	doste	dostɑ
durummHz	durummiz	durummuz
editørlArH	editørlɑrɯ	editørleri
elemɑnlArDAn	elemɑnlɑrden	elemɑnlɑrdɑn
ellArDAn	ellɑrden	ellerden
evrenDAki	evrendɑki	evrendeki
ejɑletlAr	ejɑletlɑr	ejɑletler
fɑizA	fɑizɑ	fɑize
fɑkslAr	fɑksler	fɑkslɑr
fɑjlArHn	fɑjlerin	fɑjlɑrɯn
gønyllHlArHn	gønyllilerin	gønyllylerin
gøryntyDA	gøryntydɑ	gøryntyde
gørmAlArnH	gørmɑlɑrnɯ	gørmelerni
gyʧlAnArAk	gyʧlɑnɑrɑk	gyʧlenerek
gyllArH	gyllɑrɯ	gylleri
gymryklAr	gymryklɑr	gymrykler
gyreʃDA	gyreʃdɑ	gyreʃte
gɑjretlAr	gɑjretlɑr	gɑjretler
geleʤeklArH	geleʤeklɑrɯ	geleʤekleri
geliʃmAlArDA	geliʃmɑlɑrdɑ	geliʃmelerde
gerADA	gerete	gerede
getirmADAn	getirmɑden	getirmeden
getirmAlArnH	getirmɑlɑrnɯ	getirmelerni
gevʃemAH	gevʃemɑɯ	gevʃemei
hɯrslH	hɯrsli	hɯrslɯ
hykymlHlArA	hykymlilere	hykymlylere
hɑnɯmlArH	hɑnɯmleri	hɑnɯmlɑrɯ
hɑtɑDAn	hɑtɑden	hɑtɑdɑn
hɑtɑlArHHn	hɑtɑleriin	hɑtɑlɑrɯɯn
hɑvuzDAn	hɑvuzden	hɑvuzdɑn
hɑzɯrlAmADA	hɑzɯrlɑmɑde	hɑzɯrlɑmɑtɑ
hekimnHzA	hekimnizɑ	hekimnize
hissetmAH	hissetmɑɯ	hissetmei
hormonlArHHn	hormonleriin	hormonlɑrɯɯn
iʧmAHn	iʧmɑɯn	iʧmein
iʃmA	iʃmɑ	iʃme
iʃverenDAn	iʃverendɑn	iʃverenden
ispɑtlAmHʃ	ispɑtlemiʃ	ispɑtlɑmɯʃ
istisnɑsHz	istisnɑsiz	istisnɑsɯz
ijilAʃmAA	ijileʃmɑɑ	ijileʃmee
køjlArDAki	køjlerdɑki	køjlerdeki
kɑleDA	kɑlete	kɑlede
kɑjɯpsHz	kɑjɯpsiz	kɑjɯpsɯz
kɑzɑnDHkDAn	kɑzɑndiktɑn	kɑzɑndɯktɑn
kɑzɑnmADA	kɑzɑnmɑde	kɑzɑnmɑtɑ
kentlAʃmAHn	kentlɑʃmɑɯn	kentleʃmein
kilitlAr	kilitlɑr	kilitler
koɰuʃDA	koɰuʃdɑ	koɰuʃtɑ
kurmAnHz	kurmɑniz	kurmɑnɯz
kursijerlArHn	kursijerlɑrɯn	kursijerlerin
kurHʤHnHn	kuruʤynin	kuruʤunun
kurumnHzHn	kurumnizin	kurumnuzun
lezzetlAr	lezzetlɑr	lezzetler
liberɑllAʃmA	liberɑllɑʃmɑ	liberɑlleʃme
linklArDAn	linklɑrden	linklerden
mɑɰɑrɑDA	mɑɰɑrɑde	mɑɰɑrɑdɑ
mɑkɑmDAn	mɑkɑmden	mɑkɑmdɑn
mɑkbuzlArHHn	mɑkbuzleriin	mɑkbuzlɑrɯɯn
mɑrketlAr	mɑrketlɑr	mɑrketler
mɑsɑDAn	mɑsɑden	mɑsɑdɑn
mesleklArA	mesleklɑrɑ	mesleklere
mesleklArHn	mesleklɑrɯn	mesleklerin
mezɑrlHklAr	mezɑrliklɑr	mezɑrlɯklɑr
mirɑsʧH	mirɑsʧi	mirɑsʧɯ
mirɑsʧHlAr	mirɑsʧiler	mirɑsʧɯlɑr
mitinglAr	mitinglɑr	mitingler
monitørH	monitøri	monitøry
mutlulHkDAn	mutluliktɑn	mutluluktɑn
normlH	normli	normlu
okurlArmHzHn	okurlɑrmizin	okurlɑrmɯzɯn
okurH	okuri	okuru
ortɑmlArDAn	ortɑmlerden	ortɑmlɑrdɑn
pɑmukDA	pɑmukte	pɑmuktɑ
pɑrknA	pɑrkne	pɑrknɑ
pɑrtikyllArH	pɑrtikyllɑrɯ	pɑrtikylleri
pɑzɑrlAmADA	pɑzɑrlɑmɑde	pɑzɑrlɑmɑdɑ
personellArHn	personellɑrɯn	personellerin
polisDAn	polistɑn	polisten
proteinlArH	proteinlɑrɯ	proteinleri
rɑporDAki	rɑportɑki	rɑpordɑki
refɑhHn	refɑhin	refɑhɯn
syrgynDA	syrgyndɑ	syrgynde
sɑrɯmsH	sɑrɯmsi	sɑrɯmsɯ
sɑjdɑmlHk	sɑjdɑmlik	sɑjdɑmlɯk
seʧmADA	seʧmɑde	seʧmete
semptomH	semptomi	semptomu
serɑmiklArH	serɑmiklɑrɯ	serɑmikleri
sejretmAA	sejretmɑɑ	sejretmee
spektrumlH	spektrumli	spektrumlu
sporlArHHn	sporleriin	sporlɑrɯɯn
suʧHHn	suʧiin	suʧuun
tykenmA	tykenmɑ	tykenme
tytynDAn	tytyndɑn	tytynden
tɑbɑkɑDAn	tɑbɑkɑden	tɑbɑkɑdɑn
tɑlimɑtlArA	tɑlimɑtlere	tɑlimɑtlɑrɑ
tɑnɯmADAn	tɑnɯmɑden	tɑnɯmɑdɑn
tɑsɑrɯmlArHHn	tɑsɑrɯmleriin	tɑsɑrɯmlɑrɯɯn
tɑsɑrɯmlArDA	tɑsɑrɯmlerdɑ	tɑsɑrɯmlɑrdɑ
teʃviklArH	teʃviklɑrɯ	teʃvikleri
tebligɑtA	tebligɑte	tebligɑtɑ
tekellAʃmA	tekellɑʃmɑ	tekelleʃme
temɑslArH	temɑsleri	temɑslɑrɯ
temelnDAki	temelndɑki	temelndeki
teminɑtHHn	teminɑtiin	teminɑtɯɯn
testDAn	testtɑn	testten
tolerɑnslH	tolerɑnsli	tolerɑnslɯ
toprɑkDAki	toprɑkteki	toprɑktɑki
tuʃlArHn	tuʃlerin	tuʃlɑrɯn
uʧurumH	uʧurumɯ	uʧurumu
ujgulɑHʤHH	ujgulɑiʤii	ujgulɑɯʤɯɯ
uzɑHp	uzɑup	uzɑɯp
vermAA	vermɑɑ	vermee
vitɑminlArHn	vitɑminlɑrɯn	vitɑminlerin
voltɑʒH	voltɑʒi	voltɑʒɯ
jyklAHp	jyklɑɯp	jykleip
jɑʃlHlArH	jɑʃlileri	jɑʃlɯlɑrɯ
jɑkɯtHn	jɑkɯtin	jɑkɯtɯn
jɑmɑʧlArH	jɑmɑʧleri	jɑmɑʧlɑrɯ
jɑrdɯmlArDA	jɑrdɯmlerdɑ	jɑrdɯmlɑrdɑ
jɑjɯnlArmHz	jɑjɯnlɑrmiz	jɑjɯnlɑrmɯz
jɑzɑrlH	jɑzɑrli	jɑzɑrlɯ
jenmAH	jenmɑɯ	jenmei
jetersizlHklAr	jetersizliklɑr	jetersizlikler
jorumlArnHzH	jorumlernizi	jorumlɑrnɯzɯ
jorumlAAn	jorumleen	jorumlɑɑn
zehirlAnmAlAr	zehirlɑnmɑlɑr	zehirlenmeler
ʧøzymlAmA	ʧøzymlɑmɑ	ʧøzymleme
ʧøzmADA	ʧøzmete	ʧøzmede
ʧɑjlArH	ʧɑjleri	ʧɑjlɑrɯ
ʧekAbilmA	ʧekɑbilmɑ	ʧekebilme
ʧevremDA	ʧevremdɑ	ʧevremde
ʧevremDAki	ʧevremdɑki	ʧevremdeki
ʧevrenHzA	ʧevrenizɑ	ʧevrenize
ʧiʧeklArA	ʧiʧeklɑrɑ	ʧiʧeklere
ølʧysHz	ølʧysiz	ølʧysyz
øzyrlArH	øzyrlɑrɯ	øzyrleri
ʃɑrtHn	ʃɑrtin	ʃɑrtɯn
ʃɑrtnɑmelArDA	ʃɑrtnɑmelerdɑ	ʃɑrtnɑmelerde
ynHn	ynin	ynyn
ɑɰɑʧDA	ɑɰɑʧdɑ	ɑɰɑʧtɑ
ɑdɑmlArHn	ɑdɑmlerin	ɑdɑmlɑrɯn
ɑdetlAr	ɑdetlɑr	ɑdetler
ɑdetDAn	ɑdettɑn	ɑdetten
ɑktørlArHn	ɑktørlɑrɯn	ɑktørlerin
ɑlɯmlAr	ɑlɯmler	ɑlɯmlɑr
ɑlɯnHnʤA	ɑlɯninʤe	ɑlɯnɯnʤɑ
ɑldɑtHʤH	ɑldɑtiʤi	ɑldɑtɯʤɯ
ɑmɑtørlHk	ɑmɑtørlik	ɑmɑtørlyk
ɑmbɑrlH	ɑmbɑrli	ɑmbɑrlɯ
ɑnlɑjɯʃlAr	ɑnlɑjɯʃler	ɑnlɑjɯʃlɑr
ɑnneDA	ɑnnete	ɑnnede
ɑtHʤH	ɑtiʤi	ɑtɯʤɯ
ɑjetlAr	ɑjetlɑr	ɑjetler
byjytAn	byjytɑn	byjyten
bɑroHHn	bɑroiin	bɑrouun
beʃikʧH	beʃikʧu	beʃikʧi
dɑɰɯtArAk	dɑɰɯterek	dɑɰɯtɑrɑk
dɑlDAn	dɑlden	dɑldɑn
dɑmɑrlArDAn	dɑmɑrlɑrden	dɑmɑrlɑrdɑn
dɑnɯʃmADAn	dɑnɯʃmɑden	dɑnɯʃmɑdɑn
dɑnslAr	dɑnsler	dɑnslɑr
delillArA	delillɑrɑ	delillere
denemeDA	denemete	denemede
depoHHn	depoiin	depouun
direktiflArDA	direktiflɑrdɑ	direktiflerde
direnmA	direnmɑ	direnme
doʧentlAr	doʧentlɑr	doʧentler
doɰDHkDAn	doɰdiktɑn	doɰduktɑn
dozHHn	doziin	dozuun
durmADA	durmɑde	durmɑtɑ
durumDAken	durumdeken	durumdɑken
durumnHzH	durumnizi	durumnuzu
dujgulArmHzH	dujgulɑrmizi	dujgulɑrmɯzɯ
ebɑtDA	ebɑtte	ebɑttɑ
ebevejnlArHn	ebevejnlɑrɯn	ebevejnlerin
eksenlArH	eksenlɑrɯ	eksenleri
engellArA	engellɑrɑ	engellere
ertesinDA	ertesindɑ	ertesinde
esirgemAAn	esirgemɑɑn	esirgemeen
etkilAnmADAn	etkilenmɑden	etkilenmeden
etkinlHkDAn	etkinliktɑn	etkinlikten
etmAmAlArH	etmɑmɑlɑrɯ	etmemeleri
evlHlHklArH	evliliklɑrɯ	evlilikleri
federɑsjonHHn	federɑsjoniin	federɑsjonuun
ferɑhlHk	ferɑhlik	ferɑhlɯk
festivɑlA	festivɑlɑ	festivɑle
fikirDA	fikirdɑ	fikirde
firmɑlArmHzHn	firmɑlɑrmizin	firmɑlɑrmɯzɯn
fijɑtlArmHz	fijɑtlermiz	fijɑtlɑrmɯz
fijɑtDA	fijɑtte	fijɑttɑ
fonksijonA	fonksijone	fonksijonɑ
gɯdɑlArDAn	gɯdɑlɑrden	gɯdɑlɑrdɑn
gørynymHn	gørynymin	gørynymyn
gøryntylArDA	gøryntylerdɑ	gøryntylerde
gøryntyHHn	gøryntyiin	gøryntyyyn
gøzlArmA	gøzlermɑ	gøzlerme
gylymseAn	gylymseɑn	gylymseen
gymrykDAn	gymryktɑn	gymrykten
gyvenliklArH	gyvenliklɑrɯ	gyvenlikleri
gɑzeteDAki	gɑzeteteki	gɑzetedeki
geʧAbilmA	geʧɑbilmɑ	geʧebilme
geʧAbilmAH	geʧɑbilmɑɯ	geʧebilmei
geʤikmAHn	geʤikmɑɯn	geʤikmein
geleneklArA	geleneklɑrɑ	geleneklere
grɑmlHk	grɑmlik	grɑmlɯk
hɑlkDA	hɑlkte	hɑlktɑ
hɑstɑmHz	hɑstɑmiz	hɑstɑmɯz
hɑvuzHHn	hɑvuziin	hɑvuzuun
hɑvzɑDA	hɑvzɑde	hɑvzɑdɑ
huzurlArnHzDA	huzurlernizde	huzurlɑrnɯzdɑ
iʧlAr	iʧlɑr	iʧler
idɑreDA	idɑrete	idɑrede
ihtijɑtlH	ihtijɑtli	ihtijɑtlɯ
inʤelemAlArHn	inʤelemɑlɑrɯn	inʤelemelerin
inmAH	inmɑɯ	inmei
itibɑrlH	itibɑrli	itibɑrlɯ
itmA	itmɑ	itme
kɯvrɯmlH	kɯvrɯmli	kɯvrɯmlɯ
køkenlArH	køkenlɑrɯ	køkenleri
kyllAr	kyllɑr	kyller
kyreDA	kyrete	kyrede
kɑbullAnmA	kɑbullɑnmɑ	kɑbullenme
kɑlpDAn	kɑlpden	kɑlpten
kɑmpDAn	kɑmpden	kɑmptɑn
kɑtegoriDAki	kɑtegoriteki	kɑtegorideki
kɑjbetmAmA	kɑjbetmɑmɑ	kɑjbetmeme
kireʧlH	kireʧlɯ	kireʧli
klɑsørlArH	klɑsørlɑrɯ	klɑsørleri
kodlArHHn	kodleriin	kodlɑrɯɯn
kontrɑtH	kontrɑtu	kontrɑtɯ
konuʃmAlArHHn	konuʃmɑleriin	konuʃmɑlɑrɯɯn
korumADA	korumɑde	korumɑtɑ
kriterlArDAn	kriterlɑrden	kriterlerden
lɑfDA	lɑfte	lɑftɑ
myesseselArDA	myesseselerdɑ	myesseselerde
mynɑsebetlAr	mynɑsebetlɑr	mynɑsebetler
myzɑkerelArDA	myzɑkerelerdɑ	myzɑkerelerde
mɑɰɑzɑDAn	mɑɰɑzɑden	mɑɰɑzɑdɑn
mɑɰɑzɑlArDAn	mɑɰɑzɑlɑrden	mɑɰɑzɑlɑrdɑn
mɑrkɑlArHHn	mɑrkɑleriin	mɑrkɑlɑrɯɯn
meʤlisDAki	meʤlistɑki	meʤlisteki
mesɑʒHHn	mesɑʒiin	mesɑʒɯɯn
metotlArHHn	metotleriin	metotlɑrɯɯn
mevsimlArDA	mevsimlerdɑ	mevsimlerde
modellArDAn	modellɑrden	modellerden
nɑkillArH	nɑkillɑrɯ	nɑkilleri
numɑrɑDA	numɑrɑde	numɑrɑdɑ
odɑkDA	odɑkte	odɑktɑ
okurjɑzɑrlHk	okurjɑzɑrlik	okurjɑzɑrlɯk
onlH	onli	onlu
pillAr	pillɑr	piller
røportɑʒH	røportɑʒi	røportɑʒɯ
rɑfDA	rɑfte	rɑftɑ
rɑjlAr	rɑjler	rɑjlɑr
sɯʤɑkDA	sɯʤɑkte	sɯʤɑktɑ
sɯrtDA	sɯrtte	sɯrttɑ
søzmH	søzmɯ	søzmy
sɑhillArH	sɑhillɑrɯ	sɑhilleri
sɑldɯrɯlArHHn	sɑldɯrɯleriin	sɑldɯrɯlɑrɯɯn
sɑnijeDAn	sɑnijetɑn	sɑnijeden
sɑntrɑllArHHn	sɑntrɑlleriin	sɑntrɑllɑrɯɯn
sɑjmHzHn	sɑjmizin	sɑjmɯzɯn
sedɑsHz	sedɑsiz	sedɑsɯz
senɑrjoHn	senɑrjoin	senɑrjoun
senɑrjoH	senɑrjoi	senɑrjou
sendromHHn	sendromiin	sendromuun
serɑDA	serɑde	serɑdɑ
sergilAnmAA	sergilenmɑɑ	sergilenmee
sevinʧDAn	sevinʧtɑn	sevinʧten
sorumlHlArHn	sorumlilerin	sorumlulɑrɯn
tɯklADHkDAn	tɯkletiktɑn	tɯklɑdɯktɑn
tyketmA	tyketmɑ	tyketme
tɑʃɯtHn	tɑʃɯtin	tɑʃɯtɯn
tɑʃrɑDA	tɑʃrɑde	tɑʃrɑdɑ
tɑblolArDAn	tɑblolɑrden	tɑblolɑrdɑn
tɑhminlArA	tɑhminlɑrɑ	tɑhminlere
tɑsɑrɯmlArA	tɑsɑrɯmlere	tɑsɑrɯmlɑrɑ
tɑzminɑtA	tɑzminɑte	tɑzminɑtɑ
tekellArHn	tekellɑrɯn	tekellerin
tekliflArDA	tekliflɑrdɑ	tekliflerde
temellArHn	temellɑrɯn	temellerin
titreAn	titreɑn	titreen
tohumlArHn	tohumlerin	tohumlɑrɯn
tutɑnɑklArHHn	tutɑnɑkleriin	tutɑnɑklɑrɯɯn
tutumHHn	tutumiin	tutumuun
uʧHʃlAr	uʧiʃler	uʧuʃlɑr
ujkuHn	ujkuin	ujkuun
jyklArA	jyklɑrɑ	jyklere
jyzjɯllHk	jyzjɯllik	jyzjɯllɯk
jɑkAlAAbilmA	jɑkɑlɑɑbilmɑ	jɑkɑlɑɑbilme
jɑnɯtDA	jɑnɯtte	jɑnɯttɑ
jɑrɯjɯlA	jɑrɯjɯle	jɑrɯjɯlɑ
jɑrɯjɯllHk	jɑrɯjɯllik	jɑrɯjɯllɯk
jedeklAr	jedeklɑr	jedekler
jernHzA	jernizɑ	jernize
zeminDAn	zemindɑn	zeminden
