uf	pred	sf
gynH	gyni	gyny
ɑdH	ɑdi	ɑdɯ
oHn	oin	oun
hɑlA	hɑlɑ	hɑle
dønemDA	dønemdɑ	dønemde
biʧimDA	biʧimdɑ	biʧimde
dynjɑDA	dynjɑte	dynjɑdɑ
hɑlDA	hɑltɑ	hɑlde
yʧnʤH	yʧnʤi	yʧnʤy
jɯllArDA	jɯllerde	jɯllɑrdɑ
gyʧlH	gyʧli	gyʧly
vermA	vermɑ	verme
ɑdlH	ɑdli	ɑdlɯ
sɑɰlɯklH	sɑɰlɯkli	sɑɰlɯklɯ
mydyrH	mydyri	mydyry
isteAn	isteɑn	isteen
insɑnlArHn	insɑnlerin	insɑnlɑrɯn
deɰiʃiklHk	deɰiʃiklɯk	deɰiʃiklik
dyzenlAnAn	dyzenlɑnɑn	dyzenlenen
birAr	birɑr	birer
jyzDAn	jyzdɑn	jyzden
toplumsAl	toplumsel	toplumsɑl
kodH	kodi	kodu
sonA	sone	sonɑ
rɑporH	rɑpori	rɑporu
sorumlH	sorumli	sorumlu
gynmHzDA	gynmizde	gynmyzde
ʧoʤuklAr	ʧoʤukler	ʧoʤuklɑr
olDHklArH	oldikleri	olduklɑrɯ
sorunlArH	sorunleri	sorunlɑrɯ
geliʃmA	geliʃmɑ	geliʃme
konulArDA	konulɑrde	konulɑrdɑ
yrynlAr	yrynlɑr	yrynler
dɑlH	dɑli	dɑlɯ
kɑjnɑklArH	kɑjnɑkleri	kɑjnɑklɑrɯ
sonuʧlArH	sonuʧleri	sonuʧlɑrɯ
hɑlkHn	hɑlkin	hɑlkɯn
bɑʃDA	bɑʃte	bɑʃtɑ
ermAnH	ermɑnɯ	ermeni
dyzejDA	dyzejdɑ	dyzejde
formH	formi	formu
progrɑmlArH	progrɑmleri	progrɑmlɑrɯ
ʧoʤuklArHn	ʧoʤuklerin	ʧoʤuklɑrɯn
jerlArDA	jerlɑrde	jerlerde
jɯllAr	jɯller	jɯllɑr
gynDA	gyndɑ	gynde
kurumsAl	kurumsel	kurumsɑl
bølymDA	bølymdɑ	bølymde
tyrH	tyri	tyry
genʧlHk	genʧlɯk	genʧlik
hɑstɑlArDA	hɑstɑlɑrde	hɑstɑlɑrdɑ
ønmHzDAki	ønmizdeki	ønmyzdeki
hɑjɑtA	hɑjɑte	hɑjɑtɑ
ɑmɑʧlH	ɑmɑʧli	ɑmɑʧlɯ
vermA	vermɑ	verme
jønDA	jøndɑ	jønde
etmAH	etmɑɯ	etmei
kurulHHn	kuruliin	kuruluun
miktɑrDA	miktɑrde	miktɑrdɑ
kuruluʃlArH	kuruluʃleri	kuruluʃlɑrɯ
ujɑrHnʤA	ujɑrinʤe	ujɑrɯnʤɑ
sɯnɯrlH	sɯnɯrli	sɯnɯrlɯ
jɑjɯnlArH	jɑjɯnleri	jɑjɯnlɑrɯ
etmAA	etmɑɑ	etmee
kontrolH	kontroli	kontroly
ɑlHp	ɑlip	ɑlɯp
gøzDAn	gøzdɑn	gøzden
ʧɯkHʃ	ʧɯkiʃ	ʧɯkɯʃ
tɑrihDAn	tɑrihtɑn	tɑrihten
ʃejH	ʃejɯ	ʃeji
sektørH	sektøri	sektøry
ɑlɑnlArDA	ɑlɑnlɑrde	ɑlɑnlɑrdɑ
belirtAn	belirtɑn	belirten
ɑnlɑmlH	ɑnlɑmli	ɑnlɑmlɯ
jɑpDHklArH	jɑpdikleri	jɑptɯklɑrɯ
hɑlkA	hɑlke	hɑlkɑ
koʃullArH	koʃulleri	koʃullɑrɯ
ʧɑlɯʃmAlArnA	ʧɑlɯʃmelerne	ʧɑlɯʃmɑlɑrnɑ
kuruluʃlAr	kuruluʃler	kuruluʃlɑr
ʃɑrtlArH	ʃɑrtleri	ʃɑrtlɑrɯ
sɯnɯrlArH	sɯnɯrleri	sɯnɯrlɑrɯ
søzH	søzi	søzy
jɑrɑrlH	jɑrɑrli	jɑrɑrlɯ
øɰrenmA	øɰrenmɑ	øɰrenme
kurumlAr	kurumler	kurumlɑr
zɑmɑnlArDA	zɑmɑnlɑrde	zɑmɑnlɑrdɑ
kɑjɯtlH	kɑjɯtli	kɑjɯtlɯ
hɑstɑlɯklArH	hɑstɑlɯkleri	hɑstɑlɯklɑrɯ
gynHn	gynin	gynyn
yrynH	yryni	yryny
progrɑmlAr	progrɑmler	progrɑmlɑr
hɯzH	hɯzi	hɯzɯ
ʧøzymH	ʧøzymi	ʧøzymy
inʤelAnmAH	inʤelenmɑɯ	inʤelenmei
sɯnɑvH	sɯnɑvu	sɯnɑvɯ
ønDA	øndɑ	ønde
koruHʤH	koruiʤi	koruuʤu
tɑrihDA	tɑrihtɑ	tɑrihte
getirmA	getirmɑ	getirme
olɑjlAr	olɑjler	olɑjlɑr
olmAlArH	olmeleri	olmɑlɑrɯ
kɑrʃɯlɯklH	kɑrʃɯlɯkli	kɑrʃɯlɯklɯ
kɑjnɑklAr	kɑjnɑkler	kɑjnɑklɑr
kuruluʃH	kuruluʃɯ	kuruluʃu
bɑkHʃ	bɑkiʃ	bɑkɯʃ
vermAA	vermɑɑ	vermee
verArAk	verɑrɑk	vererek
insɑnlArH	insɑnleri	insɑnlɑrɯ
sektørHn	sektørin	sektøryn
kuruluʃlArHn	kuruluʃlerin	kuruluʃlɑrɯn
rolH	roli	roly
dynjɑDAki	dynjɑteki	dynjɑdɑki
yrynHn	yrynin	yrynyn
jerlAr	jerlɑr	jerler
kɑrɑrlArH	kɑrɑrleri	kɑrɑrlɑrɯ
olmADAn	olmɑdɑn	olmɑtɑn
etDHklArH	etdikleri	ettikleri
fɑrkH	fɑrki	fɑrkɯ
esɑslArH	esɑsleri	esɑslɑrɯ
ryjɑDA	ryjɑte	ryjɑdɑ
jɯllArH	jɯlleri	jɯllɑrɯ
sektørHHn	sektøriin	sektøryyn
kurumlArH	kurumleri	kurumlɑrɯ
jɯlHHn	jɯliin	jɯlɯɯn
ʧoʤuklArH	ʧoʤukleri	ʧoʤuklɑrɯ
olɑnɑklArH	olɑnɑkleri	olɑnɑklɑrɯ
gørevA	gørevɑ	gøreve
hɑklH	hɑkli	hɑklɯ
kɑpsɑmlH	kɑpsɑmli	kɑpsɑmlɯ
hɑberleʃmA	hɑberleʃmɑ	hɑberleʃme
ɑɰɯrlɯklH	ɑɰɯrlɯkli	ɑɰɯrlɯklɯ
konsejH	konsejɯ	konseji
jɑʃlH	jɑʃli	jɑʃlɯ
ʃɑrtlAr	ʃɑrtler	ʃɑrtlɑr
hɑberlAr	hɑberlɑr	hɑberler
geleʤekDA	geleʤektɑ	geleʤekte
devɑmlH	devɑmli	devɑmlɯ
jolDA	jolde	joldɑ
sorunlArHn	sorunlerin	sorunlɑrɯn
jollArH	jolleri	jollɑrɯ
køjH	køjɯ	køjy
sɑɑtH	sɑɑtɯ	sɑɑti
konuDAki	konuteki	konudɑki
numɑrɑlH	numɑrɑli	numɑrɑlɯ
konuA	konue	konuɑ
etkilAAn	etkilɑɑn	etkileen
gelmAH	gelmɑɯ	gelmei
fɑjdɑlH	fɑjdɑli	fɑjdɑlɯ
mimɑrlHk	mimɑrlik	mimɑrlɯk
temizlHk	temizlɯk	temizlik
tɑrɯmsAl	tɑrɯmsel	tɑrɯmsɑl
esɑslAr	esɑsler	esɑslɑr
kurɑllArH	kurɑlleri	kurɑllɑrɯ
dyzejH	dyzejɯ	dyzeji
tɑbɑnlH	tɑbɑnli	tɑbɑnlɯ
sɑhiplArH	sɑhiplɑrɯ	sɑhipleri
ʧɑlɯʃɑnlArHn	ʧɑlɯʃɑnlerin	ʧɑlɯʃɑnlɑrɯn
ʧɑlɯʃmAlArHn	ʧɑlɯʃmelerin	ʧɑlɯʃmɑlɑrɯn
jɯlDAn	jɯlden	jɯldɑn
uluslAr	ulusler	uluslɑr
genʧlAr	genʧlɑr	genʧler
ʧekAn	ʧekɑn	ʧeken
døkymH	døkymi	døkymy
olɑjlArH	olɑjleri	olɑjlɑrɯ
girmA	girmɑ	girme
tymH	tymi	tymy
øɰrenmA	øɰrenmɑ	øɰrenme
ɑlDHklArH	ɑltikleri	ɑldɯklɑrɯ
etkinlHk	etkinlɯk	etkinlik
gynlAr	gynlɑr	gynler
dyzenlAnmAH	dyzenlɑnmɑɯ	dyzenlenmei
ujgulɑmɑlH	ujgulɑmɑli	ujgulɑmɑlɯ
zɑrɑrlH	zɑrɑrli	zɑrɑrlɯ
ʧɑlɯʃmAlArDA	ʧɑlɯʃmɑlɑrde	ʧɑlɯʃmɑlɑrdɑ
hɑlkHHn	hɑlkiin	hɑlkɯɯn
ɑʧAn	ɑʧen	ɑʧɑn
etmADA	etmede	etmete
jønDAn	jøndɑn	jønden
geliʃmAH	geliʃmɑɯ	geliʃmei
kɑjɯtlArH	kɑjɯtleri	kɑjɯtlɑrɯ
ɑdɑjlAr	ɑdɑjler	ɑdɑjlɑr
beklAnAn	beklɑnɑn	beklenen
gøstermA	gøstermɑ	gøsterme
fijɑtlArH	fijɑtleri	fijɑtlɑrɯ
mutlulHk	mutlulɯk	mutluluk
evA	evɑ	eve
belirtArAk	belirtɑrɑk	belirterek
eɰitimA	eɰitimɑ	eɰitime
tɑrɑfH	tɑrɑfi	tɑrɑfɯ
bølgeDAki	bølgeteki	bølgedeki
usulH	usulu	usuly
ɑʃkHn	ɑʃkin	ɑʃkɯn
ødylH	ødyli	ødyly
jyzjɯlDA	jyzjɯlde	jyzjɯldɑ
bojutlH	bojutli	bojutlu
ʧɑlɯʃmAlArHHn	ʧɑlɯʃmeleriin	ʧɑlɯʃmɑlɑrɯɯn
hukukH	hukuki	hukuku
kurɑllAr	kurɑller	kurɑllɑr
tɑrihsAl	tɑrihsɑl	tɑrihsel
ʧoʤuklArA	ʧoʤuklere	ʧoʤuklɑrɑ
koʃullAr	koʃuller	koʃullɑr
gynmHzA	gynmize	gynmyze
jɑzmA	jɑzme	jɑzmɑ
kɑblosHz	kɑblosiz	kɑblosuz
kɑdɯnlArHn	kɑdɯnlerin	kɑdɯnlɑrɯn
rɑporlArH	rɑporleri	rɑporlɑrɯ
kurtulHʃ	kurtuliʃ	kurtuluʃ
kurumlArHn	kurumlerin	kurumlɑrɯn
hɑjɑtHn	hɑjɑtin	hɑjɑtɯn
notH	notɯ	notu
vermAH	vermɑɯ	vermei
tedbirlAr	tedbirlɑr	tedbirler
olmAksHzHn	olmeksizin	olmɑksɯzɯn
ɑkɯllH	ɑkɯlli	ɑkɯllɯ
eserlAr	eserlɑr	eserler
ʃejHn	ʃejɯn	ʃejin
bulunDHklArH	bulundikleri	bulunduklɑrɯ
jønetmelikDA	jønetmeliktɑ	jønetmelikte
denizlH	denizlɯ	denizli
ɑrɑʃtɯrmAlArH	ɑrɑʃtɯrmeleri	ɑrɑʃtɯrmɑlɑrɯ
kutsAl	kutsel	kutsɑl
bizDAn	bizdɑn	bizden
koʃullArDA	koʃullerde	koʃullɑrdɑ
nitelikDA	niteliktɑ	nitelikte
kɯzH	kɯzi	kɯzɯ
gynmHz	gynmiz	gynmyz
øɰretmenlAr	øɰretmenlɑr	øɰretmenler
ileriDA	ilerite	ileride
bojutH	bojutɯ	bojutu
ɑlHʃ	ɑliʃ	ɑlɯʃ
sigortɑlH	sigortɑli	sigortɑlɯ
durumlArH	durumleri	durumlɑrɯ
okulHn	okulin	okulun
rɑporDA	rɑportɑ	rɑpordɑ
hɑklAr	hɑkler	hɑklɑr
okulDA	okultɑ	okuldɑ
ɑrɯtmA	ɑrɯtme	ɑrɯtmɑ
durumlAr	durumler	durumlɑr
hɑstɑlɯklAr	hɑstɑlɯkler	hɑstɑlɯklɑr
kiʃiDAn	kiʃiten	kiʃiden
tɑrihA	tɑrihɑ	tɑrihe
ɑvukɑtlHk	ɑvukɑtlik	ɑvukɑtlɯk
kɑtlH	kɑtli	kɑtlɯ
mɑlHn	mɑlin	mɑlɯn
sɯnɯfH	sɯnɯfi	sɯnɯfɯ
etmAH	etmɑɯ	etmei
ihtijɑʧlArH	ihtijɑʧleri	ihtijɑʧlɑrɯ
øzgyrlHk	øzgyrlik	øzgyrlyk
ɑrkɑdɑʃlArH	ɑrkɑdɑʃleri	ɑrkɑdɑʃlɑrɯ
kuruluʃlArHHn	kuruluʃleriin	kuruluʃlɑrɯɯn
jɯllArHn	jɯllerin	jɯllɑrɯn
jolDAn	jolden	joldɑn
kɑjnɑklArHn	kɑjnɑklerin	kɑjnɑklɑrɯn
ɑdɑjlArHn	ɑdɑjlerin	ɑdɑjlɑrɯn
ønlAnmAH	ønlɑnmɑɯ	ønlenmei
stɑndɑrtlArH	stɑndɑrtleri	stɑndɑrtlɑrɯ
bilmA	bilmɑ	bilme
geliʃmADA	geliʃmɑdɑ	geliʃmete
jyzH	jyzi	jyzy
jɑrɑtmA	jɑrɑtme	jɑrɑtmɑ
esɑslArA	esɑslere	esɑslɑrɑ
girmAH	girmɑɯ	girmei
ujgunlHk	ujgunlɯk	ujgunluk
jønH	jøni	jøny
kurulHn	kurulin	kurulun
komutH	komutɯ	komutu
gerʧeklAʃAn	gerʧeklɑʃɑn	gerʧekleʃen
olHnʤA	olinʤe	olunʤɑ
kɯrsAl	kɯrsel	kɯrsɑl
kuruluʃHn	kuruluʃin	kuruluʃun
ɑʧmA	ɑʧme	ɑʧmɑ
fɑrklHlHk	fɑrklilik	fɑrklɯlɯk
tɑleplArH	tɑleplɑrɯ	tɑlepleri
yʧDA	yʧtɑ	yʧte
ɑʧmA	ɑʧme	ɑʧmɑ
fonksijonlArH	fonksijonleri	fonksijonlɑrɯ
eɰitimDA	eɰitimdɑ	eɰitimde
tiplArH	tiplɑrɯ	tipleri
tutmA	tutme	tutmɑ
bɑʃlɯklH	bɑʃlɯkli	bɑʃlɯklɯ
kɑrʃɯmHzA	kɑrʃɯmize	kɑrʃɯmɯzɑ
iʃDAn	iʃtɑn	iʃten
kolH	koli	kolu
kuruluʃlArA	kuruluʃlere	kuruluʃlɑrɑ
tɑrɑflAr	tɑrɑfler	tɑrɑflɑr
hɑklArHHn	hɑkleriin	hɑklɑrɯɯn
fijɑtlAr	fijɑtler	fijɑtlɑr
girArAk	girɑrɑk	girerek
kurɑllArA	kurɑllere	kurɑllɑrɑ
kɑjnɑklArHHn	kɑjnɑkleriin	kɑjnɑklɑrɯɯn
ɑdlArH	ɑdleri	ɑdlɑrɯ
ʤihɑzlAr	ʤihɑzler	ʤihɑzlɑr
mɑlH	mɑli	mɑlɯ
progrɑmlArHHn	progrɑmleriin	progrɑmlɑrɯɯn
kɑrtlArH	kɑrtleri	kɑrtlɑrɯ
ojunlArH	ojunleri	ojunlɑrɯ
ɑmɑʧlArH	ɑmɑʧleri	ɑmɑʧlɑrɯ
kuʃkusHz	kuʃkusiz	kuʃkusuz
geriDA	gerite	geride
ʧɑlɯʃɑnlArH	ʧɑlɯʃɑnleri	ʧɑlɯʃɑnlɑrɯ
ɑlɑnDAki	ɑlɑnteki	ɑlɑndɑki
ʤihɑzlArH	ʤihɑzleri	ʤihɑzlɑrɯ
sessHz	sessɯz	sessiz
suA	sue	suɑ
performɑnsH	performɑnsu	performɑnsɯ
ɑrkɑdɑʃlAr	ɑrkɑdɑʃler	ɑrkɑdɑʃlɑr
dyzenlAnAʤAk	dyzenlɑnɑʤɑk	dyzenleneʤek
jollAr	joller	jollɑr
gørHnʤA	gørinʤe	gørynʤe
hɑksHz	hɑksiz	hɑksɯz
jɑpɯlArHn	jɑpɯlerin	jɑpɯlɑrɯn
desteklAAn	desteklɑɑn	destekleen
ɑrkɑdɑʃlArm	ɑrkɑdɑʃlerm	ɑrkɑdɑʃlɑrm
eʃlHk	eʃlɯk	eʃlik
tɯklAArAk	tɯkleerek	tɯklɑɑrɑk
tɑrzH	tɑrzi	tɑrzɯ
tuʃH	tuʃɯ	tuʃu
ʃejA	ʃejɑ	ʃeje
ortɑmlArDA	ortɑmlerde	ortɑmlɑrdɑ
plɑnlArH	plɑnleri	plɑnlɑrɯ
sonsHz	sonsɯz	sonsuz
jɑpmADA	jɑpmede	jɑpmɑtɑ
jɑtɯrɯmlArH	jɑtɯrɯmleri	jɑtɯrɯmlɑrɯ
sizDAn	sizdɑn	sizden
soɰutmA	soɰutme	soɰutmɑ
kɑvrɑmlAr	kɑvrɑmler	kɑvrɑmlɑr
kɑvrɑmlArH	kɑvrɑmleri	kɑvrɑmlɑrɯ
fɑrklHlHklAr	fɑrklilikler	fɑrklɯlɯklɑr
orgɑnlArH	orgɑnleri	orgɑnlɑrɯ
dikkɑtH	dikkɑtɯ	dikkɑti
jɑzmA	jɑzme	jɑzmɑ
jɑpmAnHz	jɑpmɑniz	jɑpmɑnɯz
bɑʃlH	bɑʃli	bɑʃlɯ
mɑllArHn	mɑllerin	mɑllɑrɯn
doɰumlH	doɰumli	doɰumlu
okullArDA	okullerde	okullɑrdɑ
dɑvrɑnHʃlArH	dɑvrɑniʃleri	dɑvrɑnɯʃlɑrɯ
dujgusAl	dujgusel	dujgusɑl
ʧoʤuklHk	ʧoʤuklɯk	ʧoʤukluk
uʧHʃ	uʧiʃ	uʧuʃ
ʃɑrtlArDA	ʃɑrtlerde	ʃɑrtlɑrdɑ
jolHn	jolin	jolun
ʃɑnsH	ʃɑnsu	ʃɑnsɯ
fotoɰrɑflAr	fotoɰrɑfler	fotoɰrɑflɑr
ʃejDAn	ʃejdɑn	ʃejden
dolɑrlHk	dolɑrlik	dolɑrlɯk
ʧɯkHp	ʧɯkup	ʧɯkɯp
ɑlɑnlArHn	ɑlɑnlerin	ɑlɑnlɑrɯn
gelirlAr	gelirlɑr	gelirler
kɑrɑrlH	kɑrɑrli	kɑrɑrlɯ
fotoɰrɑflArH	fotoɰrɑfleri	fotoɰrɑflɑrɯ
bølymHn	bølymin	bølymyn
birejHn	birejɯn	birejin
ɑjɑrlArH	ɑjɑrleri	ɑjɑrlɑrɯ
jykH	jyki	jyky
kɑnɑlH	kɑnɑli	kɑnɑlɯ
kɑjnɑklH	kɑjnɑkli	kɑjnɑklɯ
okullAr	okuller	okullɑr
jɯllArA	jɯllere	jɯllɑrɑ
progrɑmlArHn	progrɑmlerin	progrɑmlɑrɯn
syreʧDA	syreʧtɑ	syreʧte
uzmɑnlArH	uzmɑnleri	uzmɑnlɑrɯ
mɑllAr	mɑller	mɑllɑr
tɑrɑflH	tɑrɑfli	tɑrɑflɯ
yretimA	yretimɑ	yretime
bølymHHn	bølymiin	bølymyyn
doɰruA	doɰrue	doɰruɑ
kɑdɯnlArDA	kɑdɯnlɑrde	kɑdɯnlɑrdɑ
rɑporHn	rɑporin	rɑporun
tytynHn	tytynin	tytynyn
sɑnɑtlAr	sɑnɑtler	sɑnɑtlɑr
zɑmɑnlH	zɑmɑnli	zɑmɑnlɯ
plɑnlH	plɑnli	plɑnlɯ
ɑjdɯnlɑtmA	ɑjdɯnlɑtme	ɑjdɯnlɑtmɑ
kullAnHʤHA	kulleniʤie	kullɑnɯʤɯɑ
vermADAn	vermɑdɑn	vermeden
jyklH	jykli	jykly
kyresAllAʃmA	kyreselleʃmɑ	kyreselleʃme
tɑbloDA	tɑblode	tɑblodɑ
bulunmADA	bulunmɑdɑ	bulunmɑtɑ
hukukHn	hukukin	hukukun
nyfusHn	nyfusɯn	nyfusun
nolH	noli	nolu
sɑklH	sɑkli	sɑklɯ
ʧoklH	ʧokli	ʧoklu
geʤikmA	geʤikmɑ	geʤikme
hɑtlArH	hɑtleri	hɑtlɑrɯ
kurullArH	kurulleri	kurullɑrɯ
kurumlArA	kurumlere	kurumlɑrɑ
dinlenmA	dinlenmɑ	dinlenme
dyzejA	dyzejɑ	dyzeje
gøndermA	gøndermɑ	gønderme
bɑʃkɑnlArH	bɑʃkɑnleri	bɑʃkɑnlɑrɯ
okullArH	okulleri	okullɑrɯ
tytynlAr	tytynlɑr	tytynler
bojutlArH	bojutleri	bojutlɑrɯ
ɑdɑmlArH	ɑdɑmleri	ɑdɑmlɑrɯ
ɑnlɑtmA	ɑnlɑtme	ɑnlɑtmɑ
byjyAn	byjyɑn	byjyen
hɑstɑlɯklArHn	hɑstɑlɯklerin	hɑstɑlɯklɑrɯn
deɰerlendirmAH	deɰerlendirmɑɯ	deɰerlendirmei
stɑndɑrtlArA	stɑndɑrtlere	stɑndɑrtlɑrɑ
jyryHʃ	jyryiʃ	jyryyʃ
ɑrɑpʧA	ɑrɑpʧe	ɑrɑpʧɑ
doɰrultuDA	doɰrultutɑ	doɰrultudɑ
gøzH	gøzi	gøzy
køjHn	køjɯn	køjyn
ɑkHʃH	ɑkiʃi	ɑkɯʃɯ
sojɑdH	sojɑdi	sojɑdɯ
memurlArH	memurleri	memurlɑrɯ
fotoɰrɑfH	fotoɰrɑfi	fotoɰrɑfɯ
stɑndɑrtlAr	stɑndɑrtler	stɑndɑrtlɑr
ølAn	ølɑn	ølen
byroH	byroi	byrou
silmA	silmɑ	silme
gøsterArAk	gøsterɑrɑk	gøstererek
kɑbulH	kɑbulu	kɑbuly
kurulmHz	kurulmiz	kurulmuz
ɑlɑnlArHHn	ɑlɑnleriin	ɑlɑnlɑrɯɯn
vermAH	vermɑɯ	vermei
ɑrɑʧlArHn	ɑrɑʧlerin	ɑrɑʧlɑrɯn
getirArAk	getirɑrɑk	getirerek
kurumlArHHn	kurumleriin	kurumlɑrɯɯn
mesɑʒlAr	mesɑʒler	mesɑʒlɑr
dyʃynmA	dyʃynmɑ	dyʃynme
tɑʃɯHʤH	tɑʃɯiʤi	tɑʃɯɯʤɯ
bølymDAn	bølymdɑn	bølymden
kɑjɯtlAr	kɑjɯtler	kɑjɯtlɑr
ɑslH	ɑsli	ɑslɯ
gørynymH	gørynymi	gørynymy
ilɑʧlArHn	ilɑʧlerin	ilɑʧlɑrɯn
tɑsɑrrufH	tɑsɑrrufi	tɑsɑrrufu
tɑnɯmlAr	tɑnɯmler	tɑnɯmlɑr
tɑrihlArDA	tɑrihlɑrde	tɑrihlerde
gørevDAn	gørevtɑn	gørevden
kendimA	kendimɑ	kendime
ʧɯkHʃH	ʧɯkiʃi	ʧɯkɯʃɯ
dostlHk	dostlik	dostluk
kursH	kursi	kursu
metinlAr	metinlɑr	metinler
kɑdroH	kɑdroi	kɑdrou
geliʃmAlArA	geliʃmɑlɑrɑ	geliʃmelere
giderlAr	giderlɑr	giderler
jɑzɯlɯmlArH	jɑzɯlɯmleri	jɑzɯlɯmlɑrɯ
gelmA	gelmɑ	gelme
seklHnDA	seklɯndɑ	seklinde
elemɑnlArHHn	elemɑnleriin	elemɑnlɑrɯɯn
kontrollH	kontrolli	kontrolly
jyzejH	jyzejɯ	jyzeji
jɑpmADAn	jɑpmeden	jɑpmɑdɑn
jɯllArDAn	jɯllerden	jɯllɑrdɑn
bilgisɑjɑrDA	bilgisɑjɑrde	bilgisɑjɑrdɑ
olAbilmA	olɑbilmɑ	olɑbilme
vɑkɯflAr	vɑkɯfler	vɑkɯflɑr
ʧoʤuklArHHn	ʧoʤukleriin	ʧoʤuklɑrɯɯn
motorlH	motorli	motorlu
jɑʃDA	jɑʃte	jɑʃtɑ
sorunlArHHn	sorunleriin	sorunlɑrɯɯn
notlArH	notleri	notlɑrɯ
olmAnHz	olmɑniz	olmɑnɯz
sɯnɑvlArH	sɯnɑvleri	sɯnɑvlɑrɯ
modylH	modyli	modyly
ujgulɑmɑlArDA	ujgulɑmɑlɑrde	ujgulɑmɑlɑrdɑ
tɑrɑfHn	tɑrɑfin	tɑrɑfɯn
ɑdHHn	ɑdiin	ɑdɯɯn
sɑnɑtlArH	sɑnɑtleri	sɑnɑtlɑrɯ
seminerlAr	seminerlɑr	seminerler
bɑbɑHHn	bɑbɑiin	bɑbɑɯɯn
kollArH	kolleri	kollɑrɯ
sendromH	sendromi	sendromu
unsurH	unsuri	unsuru
herʃejH	herʃejɯ	herʃeji
sonuʧlArHHn	sonuʧleriin	sonuʧlɑrɯɯn
renkDA	renktɑ	renkte
sɯnɑvlAr	sɯnɑvler	sɯnɑvlɑr
ɑlmADA	ɑlmɑdɑ	ɑlmɑtɑ
plɑtformH	plɑtformi	plɑtformu
burɑlArDA	burɑlɑrde	burɑlɑrdɑ
gørmAH	gørmɑɯ	gørmei
hɑtɑlH	hɑtɑli	hɑtɑlɯ
sorumlHlHklArH	sorumlilikleri	sorumluluklɑrɯ
tɑnɯmlArH	tɑnɯmleri	tɑnɯmlɑrɯ
prensiplArH	prensiplɑrɯ	prensipleri
olDHkDAn	oldiktɑn	olduktɑn
iʃsHzlHk	iʃsizlɯk	iʃsizlik
øɰretmenlHk	øɰretmenlɯk	øɰretmenlik
fɑɑlijetDA	fɑɑlijettɑ	fɑɑlijette
girmA	girmɑ	girme
ʧɑlɯʃmAlArmHz	ʧɑlɯʃmɑlɑrmiz	ʧɑlɯʃmɑlɑrmɯz
bɑjɯndɯrlHk	bɑjɯndɯrlik	bɑjɯndɯrlɯk
ørgytHn	ørgytin	ørgytyn
bildirmA	bildirmɑ	bildirme
deɰiʃmAH	deɰiʃmɑɯ	deɰiʃmei
fotoɰrɑfHn	fotoɰrɑfin	fotoɰrɑfɯn
tɑrɑflArHn	tɑrɑflerin	tɑrɑflɑrɯn
zijɑretʧH	zijɑretʧɯ	zijɑretʧi
egemenlHk	egemenlɯk	egemenlik
sonuʧlArA	sonuʧlere	sonuʧlɑrɑ
firmɑmHz	firmɑmiz	firmɑmɯz
jɑprɑklArH	jɑprɑkleri	jɑprɑklɑrɯ
gøndermA	gøndermɑ	gønderme
gøstermAH	gøstermɑɯ	gøstermei
kɑrʃɯnHzA	kɑrʃɯnize	kɑrʃɯnɯzɑ
jyrytAn	jyrytɑn	jyryten
hɑklArHn	hɑklerin	hɑklɑrɯn
sigortɑlHHn	sigortɑliin	sigortɑlɯɯn
suʧH	suʧi	suʧu
yretimDA	yretimdɑ	yretimde
konferɑnsH	konferɑnsu	konferɑnsɯ
krɑlH	krɑli	krɑlɯ
mɑllArH	mɑlleri	mɑllɑrɯ
ɑdɯmlAr	ɑdɯmler	ɑdɯmlɑr
deɰerlendirmAA	deɰerlendirmɑɑ	deɰerlendirmee
dɑllArH	dɑlleri	dɑllɑrɯ
ijilAʃmA	ijileʃmɑ	ijileʃme
kɑrɑrlArHn	kɑrɑrlerin	kɑrɑrlɑrɯn
sɯnɑvDA	sɯnɑvde	sɯnɑvdɑ
topH	topi	topu
ylkeDAki	ylketeki	ylkedeki
ɑkHʃ	ɑkiʃ	ɑkɯʃ
hɑlkmHzHn	hɑlkmizin	hɑlkmɯzɯn
ɑʧArAk	ɑʧerek	ɑʧɑrɑk
ɑlmAlArH	ɑlmeleri	ɑlmɑlɑrɯ
miktɑrlArDA	miktɑrlɑrde	miktɑrlɑrdɑ
okullArHn	okullerin	okullɑrɯn
nedenlAr	nedenlɑr	nedenler
ɑtɯklArHn	ɑtɯklerin	ɑtɯklɑrɯn
kimA	kimɑ	kime
olɑnɑklAr	olɑnɑkler	olɑnɑklɑr
soruA	sorue	soruɑ
protokolH	protokoli	protokoly
rɑhɑtʧA	rɑhɑtʧe	rɑhɑtʧɑ
suretDA	surettɑ	surette
tutmA	tutme	tutmɑ
gørHp	gørup	gøryp
kɑnɑllArH	kɑnɑlleri	kɑnɑllɑrɯ
olHʃH	oliʃi	oluʃu
ɑrkɑdɑʃlArmHz	ɑrkɑdɑʃlermiz	ɑrkɑdɑʃlɑrmɯz
olAbilmAH	olɑbilmɑɯ	olɑbilmei
jɑpmAlArH	jɑpmeleri	jɑpmɑlɑrɯ
ɯsɯtmA	ɯsɯtme	ɯsɯtmɑ
bɑʃlɑHp	bɑʃlɑip	bɑʃlɑɯp
ʤinsH	ʤinsu	ʤinsi
kɯsɯtlH	kɯsɯtli	kɯsɯtlɯ
kɑnlH	kɑnli	kɑnlɯ
ʧɑlɯʃɑnlArHHn	ʧɑlɯʃɑnleriin	ʧɑlɯʃɑnlɑrɯɯn
dønHp	dønip	dønyp
dønmA	dønmɑ	dønme
ɑvɑntɑʒlArH	ɑvɑntɑʒleri	ɑvɑntɑʒlɑrɯ
kurulDA	kurultɑ	kuruldɑ
nyfusHHn	nyfusiin	nyfusuun
formlArH	formleri	formlɑrɯ
toprɑklArH	toprɑkleri	toprɑklɑrɯ
jɑpAbilmA	jɑpɑbilmɑ	jɑpɑbilme
vermADA	vermɑdɑ	vermete
vɑtɑndɑʃlArHn	vɑtɑndɑʃlerin	vɑtɑndɑʃlɑrɯn
kurumlArDA	kurumlerde	kurumlɑrdɑ
pɑrkH	pɑrki	pɑrkɯ
jykymlH	jykymli	jykymly
ɑlDHkDAn	ɑltiktɑn	ɑldɯktɑn
hɑjɑtHHn	hɑjɑtiin	hɑjɑtɯɯn
jɑtɯrɯmlArHn	jɑtɯrɯmlerin	jɑtɯrɯmlɑrɯn
jɑzɯlɯmlAr	jɑzɯlɯmler	jɑzɯlɯmlɑr
zorlHk	zorlik	zorluk
bɯrɑkHp	bɯrɑkip	bɯrɑkɯp
dyʃynmA	dyʃynmɑ	dyʃynme
internetDA	internettɑ	internette
dyʃmAH	dyʃmɑɯ	dyʃmei
kullɑnDHklArH	kullɑndikleri	kullɑndɯklɑrɯ
normɑlDA	normɑltɑ	normɑlde
sɑnɑtsAl	sɑnɑtsel	sɑnɑtsɑl
doɰrusAl	doɰrusel	doɰrusɑl
gruplArHn	gruplerin	gruplɑrɯn
unsurlArH	unsurleri	unsurlɑrɯ
joksullHk	joksullik	joksulluk
ɑɰlArH	ɑɰleri	ɑɰlɑrɯ
bɑʃlɯklArH	bɑʃlɯkleri	bɑʃlɯklɑrɯ
ʤihɑzlArHn	ʤihɑzlerin	ʤihɑzlɑrɯn
ekiplArH	ekiplɑrɯ	ekipleri
hedeflAAn	hedeflɑɑn	hedefleen
dostH	dosty	dostu
esneklHk	esneklɯk	esneklik
fɑktørH	fɑktøri	fɑktøry
dyʃHʃ	dyʃiʃ	dyʃyʃ
dersDAn	derstɑn	dersten
getirmAA	getirmɑɑ	getirmee
izlAnmAH	izlɑnmɑɯ	izlenmei
mezunlArH	mezunleri	mezunlɑrɯ
ruhH	ruhi	ruhu
jɑrɑtmA	jɑrɑtme	jɑrɑtmɑ
ʧekArAk	ʧekɑrɑk	ʧekerek
jykselmA	jykselmɑ	jykselme
ʧekilmAH	ʧekilmɑɯ	ʧekilmei
ɑtmA	ɑtme	ɑtmɑ
sonuʧlArHn	sonuʧlerin	sonuʧlɑrɯn
dɑvrɑnHʃlAr	dɑvrɑniʃler	dɑvrɑnɯʃlɑr
kusmA	kusme	kusmɑ
notlAr	notler	notlɑr
sɑvɑʃDA	sɑvɑʃte	sɑvɑʃtɑ
seʧimA	seʧimɑ	seʧime
ʧɑplH	ʧɑpli	ʧɑplɯ
kɑrlH	kɑrli	kɑrlɯ
olɑjlArA	olɑjlere	olɑjlɑrɑ
jɑrɑlH	jɑrɑli	jɑrɑlɯ
øzlHk	øzlɯk	øzlyk
merkezlH	merkezlɯ	merkezli
ønʤylHk	ønʤylɯk	ønʤylyk
ɑlɑʤɑklArH	ɑlɑʤɑkleri	ɑlɑʤɑklɑrɯ
etmAnHz	etmɑniz	etmeniz
kyltyrHHn	kyltyriin	kyltyryyn
koʃullArHn	koʃullerin	koʃullɑrɯn
jɑklɑʃɯmlAr	jɑklɑʃɯmler	jɑklɑʃɯmlɑr
hykymlH	hykymli	hykymly
toplɑntɯlArDA	toplɑntɯlɑrde	toplɑntɯlɑrdɑ
tutɑrlH	tutɑrli	tutɑrlɯ
dɑlHʃ	dɑliʃ	dɑlɯʃ
gørmAA	gørmɑɑ	gørmee
geʧDHkʧA	geʧdikʧɑ	geʧtikʧe
pɑzɑrDA	pɑzɑrde	pɑzɑrdɑ
jɑpDHkDAn	jɑpdiktɑn	jɑptɯktɑn
evDAn	evtɑn	evden
hukuksAl	hukuksel	hukuksɑl
kɯsɯmlArH	kɯsɯmleri	kɯsɯmlɑrɯ
jɑpAʤAklArH	jɑpɑʤɑkleri	jɑpɑʤɑklɑrɯ
bolH	boli	bolu
etmAAn	etmɑɑn	etmeen
ʧɑlɯʃmADA	ʧɑlɯʃmɑdɑ	ʧɑlɯʃmɑtɑ
koʃullArA	koʃullere	koʃullɑrɑ
ɑlAbilmA	ɑlɑbilmɑ	ɑlɑbilme
bɑʃkɑnmHz	bɑʃkɑnmiz	bɑʃkɑnmɯz
esɑslH	esɑsli	esɑslɯ
gørDHklArH	gørdikleri	gørdykleri
koʃullArHHn	koʃulleriin	koʃullɑrɯɯn
ɑjlArDA	ɑjlerde	ɑjlɑrdɑ
konAn	konen	konɑn
sorunsHz	sorunsɯz	sorunsuz
getirmA	getirmɑ	getirme
kɑjnɑklArA	kɑjnɑklere	kɑjnɑklɑrɑ
menyDAn	menytɑn	menyden
tɑmɑmlAmA	tɑmɑmleme	tɑmɑmlɑmɑ
jɑʃɑDHklArH	jɑʃɑtɯkleri	jɑʃɑdɯklɑrɯ
ɑʧɯklɑmAlArH	ɑʧɯklɑmeleri	ɑʧɯklɑmɑlɑrɯ
ɑvɑntɑʒlAr	ɑvɑntɑʒler	ɑvɑntɑʒlɑr
geliʃmAA	geliʃmɑɑ	geliʃmee
ɑrɑʧlArHHn	ɑrɑʧleriin	ɑrɑʧlɑrɯɯn
orɑDAki	orɑteki	orɑdɑki
desteklAnmAH	desteklɑnmɑɯ	desteklenmei
edinmA	edinmɑ	edinme
kriterlAr	kriterlɑr	kriterler
olmADHkʧA	olmɑtɯkʧɑ	olmɑdɯkʧɑ
telefonlArH	telefonleri	telefonlɑrɯ
tuzlH	tuzlɯ	tuzlu
vɑkɑlArDA	vɑkɑlɑrde	vɑkɑlɑrdɑ
geliʃmAHn	geliʃmɑɯn	geliʃmein
olmADA	olmɑdɑ	olmɑtɑ
gruplArHHn	grupleriin	gruplɑrɯɯn
okulDAn	okultɑn	okuldɑn
depremDAn	depremdɑn	depremden
konuHHn	konuiin	konuuun
vermAAn	vermɑɑn	vermeen
ɑjlAr	ɑjler	ɑjlɑr
kuruluʃlArDA	kuruluʃlerde	kuruluʃlɑrdɑ
mesɑʒlArH	mesɑʒleri	mesɑʒlɑrɯ
motorH	motori	motoru
progrɑmlArA	progrɑmlere	progrɑmlɑrɑ
sporlArH	sporleri	sporlɑrɯ
gøzlAnAn	gøzlɑnɑn	gøzlenen
kuruluʃHHn	kuruluʃiin	kuruluʃuun
kutlH	kutli	kutlu
ɑskerlAr	ɑskerlɑr	ɑskerler
hɑrʤɑmAlArH	hɑrʤɑmeleri	hɑrʤɑmɑlɑrɯ
hususDA	hususte	husustɑ
jerlArDAn	jerlɑrden	jerlerden
deɰiʃimA	deɰiʃimɑ	deɰiʃime
geʧDHkDAn	geʧdiktɑn	geʧtikten
kitɑplArHn	kitɑplerin	kitɑplɑrɯn
suDAn	sutɑn	sudɑn
dønemDAki	dønemdɑki	dønemdeki
kyltyrHn	kyltyrin	kyltyryn
odɑklH	odɑkli	odɑklɯ
rɑstlAnAn	rɑstlenen	rɑstlɑnɑn
jyzejA	jyzejɑ	jyzeje
bugynHn	bugynin	bugynyn
zorunlulHk	zorunlulɯk	zorunluluk
iʃlAnmAH	iʃlɑnmɑɯ	iʃlenmei
sevAn	sevɑn	seven
tɑbiplArH	tɑbiplɑrɯ	tɑbipleri
tipDA	tiptɑ	tipte
ɑtArAk	ɑterek	ɑtɑrɑk
deɰerlendirmAlAr	deɰerlendirmɑlɑr	deɰerlendirmeler
deɰiʃmA	deɰiʃmɑ	deɰiʃme
kɑlkAn	kɑlken	kɑlkɑn
tɑleplAr	tɑleplɑr	tɑlepler
eklAnAn	eklɑnɑn	eklenen
etmAHn	etmɑɯn	etmein
lisɑnsH	lisɑnsu	lisɑnsɯ
jɑprɑklAr	jɑprɑkler	jɑprɑklɑr
odɑmHz	odɑmiz	odɑmɯz
bilgisɑjɑrlArHn	bilgisɑjɑrlerin	bilgisɑjɑrlɑrɯn
hekimA	hekimɑ	hekime
rɑhɑtsHzlHk	rɑhɑtsizlɯk	rɑhɑtsɯzlɯk
tɑnɯmlH	tɑnɯmli	tɑnɯmlɯ
ɑɰɑʧlArH	ɑɰɑʧleri	ɑɰɑʧlɑrɯ
bojutlArDA	bojutlerde	bojutlɑrdɑ
gynmHzHn	gynmizin	gynmyzyn
suʧlH	suʧli	suʧlu
vɑtɑndɑʃlAr	vɑtɑndɑʃler	vɑtɑndɑʃlɑr
jɑpAlHm	jɑpɑlim	jɑpɑlɯm
dyʃmA	dyʃmɑ	dyʃme
hɑtlAr	hɑtler	hɑtlɑr
kurslArH	kursleri	kurslɑrɯ
merkezDAn	merkezdɑn	merkezden
oʤɑklArH	oʤɑkleri	oʤɑklɑrɯ
sɯrɑlArDA	sɯrɑlɑrde	sɯrɑlɑrdɑ
tɑrɑfsHz	tɑrɑfsiz	tɑrɑfsɯz
øzH	øzi	øzy
ɑvukɑtlAr	ɑvukɑtler	ɑvukɑtlɑr
binDA	bindɑ	binde
dønmAH	dønmɑɯ	dønmei
fikirlAr	fikirlɑr	fikirler
hɑjvɑnlArH	hɑjvɑnleri	hɑjvɑnlɑrɯ
isteAnlArHn	isteɑnlerin	isteenlerin
kentDA	kenttɑ	kentte
hɑstɑlɯklArA	hɑstɑlɯklere	hɑstɑlɯklɑrɑ
kɑjɯtlArHn	kɑjɯtlerin	kɑjɯtlɑrɯn
ortɑklArH	ortɑkleri	ortɑklɑrɯ
tɑmɑmlAmHʃ	tɑmɑmlemiʃ	tɑmɑmlɑmɯʃ
gidermA	gidermɑ	giderme
hɑzɯrlɯklArH	hɑzɯrlɯkleri	hɑzɯrlɯklɑrɯ
huzurlH	huzurli	huzurlu
kodlArH	kodleri	kodlɑrɯ
suʧHn	suʧin	suʧun
jɑʃlArDA	jɑʃlerde	jɑʃlɑrdɑ
etmADAn	etmeden	etmeten
krizDAn	krizdɑn	krizden
turH	turi	turu
jollArDAn	jollerden	jollɑrdɑn
yrynlArA	yrynlɑrɑ	yrynlere
ystynDAki	ystynteki	ystyndeki
kojHp	kojip	kojup
sɯnɑvlArA	sɯnɑvlere	sɯnɑvlɑrɑ
ʧɯkɑrlArH	ʧɯkɑrleri	ʧɯkɑrlɑrɯ
ønlAHʤH	ønlɑɯʤɯ	ønleiʤi
ɑlkɯʃlAr	ɑlkɯʃler	ɑlkɯʃlɑr
bɑsɯnʧlH	bɑsɯnʧli	bɑsɯnʧlɯ
bilgisɑjɑrnHzA	bilgisɑjɑrnize	bilgisɑjɑrnɯzɑ
jyryrlykDA	jyryrlyktɑ	jyryrlykte
jɑʃlArH	jɑʃleri	jɑʃlɑrɯ
eklAnmAH	eklɑnmɑɯ	eklenmei
ilɑʧlArH	ilɑʧleri	ilɑʧlɑrɯ
ortɑklAr	ortɑkler	ortɑklɑr
rɑporHHn	rɑporiin	rɑporuun
sebeplArH	sebeplɑrɯ	sebepleri
silmA	silmɑ	silme
toprɑklAr	toprɑkler	toprɑklɑr
jønetimA	jønetimɑ	jønetime
jɑtɑklH	jɑtɑkli	jɑtɑklɯ
ɑtmA	ɑtme	ɑtmɑ
kɑmuA	kɑmue	kɑmuɑ
millijetʧH	millijetʧɯ	millijetʧi
ɑrkɑdɑʃmHz	ɑrkɑdɑʃmiz	ɑrkɑdɑʃmɯz
dyzAnlAHʤH	dyzenlɑɯʤɯ	dyzenleiʤi
gørArAk	gørɑrɑk	gørerek
jyryrlykDAn	jyryrlyktɑn	jyryrlykten
jɑpɯlArDA	jɑpɯlɑrde	jɑpɯlɑrdɑ
dɑɰlArH	dɑɰleri	dɑɰlɑrɯ
gønderArAk	gønderɑrɑk	gøndererek
orduHHn	orduiin	orduuun
jollArDA	jollerde	jollɑrdɑ
bɑzɯlArHHn	bɑzɯleriin	bɑzɯlɑrɯɯn
dujDHklArH	dujdikleri	dujduklɑrɯ
okulmHz	okulmiz	okulmuz
teʃekkyrlAr	teʃekkyrlɑr	teʃekkyrler
tijɑtroH	tijɑtroi	tijɑtrou
jykseklHk	jykseklɯk	jykseklik
ʧɑlɯʃDHklArH	ʧɑlɯʃdikleri	ʧɑlɯʃtɯklɑrɯ
øɰrenmAA	øɰrenmɑɑ	øɰrenmee
ølʧymH	ølʧymi	ølʧymy
engellAAn	engellɑɑn	engelleen
izinsHz	izinsɯz	izinsiz
progrɑmlArDA	progrɑmlerde	progrɑmlɑrdɑ
girmAA	girmɑɑ	girmee
kesilmAH	kesilmɑɯ	kesilmei
sɑbɑhH	sɑbɑhi	sɑbɑhɯ
ujruklH	ujrukli	ujruklu
jɑkɯnlArH	jɑkɯnleri	jɑkɯnlɑrɯ
bilgisɑjɑrlH	bilgisɑjɑrli	bilgisɑjɑrlɯ
borʧlH	borʧli	borʧlu
gelmAA	gelmɑɑ	gelmee
hemDA	hemdɑ	hemde
kɑnunlArH	kɑnunleri	kɑnunlɑrɯ
nedenlArDAn	nedenlɑrden	nedenlerden
ɑrkɑdɑʃlArHHn	ɑrkɑdɑʃleriin	ɑrkɑdɑʃlɑrɯɯn
bilmAAn	bilmɑɑn	bilmeen
desteklAnAn	desteklɑnɑn	desteklenen
nøbetʧH	nøbetʧɯ	nøbetʧi
sɑnɑtʧHHn	sɑnɑtʧiin	sɑnɑtʧɯɯn
sebeplAr	sebeplɑr	sebepler
sistemDAn	sistemdɑn	sistemden
jerleʃmA	jerleʃmɑ	jerleʃme
dyzensHz	dyzensɯz	dyzensiz
kɑrɑrlArHHn	kɑrɑrleriin	kɑrɑrlɑrɯɯn
kuruluʃlArDAn	kuruluʃlerden	kuruluʃlɑrdɑn
jykymlHlHklArH	jykymlilikleri	jykymlylykleri
ʃɑrtlArHn	ʃɑrtlerin	ʃɑrtlɑrɯn
binɑlArDA	binɑlɑrde	binɑlɑrdɑ
sɑnɑtHn	sɑnɑtin	sɑnɑtɯn
jurtlAr	jurtler	jurtlɑr
koordinɑtørH	koordinɑtøri	koordinɑtøry
ɑrɑmHzDA	ɑrɑmizde	ɑrɑmɯzdɑ
dyzelmA	dyzelmɑ	dyzelme
gyndemDA	gyndemdɑ	gyndemde
metodlArH	metodleri	metodlɑrɯ
semptomlAr	semptomler	semptomlɑr
bitDHkDAn	bitdiktɑn	bittikten
ergenlHk	ergenlɯk	ergenlik
etDHkDAn	etdiktɑn	ettikten
hususlArH	hususleri	hususlɑrɯ
temizlAnmAH	temizlɑnmɑɯ	temizlenmei
jolHHn	joliin	joluun
benzeAn	benzeɑn	benzeen
binA	binɑ	bine
girmADAn	girmɑdɑn	girmeden
virysH	virysi	virysy
yʧlH	yʧli	yʧly
byjyklHkDA	byjyklɯktɑ	byjyklykte
dønHʃH	dønɯʃɯ	dønyʃy
kɑrtlAr	kɑrtler	kɑrtlɑr
komutlArH	komutleri	komutlɑrɯ
kusursHz	kusursiz	kusursuz
ɑjlArH	ɑjleri	ɑjlɑrɯ
fɑrsʧA	fɑrsʧe	fɑrsʧɑ
herʃejDAn	herʃejdɑn	herʃejden
sɑtmA	sɑtme	sɑtmɑ
verAbilmA	verɑbilmɑ	verebilme
dønmA	dønmɑ	dønme
konulArDAn	konulɑrden	konulɑrdɑn
jɑrɯjɯlDA	jɑrɯjɯlde	jɑrɯjɯldɑ
gøryʃmA	gøryʃmɑ	gøryʃme
gyʧlAr	gyʧlɑr	gyʧler
konferɑnslAr	konferɑnsler	konferɑnslɑr
evlenmA	evlenmɑ	evlenme
toprɑklArDA	toprɑklerde	toprɑklɑrdɑ
geliʃmAH	geliʃmɑɯ	geliʃmei
insɑnlArDA	insɑnlɑrde	insɑnlɑrdɑ
kɑrɑrlArA	kɑrɑrlere	kɑrɑrlɑrɑ
mevzuɑtA	mevzuɑte	mevzuɑtɑ
olgulArDA	olgulɑrde	olgulɑrdɑ
jɯldɯzlAr	jɯldɯzler	jɯldɯzlɑr
eɰitimDAn	eɰitimdɑn	eɰitimden
gelmADAn	gelmɑdɑn	gelmeden
mɑsonlHk	mɑsonlɯk	mɑsonluk
ɑlkollH	ɑlkolli	ɑlkolly
rektørH	rektøri	rektøry
jenilAnmAH	jenilɑnmɑɯ	jenilenmei
ɑdɑjlArH	ɑdɑjleri	ɑdɑjlɑrɯ
ɑlmAnHz	ɑlmɑniz	ɑlmɑnɯz
bɑlɯklAr	bɑlɯkler	bɑlɯklɑr
denizDAn	denizdɑn	denizden
kiʃiDA	kiʃite	kiʃide
konuklAr	konukler	konuklɑr
tɑrihlAr	tɑrihlɑr	tɑrihler
jɑpmADAn	jɑpmeden	jɑpmɑtɑn
joɰunlHk	joɰunlɯk	joɰunluk
ɑrɑDAki	ɑrɑteki	ɑrɑdɑki
bytynH	bytyni	bytyny
doɰHʃ	doɰiʃ	doɰuʃ
pijɑsɑDAki	pijɑsɑteki	pijɑsɑdɑki
prɑtikDA	prɑtiktɑ	prɑtikte
syrymH	syrymi	syrymy
toplumlArHn	toplumlerin	toplumlɑrɯn
ujgɑrlHk	ujgɑrlik	ujgɑrlɯk
bɑʃlAnAn	bɑʃlenen	bɑʃlɑnɑn
bɑroH	bɑroi	bɑrou
gøzHn	gøzɯn	gøzyn
mekɑnlArDA	mekɑnlɑrde	mekɑnlɑrdɑ
jyklAnHʤH	jyklɑnɯʤɯ	jykleniʤi
øɰretimA	øɰretimɑ	øɰretime
bɑkHp	bɑkip	bɑkɯp
gitmAH	gitmɑɯ	gitmei
rektørlHk	rektørlik	rektørlyk
tɑnɯmlAmA	tɑnɯmleme	tɑnɯmlɑmɑ
jɑrdɯmlAr	jɑrdɯmler	jɑrdɯmlɑr
ɑɰɑʧlArHn	ɑɰɑʧlerin	ɑɰɑʧlɑrɯn
ɑlbymH	ɑlbymi	ɑlbymy
doktorH	doktori	doktoru
insɑnlArDAn	insɑnlɑrden	insɑnlɑrdɑn
kɑtA	kɑte	kɑtɑ
toplumlAr	toplumler	toplumlɑr
jɑnnHzDA	jɑnnizde	jɑnnɯzdɑ
ørgytHHn	ørgytiin	ørgytyyn
søzHn	søzɯn	søzyn
ɑrkɑdɑʃlArmHzHn	ɑrkɑdɑʃlermizin	ɑrkɑdɑʃlɑrmɯzɯn
duvɑrlArH	duvɑrleri	duvɑrlɑrɯ
eksiklHk	eksiklɯk	eksiklik
ønH	øni	øny
bytynlHk	bytynlɯk	bytynlyk
bozuklHk	bozuklɯk	bozukluk
dinlAr	dinlɑr	dinler
kɑrʃɯlɯksHz	kɑrʃɯlɯksiz	kɑrʃɯlɯksɯz
zɑrɑrlArH	zɑrɑrleri	zɑrɑrlɑrɯ
ɑltɯnʤH	ɑltɯnʤi	ɑltɯnʤɯ
ɑmɑʧlArA	ɑmɑʧlere	ɑmɑʧlɑrɑ
bursH	bursi	bursu
dønemDAn	dønemdɑn	dønemden
esɑsH	esɑsi	esɑsɯ
izlAnAn	izlɑnɑn	izlenen
sokɑklArDA	sokɑklerde	sokɑklɑrdɑ
ɑrɑʃtɯrmAlArHn	ɑrɑʃtɯrmelerin	ɑrɑʃtɯrmɑlɑrɯn
gøstermA	gøstermɑ	gøsterme
kurɑlH	kurɑli	kurɑlɯ
uʤuzA	uʤuze	uʤuzɑ
jɑprɑklArHn	jɑprɑklerin	jɑprɑklɑrɯn
ʃɑrtlArHHn	ʃɑrtleriin	ʃɑrtlɑrɯɯn
komisjonA	komisjone	komisjonɑ
komutlAr	komutler	komutlɑr
rɑporlArHn	rɑporlerin	rɑporlɑrɯn
jykselmAH	jykselmɑɯ	jykselmei
hedeflAnAn	hedeflɑnɑn	hedeflenen
sektørlAr	sektørlɑr	sektørler
senDAn	sendɑn	senden
jyryAn	jyryɑn	jyryen
jolsuzlHk	jolsuzlɯk	jolsuzluk
yrynlArDA	yrynlɑrde	yrynlerde
bilgisɑjɑrDAn	bilgisɑjɑrden	bilgisɑjɑrdɑn
depoH	depoi	depou
depremDA	depremdɑ	depremde
ekrɑnDAki	ekrɑnteki	ekrɑndɑki
getirmAH	getirmɑɯ	getirmei
kɯzlAr	kɯzler	kɯzlɑr
miljonA	miljone	miljonɑ
odɑlArDA	odɑlɑrde	odɑlɑrdɑ
syreʧlAr	syreʧlɑr	syreʧler
sektørlArDA	sektørlɑrde	sektørlerde
jɑzɯlArHn	jɑzɯlerin	jɑzɯlɑrɯn
kɑmusAl	kɑmusel	kɑmusɑl
kɑrtHn	kɑrtin	kɑrtɯn
sɑɑtDAn	sɑɑttɑn	sɑɑtten
jyzjɯllAr	jyzjɯller	jyzjɯllɑr
bojutlArA	bojutlere	bojutlɑrɑ
detɑjlArH	detɑjleri	detɑjlɑrɯ
jɑklɑʃɯmlArH	jɑklɑʃɯmleri	jɑklɑʃɯmlɑrɯ
ystDA	ysttɑ	ystte
ɑvɑntɑʒlH	ɑvɑntɑʒli	ɑvɑntɑʒlɯ
fɑrklHlHklArH	fɑrklilikleri	fɑrklɯlɯklɑrɯ
istikrɑrlH	istikrɑrli	istikrɑrlɯ
kɑpɑtmA	kɑpɑtme	kɑpɑtmɑ
onurlH	onurli	onurlu
jorumlAr	jorumler	jorumlɑr
ɑrɑlɯksHz	ɑrɑlɯksiz	ɑrɑlɯksɯz
bɑkHʃDA	bɑkiʃte	bɑkɯʃtɑ
bɑslAr	bɑsler	bɑslɑr
elemɑnlArHn	elemɑnlerin	elemɑnlɑrɯn
etkenlAr	etkenlɑr	etkenler
mɑntɯksAl	mɑntɯksel	mɑntɯksɑl
mɑsrɑflAr	mɑsrɑfler	mɑsrɑflɑr
okullArA	okullere	okullɑrɑ
sorumluluklAr	sorumlulukler	sorumluluklɑr
tørenDA	tørendɑ	tørende
tɑmɑmlADHkDAn	tɑmɑmletiktɑn	tɑmɑmlɑdɯktɑn
tɑrɑfDAki	tɑrɑfteki	tɑrɑftɑki
unutmAmA	unutmeme	unutmɑmɑ
ʧekmAA	ʧekmɑɑ	ʧekmee
ɑlɑnlArDAki	ɑlɑnlɑrdeki	ɑlɑnlɑrdɑki
dinA	dinɑ	dine
kɑrtHHn	kɑrtiin	kɑrtɯɯn
kuʃlAr	kuʃler	kuʃlɑr
olmAlArnA	olmelerne	olmɑlɑrnɑ
jollArHn	jollerin	jollɑrɯn
ørnekDA	ørnektɑ	ørnekte
ɑdɑmlArHHn	ɑdɑmleriin	ɑdɑmlɑrɯɯn
ɑʒɑnsH	ɑʒɑnsu	ɑʒɑnsɯ
bɑʃlɯklAr	bɑʃlɯkler	bɑʃlɯklɑr
dyzenlAnArAk	dyzenlɑnɑrɑk	dyzenlenerek
devletDAn	devlettɑn	devletten
fɑrklAr	fɑrkler	fɑrklɑr
mydyrHn	mydyrin	mydyryn
sonsHzA	sonsize	sonsuzɑ
ømyrlH	ømyrli	ømyrly
ʃehirlArDA	ʃehirlɑrde	ʃehirlerde
ʃiʃlHk	ʃiʃlɯk	ʃiʃlik
ɑnDAki	ɑnteki	ɑndɑki
ɑrɑʃtɯrmAlArDA	ɑrɑʃtɯrmɑlɑrde	ɑrɑʃtɯrmɑlɑrdɑ
borʧlArH	borʧleri	borʧlɑrɯ
dynjɑDAn	dynjɑtɑn	dynjɑdɑn
ɑrkɑDAn	ɑrkɑtɑn	ɑrkɑdɑn
fijɑtA	fijɑte	fijɑtɑ
nyfusA	nyfuse	nyfusɑ
tɑʃlAr	tɑʃler	tɑʃlɑr
tɑrtɯʃmAlArH	tɑrtɯʃmeleri	tɑrtɯʃmɑlɑrɯ
ɑdɑmlAr	ɑdɑmler	ɑdɑmlɑr
bɑsmA	bɑsme	bɑsmɑ
dyʃynmAA	dyʃynmɑɑ	dyʃynmee
hɯzHHn	hɯziin	hɯzɯɯn
komisjonlArH	komisjonleri	komisjonlɑrɯ
mydyrHHn	mydyriin	mydyryyn
sulArDA	sulɑrde	sulɑrdɑ
jollArHHn	jolleriin	jollɑrɯɯn
ʃɑhɯslAr	ʃɑhɯsler	ʃɑhɯslɑr
dønyʃymH	dønyʃymi	dønyʃymy
derinDAn	derindɑn	derinden
formlAr	formler	formlɑr
hɑstɑlɯklArHHn	hɑstɑlɯkleriin	hɑstɑlɯklɑrɯɯn
inAn	inɑn	inen
internetDAn	internettɑn	internetten
kenɑrlArH	kenɑrleri	kenɑrlɑrɯ
ojA	oje	ojɑ
sembolH	semboli	semboly
ørgytlH	ørgytli	ørgytly
deɰerlendirmADA	deɰerlendirmɑdɑ	deɰerlendirmede
hesɑplArHn	hesɑplerin	hesɑplɑrɯn
orɑnlArHHn	orɑnleriin	orɑnlɑrɯɯn
tutHp	tutip	tutup
jorgunlHk	jorgunlɯk	jorgunluk
yjelHkDAn	yjeliktɑn	yjelikten
bozuklHklAr	bozuklikler	bozukluklɑr
formylH	formyli	formyly
hɑklArA	hɑklere	hɑklɑrɑ
konuʃmAlArH	konuʃmeleri	konuʃmɑlɑrɯ
olɑnɑksHz	olɑnɑksiz	olɑnɑksɯz
rɑkɑmlArH	rɑkɑmleri	rɑkɑmlɑrɯ
sɯnɯflAr	sɯnɯfler	sɯnɯflɑr
tɑʃlArH	tɑʃleri	tɑʃlɑrɯ
jɑzɯlɯmlArHn	jɑzɯlɯmlerin	jɑzɯlɯmlɑrɯn
ɑnlɑmsHz	ɑnlɑmsiz	ɑnlɑmsɯz
bɑzDA	bɑzde	bɑzdɑ
fotoɰrɑflArHn	fotoɰrɑflerin	fotoɰrɑflɑrɯn
gitmAA	gitmɑɑ	gitmee
hususlArDA	hususlerde	hususlɑrdɑ
kesAn	kesɑn	kesen
kursA	kurse	kursɑ
plɑnlArHHn	plɑnleriin	plɑnlɑrɯɯn
rekɑbetʧH	rekɑbetʧɯ	rekɑbetʧi
sonlH	sonli	sonlu
ʃiirlAr	ʃiirlɑr	ʃiirler
dɑmɑrlArH	dɑmɑrleri	dɑmɑrlɑrɯ
gɑzlAr	gɑzler	gɑzlɑr
okulmHzDA	okulmizde	okulmuzdɑ
reformH	reformi	reformu
jollArA	jollere	jollɑrɑ
zorlHklAr	zorlikler	zorluklɑr
birikAn	birikɑn	biriken
dosjɑDA	dosjɑte	dosjɑdɑ
ermAH	ermɑɯ	ermei
geʧirArAk	geʧirɑrɑk	geʧirerek
isteAnlArA	isteɑnlɑrɑ	isteenlere
kurullArHHn	kurulleriin	kurullɑrɯɯn
lɑiklHk	lɑiklɯk	lɑiklik
sɑnɑtHHn	sɑnɑtiin	sɑnɑtɯɯn
sɑvɑʃlArH	sɑvɑʃleri	sɑvɑʃlɑrɯ
silɑhlArHn	silɑhlerin	silɑhlɑrɯn
ulusHn	ulusɯn	ulusun
ʧɑlɯʃmɑmHzDA	ʧɑlɯʃmɑmizde	ʧɑlɯʃmɑmɯzdɑ
ølʧekDA	ølʧektɑ	ølʧekte
ɑdɑjlArA	ɑdɑjlere	ɑdɑjlɑrɑ
dyʃynHp	dyʃynip	dyʃynyp
girmAnHz	girmɑniz	girmeniz
pɑjlArH	pɑjleri	pɑjlɑrɯ
sɑnɑtʧHlAr	sɑnɑtʧiler	sɑnɑtʧɯlɑr
sɑjfɑlArDA	sɑjfɑlɑrde	sɑjfɑlɑrdɑ
tymHHn	tymiin	tymyyn
tɑrihinDAki	tɑrihinteki	tɑrihindeki
toplumlArDA	toplumlerde	toplumlɑrdɑ
jɑjɯnlArHn	jɑjɯnlerin	jɑjɯnlɑrɯn
ɑvukɑtHn	ɑvukɑtin	ɑvukɑtɯn
etrɑfH	etrɑfi	etrɑfɯ
formHn	formin	formun
hɑvɑlArDA	hɑvɑlɑrde	hɑvɑlɑrdɑ
kɑlDHklArH	kɑltikleri	kɑldɯklɑrɯ
konulArDAki	konulɑrdeki	konulɑrdɑki
kurullAr	kuruller	kurullɑr
ɑdɯmlArH	ɑdɯmleri	ɑdɯmlɑrɯ
bɑsDA	bɑste	bɑstɑ
edinmA	edinmɑ	edinme
fuɑrDA	fuɑrde	fuɑrdɑ
gynmHzDAki	gynmizdeki	gynmyzdeki
gynlArA	gynlɑrɑ	gynlere
kɑdɯnlArH	kɑdɯnleri	kɑdɯnlɑrɯ
orgɑnlArHHn	orgɑnleriin	orgɑnlɑrɯɯn
sɑnɑtʧHH	sɑnɑtʧii	sɑnɑtʧɯɯ
uʧlArH	uʧleri	uʧlɑrɯ
jɑnDAki	jɑnteki	jɑndɑki
jɑpɯlArHHn	jɑpɯleriin	jɑpɯlɑrɯɯn
zeminDA	zemindɑ	zeminde
ʧɯkmADAn	ʧɯkmeden	ʧɯkmɑdɑn
hejeʤɑnlH	hejeʤɑnli	hejeʤɑnlɯ
noktɑlArDA	noktɑlɑrde	noktɑlɑrdɑ
pɑtlAHʤH	pɑtleiʤi	pɑtlɑɯʤɯ
pijɑsɑlArDA	pijɑsɑlɑrde	pijɑsɑlɑrdɑ
suʧlArH	suʧleri	suʧlɑrɯ
tytynlArDA	tytynlɑrde	tytynlerde
jɑrdɯmlArH	jɑrdɯmleri	jɑrdɯmlɑrɯ
belirsizlHk	belirsizlɯk	belirsizlik
deɰiʃmAlAr	deɰiʃmɑlɑr	deɰiʃmeler
elmHzDAn	elmizdɑn	elmizden
fijɑtlArHHn	fijɑtleriin	fijɑtlɑrɯɯn
hɯzlArH	hɯzleri	hɯzlɑrɯ
ihtijɑʧlArHHn	ihtijɑʧleriin	ihtijɑʧlɑrɯɯn
kɑʧAn	kɑʧen	kɑʧɑn
kɑrɑrDA	kɑrɑrde	kɑrɑrdɑ
ʧɑlɯʃmAlArDAn	ʧɑlɯʃmɑlɑrden	ʧɑlɯʃmɑlɑrdɑn
ʃehirlAr	ʃehirlɑr	ʃehirler
ɑʃkH	ɑʃki	ɑʃkɯ
ɑrɑjyzH	ɑrɑjyzi	ɑrɑjyzy
byjymAA	byjymɑɑ	byjymee
bojlH	bojlɯ	bojlu
bugynlArDA	bugynlɑrde	bugynlerde
deɰiʃkenlAr	deɰiʃkenlɑr	deɰiʃkenler
firmɑlArDAn	firmɑlɑrden	firmɑlɑrdɑn
formHHn	formiin	formuun
gynejDA	gynejdɑ	gynejde
hizmetDA	hizmettɑ	hizmette
kɑblolH	kɑbloli	kɑblolu
konferɑnsDA	konferɑnste	konferɑnstɑ
sɯnɯflArDA	sɯnɯflerde	sɯnɯflɑrdɑ
jɑʃɑmsAl	jɑʃɑmsel	jɑʃɑmsɑl
ʧoʤuklArmHz	ʧoʤuklermiz	ʧoʤuklɑrmɯz
yʧnʤHH	yʧnʤii	yʧnʤyy
ɑlɑnlArDAn	ɑlɑnlɑrden	ɑlɑnlɑrdɑn
dyzejDAki	dyzejdɑki	dyzejdeki
geʧmiʃDAn	geʧmiʃtɑn	geʧmiʃten
hɑlkmHz	hɑlkmiz	hɑlkmɯz
hɑzɯrlAmHʃ	hɑzɯrlemiʃ	hɑzɯrlɑmɯʃ
mɑsrɑfH	mɑsrɑfi	mɑsrɑfɯ
silɑhH	silɑhi	silɑhɯ
sporH	spori	sporu
ørtylH	ørtyli	ørtyly
deɰerlendirArAk	deɰerlendirɑrɑk	deɰerlendirerek
gøtyrmA	gøtyrmɑ	gøtyrme
hɑstɑlɯklArDAn	hɑstɑlɯklerden	hɑstɑlɯklɑrdɑn
kɑrɑrlHlHk	kɑrɑrlilik	kɑrɑrlɯlɯk
memurlArHn	memurlerin	memurlɑrɯn
meslekDA	meslektɑ	meslekte
ortɑmlAr	ortɑmler	ortɑmlɑr
sɑnɑjilAʃmA	sɑnɑjileʃmɑ	sɑnɑjileʃme
tɑmɑmlɑnDHkDAn	tɑmɑmlɑndiktɑn	tɑmɑmlɑndɯktɑn
telgrɑfH	telgrɑfi	telgrɑfɯ
ʧoʤuklArmHzHn	ʧoʤuklermizin	ʧoʤuklɑrmɯzɯn
bilmAH	bilmɑɯ	bilmei
ʤɑnlHlArHn	ʤɑnlilerin	ʤɑnlɯlɑrɯn
hɑzɯrlɯklH	hɑzɯrlɯkli	hɑzɯrlɯklɯ
temɑsH	temɑsi	temɑsɯ
jyzlH	jyzlɯ	jyzly
jɑpmAmHz	jɑpmemiz	jɑpmɑmɯz
gelHnʤAA	gelinʤɑɑ	gelinʤee
kullAnHʤHH	kulleniʤii	kullɑnɯʤɯɯ
merkeznDAki	merkeznteki	merkezndeki
performɑnslH	performɑnsli	performɑnslɯ
stɑndɑrtlArHn	stɑndɑrtlerin	stɑndɑrtlɑrɯn
tɑbloA	tɑbloe	tɑbloɑ
jurtiʧinDA	jurtiʧindɑ	jurtiʧinde
ʃɑhɯslArA	ʃɑhɯslere	ʃɑhɯslɑrɑ
ɑltDAki	ɑltteki	ɑlttɑki
donɑnɯmlH	donɑnɯmli	donɑnɯmlɯ
durumlArA	durumlere	durumlɑrɑ
iddiɑlH	iddiɑli	iddiɑlɯ
milletlArɑrɑsɯ	milletlɑrɑrɑsɯ	milletlerɑrɑsɯ
pɑzɑrlArDA	pɑzɑrlɑrde	pɑzɑrlɑrdɑ
tyrlAr	tyrlɑr	tyrler
tɑmɑmlAr	tɑmɑmler	tɑmɑmlɑr
bordroH	bordroi	bordrou
memleketDA	memlekettɑ	memlekette
sɯnɯfHn	sɯnɯfin	sɯnɯfɯn
sɯnɑvHn	sɯnɑvin	sɯnɑvɯn
jerjyzynDA	jerjyzyndɑ	jerjyzynde
ɑvukɑtlArHn	ɑvukɑtlerin	ɑvukɑtlɑrɯn
dørtDA	dørttɑ	dørtte
ekiplAr	ekiplɑr	ekipler
geliʃmAlArDAn	geliʃmɑlɑrden	geliʃmelerden
kɑmpysH	kɑmpysi	kɑmpysy
kɑvrɑmlArHn	kɑvrɑmlerin	kɑvrɑmlɑrɯn
kentlAʃmA	kentleʃmɑ	kentleʃme
ortɑmlArH	ortɑmleri	ortɑmlɑrɯ
sɑtHʃlArH	sɑtiʃleri	sɑtɯʃlɑrɯ
sevmA	sevmɑ	sevme
tɑbiplAr	tɑbiplɑr	tɑbipler
tɑlepDA	tɑleptɑ	tɑlepte
tiʤɑretDA	tiʤɑrettɑ	tiʤɑrette
ʧøzmAA	ʧøzmɑɑ	ʧøzmee
yrynlArmHz	yrynlɑrmiz	yrynlermiz
ihtijɑʧlArA	ihtijɑʧlere	ihtijɑʧlɑrɑ
kɑrtlArHHn	kɑrtleriin	kɑrtlɑrɯɯn
sunHʃ	sunɯʃ	sunuʃ
jɑrɑrlArH	jɑrɑrleri	jɑrɑrlɑrɯ
øɰrenmAHn	øɰrenmɑɯn	øɰrenmein
ɑnlɑʃmɑlH	ɑnlɑʃmɑli	ɑnlɑʃmɑlɯ
ɑrɑlɯklH	ɑrɑlɯkli	ɑrɑlɯklɯ
bilgisɑjɑrlArA	bilgisɑjɑrlere	bilgisɑjɑrlɑrɑ
girDHkDAn	girdiktɑn	girdikten
konutlAr	konutler	konutlɑr
kusurlH	kusurli	kusurlu
jyrekDAn	jyrektɑn	jyrekten
bilgisɑjɑrlArH	bilgisɑjɑrleri	bilgisɑjɑrlɑrɯ
fɯrsɑtlAr	fɯrsɑtler	fɯrsɑtlɑr
fotoɰrɑfʧH	fotoɰrɑfʧi	fotoɰrɑfʧɯ
kɑtegoriDA	kɑtegorite	kɑtegoride
kurumlArDAn	kurumlerden	kurumlɑrdɑn
sebepDAn	sebeptɑn	sebepten
teʃkilɑtHHn	teʃkilɑtiin	teʃkilɑtɯɯn
jyrymAA	jyrymɑɑ	jyrymee
ʧoʤuklArmHzA	ʧoʤuklermize	ʧoʤuklɑrmɯzɑ
yzHʤH	yziʤi	yzyʤy
ɑlH	ɑli	ɑlɯ
bilgisɑjɑrlArDA	bilgisɑjɑrlɑrde	bilgisɑjɑrlɑrdɑ
hɑjvɑnsAl	hɑjvɑnsel	hɑjvɑnsɑl
hususlArA	hususlere	hususlɑrɑ
kɑrʃɯlɑʃDHklArH	kɑrʃɯlɑʃtɯkleri	kɑrʃɯlɑʃtɯklɑrɯ
kɑjɯtlArHHn	kɑjɯtleriin	kɑjɯtlɑrɯɯn
mɑkɑmlArA	mɑkɑmlere	mɑkɑmlɑrɑ
normɑlA	normɑlɑ	normɑle
olɑjlArDAn	olɑjlerden	olɑjlɑrdɑn
ojlArHn	ojlerin	ojlɑrɯn
sɑnɑtA	sɑnɑte	sɑnɑtɑ
øɰretimDA	øɰretimdɑ	øɰretimde
ɑkɯmlArH	ɑkɯmleri	ɑkɯmlɑrɯ
bilgisɑjɑrnHzHn	bilgisɑjɑrnizin	bilgisɑjɑrnɯzɯn
gelDHkDAn	geldiktɑn	geldikten
kurDAn	kurtɑn	kurdɑn
lisɑnslH	lisɑnsli	lisɑnslɯ
tɑrɑflArA	tɑrɑflere	tɑrɑflɑrɑ
usA	use	usɑ
vɑtɑndɑʃlArmHzHn	vɑtɑndɑʃlermizin	vɑtɑndɑʃlɑrmɯzɯn
zeminA	zeminɑ	zemine
ʧevreDAki	ʧevreteki	ʧevredeki
eriʃmA	eriʃmɑ	eriʃme
operɑtørH	operɑtøri	operɑtøry
søzHHn	søziin	søzyyn
sɑtɯrDA	sɑtɯrde	sɑtɯrdɑ
tyrHHn	tyriin	tyryyn
tɑmɑmlAHʤH	tɑmɑmleiʤi	tɑmɑmlɑɯʤɯ
ulɑʃAbilmA	ulɑʃɑbilmɑ	ulɑʃɑbilme
jɑprɑklH	jɑprɑkli	jɑprɑklɯ
bilgisɑjɑrnHzDA	bilgisɑjɑrnizde	bilgisɑjɑrnɯzdɑ
bojɑlH	bojɑli	bojɑlɯ
bulHʃ	buliʃ	buluʃ
bulunmAlArH	bulunmeleri	bulunmɑlɑrɯ
doɰrulHk	doɰrulɯk	doɰruluk
iletiʃimDA	iletiʃimdɑ	iletiʃimde
kɑlkHp	kɑlkip	kɑlkɯp
kɑjɯtlArA	kɑjɯtlere	kɑjɯtlɑrɑ
rɑporlArHHn	rɑporleriin	rɑporlɑrɯɯn
sɯrɑlH	sɯrɑli	sɯrɑlɯ
syrHp	syrup	syryp
syrmAH	syrmɑɯ	syrmei
sɑkɯnʤɑlH	sɑkɯnʤɑli	sɑkɯnʤɑlɯ
tɑsɑrɯmlArH	tɑsɑrɯmleri	tɑsɑrɯmlɑrɯ
jønDAki	jønteki	jøndeki
jemekDAn	jemektɑn	jemekten
doktorHn	doktorin	doktorun
eminA	eminɑ	emine
fɑrklArH	fɑrkleri	fɑrklɑrɯ
hɑstɑlɯklArDA	hɑstɑlɯklerde	hɑstɑlɯklɑrdɑ
kɑmpH	kɑmpi	kɑmpɯ
notHHn	notiin	notuun
reformlAr	reformler	reformlɑr
susHz	susiz	susuz
jyryHʃH	jyryiʃi	jyryyʃy
jɑɰHʃlH	jɑɰiʃli	jɑɰɯʃlɯ
zenginlHk	zenginlɯk	zenginlik
øɰretmenlArA	øɰretmenlɑrɑ	øɰretmenlere
fijɑtlArHn	fijɑtlerin	fijɑtlɑrɯn
getirmAH	getirmɑɯ	getirmei
kuzejDA	kuzejdɑ	kuzejde
mensuplArHHn	mensupleriin	mensuplɑrɯɯn
ʃɑhHn	ʃɑhin	ʃɑhɯn
dɑlDA	dɑltɑ	dɑldɑ
gelmADA	gelmɑdɑ	gelmete
hususlArHn	hususlerin	hususlɑrɯn
iʃlemDAn	iʃlemdɑn	iʃlemden
kullɑnmADA	kullɑnmɑdɑ	kullɑnmɑtɑ
motorlArH	motorleri	motorlɑrɯ
jyzjɯlDAn	jyzjɯlden	jyzjɯldɑn
ɑlɑkɑlH	ɑlɑkɑli	ɑlɑkɑlɯ
bɑʃlɑDHkDAn	bɑʃlɑtɯktɑn	bɑʃlɑdɯktɑn
bɑʃlɑHnʤA	bɑʃlɑɯnʤe	bɑʃlɑɯnʤɑ
bugynDAn	bugyndɑn	bugynden
elmDA	elmdɑ	elmde
gøryntylH	gøryntyli	gøryntyly
kesimDA	kesimdɑ	kesimde
mevzuɑtHn	mevzuɑtin	mevzuɑtɯn
sɯnɑvlArHn	sɯnɑvlerin	sɯnɑvlɑrɯn
syrArAk	syrɑrɑk	syrerek
sɑnɯklArHn	sɑnɯklerin	sɑnɯklɑrɯn
eklAnArAk	eklɑnɑrɑk	eklenerek
rɑhɑtlHk	rɑhɑtlik	rɑhɑtlɯk
vɑrlɯklArH	vɑrlɯkleri	vɑrlɯklɑrɯ
øɰrenmAH	øɰrenmɑɯ	øɰrenmei
ʃɑnslH	ʃɑnsli	ʃɑnslɯ
hɑzɯrlAHp	hɑzɯrleip	hɑzɯrlɑɯp
herʃejHn	herʃejɯn	herʃejin
istemAAn	istemɑɑn	istemeen
kollHk	kollik	kolluk
mydyrlykʧA	mydyrlykʧɑ	mydyrlykʧe
okulmHzHn	okulmizin	okulmuzun
sɑnɑtʧHlArHn	sɑnɑtʧilerin	sɑnɑtʧɯlɑrɯn
sorunlArDAn	sorunlɑrden	sorunlɑrdɑn
timA	timɑ	time
ɑʧmAA	ɑʧmee	ɑʧmɑɑ
ɑdɑjlArHHn	ɑdɑjleriin	ɑdɑjlɑrɯɯn
fonksijonlArHn	fonksijonlerin	fonksijonlɑrɯn
giriʃimDA	giriʃimdɑ	giriʃimde
ihrɑʤɑtA	ihrɑʤɑte	ihrɑʤɑtɑ
kɑrɑkterlAr	kɑrɑkterlɑr	kɑrɑkterler
puɑnlArH	puɑnleri	puɑnlɑrɯ
stɑndɑrtlArHHn	stɑndɑrtleriin	stɑndɑrtlɑrɯɯn
tɑrɑfHHn	tɑrɑfiin	tɑrɑfɯɯn
jɑkɯnlArHHn	jɑkɯnleriin	jɑkɯnlɑrɯɯn
øzellikDA	øzelliktɑ	øzellikte
øzgyrlHklAr	øzgyrlikler	øzgyrlykler
bɑɰlArH	bɑɰleri	bɑɰlɑrɯ
dɑvrɑnHʃlArHn	dɑvrɑniʃlerin	dɑvrɑnɯʃlɑrɯn
gynejA	gynejɑ	gyneje
girAbilmA	girɑbilmɑ	girebilme
konferɑnsA	konferɑnse	konferɑnsɑ
kurDHklArH	kurdikleri	kurduklɑrɯ
sebeplArDAn	sebeplɑrden	sebeplerden
telefonA	telefone	telefonɑ
toprɑklArHn	toprɑklerin	toprɑklɑrɯn
ɯʃɯklH	ɯʃɯkli	ɯʃɯklɯ
ʃirketDA	ʃirkettɑ	ʃirkette
demokrɑtiklAʃmA	demokrɑtikleʃmɑ	demokrɑtikleʃme
doɰuA	doɰue	doɰuɑ
fonlArH	fonleri	fonlɑrɯ
gøstermADA	gøstermɑdɑ	gøstermete
herkesDAn	herkestɑn	herkesten
kɑrlHlHk	kɑrlilik	kɑrlɯlɯk
silɑhlArH	silɑhleri	silɑhlɑrɯ
tonA	tone	tonɑ
ujkuA	ujkue	ujkuɑ
jɑtɯrɯmlArA	jɑtɯrɯmlere	jɑtɯrɯmlɑrɑ
jɑzɑrlArHn	jɑzɑrlerin	jɑzɑrlɑrɯn
ɑlɑlHm	ɑlɑlim	ɑlɑlɯm
burslH	bursli	burslu
doktornHz	doktorniz	doktornuz
fedɑkɑrlHk	fedɑkɑrlik	fedɑkɑrlɯk
kolɑjlHklAr	kolɑjlɯkler	kolɑjlɯklɑr
syrHʃ	syriʃ	syryʃ
sytHn	sytin	sytyn
tuʃlArH	tuʃleri	tuʃlɑrɯ
jɑʃlHlAr	jɑʃliler	jɑʃlɯlɑr
ʧøzymlAnmAH	ʧøzymlɑnmɑɯ	ʧøzymlenmei
ʧøzynyrlykDA	ʧøzynyrlyktɑ	ʧøzynyrlykte
bugynH	bugyni	bugyny
direktørH	direktøri	direktøry
gøryʃHn	gøryʃin	gøryʃyn
gerʧeklHk	gerʧeklɯk	gerʧeklik
hɑzɯrlɯklAr	hɑzɯrlɯkler	hɑzɯrlɯklɑr
konforlH	konforli	konforlu
konserlAr	konserlɑr	konserler
kullɑnmAnHz	kullɑnmɑniz	kullɑnmɑnɯz
lɑborɑtuvɑrDA	lɑborɑtuvɑrde	lɑborɑtuvɑrdɑ
mɑddeDAki	mɑddeteki	mɑddedeki
orduA	ordue	orduɑ
tɑkɯmlArH	tɑkɯmleri	tɑkɯmlɑrɯ
uzmɑnlArHn	uzmɑnlerin	uzmɑnlɑrɯn
ʧɯkHnʤA	ʧɯkinʤe	ʧɯkɯnʤɑ
ɑkɯmlAr	ɑkɯmler	ɑkɯmlɑr
bɑjsAl	bɑjsel	bɑjsɑl
birleʃArAk	birleʃɑrɑk	birleʃerek
dɑmɑrlArHn	dɑmɑrlerin	dɑmɑrlɑrɯn
deDHklArH	detikleri	dedikleri
edilAmAAn	edilemɑɑn	edilemeen
esnɑfH	esnɑfi	esnɑfɯ
ilerleDHkʧA	ilerletikʧɑ	ilerledikʧe
kɑrʃɯlɯklAr	kɑrʃɯlɯkler	kɑrʃɯlɯklɑr
motorHn	motorin	motorun
olmADHklArH	olmetikleri	olmɑdɯklɑrɯ
ruhHn	ruhin	ruhun
topHn	topin	topun
vɑrlɯklAr	vɑrlɯkler	vɑrlɯklɑr
jɑzɑrlArH	jɑzɑrleri	jɑzɑrlɑrɯ
byjyklHk	byjyklɯk	byjyklyk
bilmADAn	bilmɑdɑn	bilmeden
bojlArH	bojleri	bojlɑrɯ
bojutlAr	bojutler	bojutlɑr
edinAn	edinɑn	edinen
fɯrsɑtlArH	fɯrsɑtleri	fɯrsɑtlɑrɯ
gelmA	gelmɑ	gelme
resimDA	resimdɑ	resimde
tonlHk	tonlɯk	tonluk
topluluklArH	toplulukleri	topluluklɑrɯ
jyzejDA	jyzejdɑ	jyzejde
øzgyrlHklArH	øzgyrlikleri	øzgyrlykleri
ɑrtHʃlAr	ɑrtiʃler	ɑrtɯʃlɑr
ɑrtmADA	ɑrtmede	ɑrtmɑtɑ
dɑlHHn	dɑliin	dɑlɯɯn
dilDAn	diltɑn	dilden
grupDAki	grupteki	gruptɑki
iʧeriDA	iʧerite	iʧeride
kɑnɑllAr	kɑnɑller	kɑnɑllɑr
seʧimDA	seʧimdɑ	seʧimde
topʧH	topʧi	topʧu
ølymHn	ølymin	ølymyn
denetlAnmAH	denetlɑnmɑɯ	denetlenmei
esnɑfHn	esnɑfin	esnɑfɯn
frekɑnsH	frekɑnsu	frekɑnsɯ
gyryltylH	gyryltyli	gyryltyly
hɑksHzlHk	hɑksizlɯk	hɑksɯzlɯk
hɑstɑlɯklH	hɑstɑlɯkli	hɑstɑlɯklɯ
imzɑlH	imzɑli	imzɑlɯ
lyzumlH	lyzumli	lyzumlu
olɑnɑklArHHn	olɑnɑkleriin	olɑnɑklɑrɯɯn
orgɑnlArHn	orgɑnlerin	orgɑnlɑrɯn
sorunlH	sorunli	sorunlu
tɑrtɯʃmAlArHn	tɑrtɯʃmelerin	tɑrtɯʃmɑlɑrɯn
unsurlArHn	unsurlerin	unsurlɑrɯn
jɯllArDAki	jɯllerdeki	jɯllɑrdɑki
ønmHzA	ønmize	ønmyze
dyzenleDHklArH	dyzenletikleri	dyzenledikleri
filmDA	filmdɑ	filmde
kɯsɯmlAr	kɯsɯmler	kɯsɯmlɑr
kuzejA	kuzejɑ	kuzeje
modH	modi	modu
sɑɰlɑmADA	sɑɰlɑmɑdɑ	sɑɰlɑmɑtɑ
sɑkɑtlHk	sɑkɑtlik	sɑkɑtlɯk
sɑvɑʃlAr	sɑvɑʃler	sɑvɑʃlɑr
tyjlH	tyjlɯ	tyjly
tɑrɑflArH	tɑrɑfleri	tɑrɑflɑrɯ
terørHn	terørin	terøryn
jɑtɑklAr	jɑtɑkler	jɑtɑklɑr
zorlHklArH	zorlikleri	zorluklɑrɯ
ɑvukɑtlArH	ɑvukɑtleri	ɑvukɑtlɑrɯ
dɑlgɑlH	dɑlgɑli	dɑlgɑlɯ
evrɑklAr	evrɑkler	evrɑklɑr
gølHn	gølin	gølyn
hɑrʤɑmAlArHn	hɑrʤɑmelerin	hɑrʤɑmɑlɑrɯn
hɑtlArHHn	hɑtleriin	hɑtlɑrɯɯn
kurullArHn	kurullerin	kurullɑrɯn
numɑrɑnHzH	numɑrɑnizi	numɑrɑnɯzɯ
operɑtørlAr	operɑtørlɑr	operɑtørler
pɑrʧɑlH	pɑrʧɑli	pɑrʧɑlɯ
pɑrlɑmentoH	pɑrlɑmentoi	pɑrlɑmentou
referɑnslAr	referɑnsler	referɑnslɑr
sɑɰlAAbilmA	sɑɰlɑɑbilmɑ	sɑɰlɑɑbilme
sonbɑhɑrDA	sonbɑhɑrde	sonbɑhɑrdɑ
tɑkɯmlAr	tɑkɯmler	tɑkɯmlɑr
toplɑntɯlArHn	toplɑntɯlerin	toplɑntɯlɑrɯn
verDHkDAn	verdiktɑn	verdikten
vermADAn	vermɑdɑn	vermeten
vermAmA	vermɑmɑ	vermeme
vermAHn	vermɑɯn	vermein
jøntemDA	jøntemdɑ	jøntemde
ʧɑlɯʃmAlArmHzH	ʧɑlɯʃmɑlɑrmizi	ʧɑlɯʃmɑlɑrmɯzɯ
bɑkHnʤA	bɑkinʤe	bɑkɯnʤɑ
edebijɑtHHn	edebijɑtiin	edebijɑtɯɯn
fɑktørlArDAn	fɑktørlɑrden	fɑktørlerden
gørmAH	gørmɑɯ	gørmei
gerginlHk	gerginlɯk	gerginlik
gezAn	gezɑn	gezen
køprylH	køpryli	køpryly
sɯnɑvlArDA	sɯnɑvlerde	sɯnɑvlɑrdɑ
søjleDHklArH	søjletikleri	søjledikleri
sɑhɑlArDA	sɑhɑlɑrde	sɑhɑlɑrdɑ
tɑsɑrɯmlAr	tɑsɑrɯmler	tɑsɑrɯmlɑr
toprɑklArHHn	toprɑkleriin	toprɑklɑrɯɯn
bɑnkɑmHz	bɑnkɑmiz	bɑnkɑmɯz
bilimA	bilimɑ	bilime
enfeksijonlArH	enfeksijonleri	enfeksijonlɑrɯ
engellAnmAH	engellɑnmɑɯ	engellenmei
gørynymlH	gørynymli	gørynymly
gørAbilmA	gørɑbilmɑ	gørebilme
hɑjvɑnlArDA	hɑjvɑnlɑrde	hɑjvɑnlɑrdɑ
køjDAn	køjdɑn	køjden
kyrlAʃmA	kyrlɑʃmɑ	kyrleʃme
okullArHHn	okulleriin	okullɑrɯɯn
sporHn	sporin	sporun
jykymlHlHk	jykymlilik	jykymlylyk
jyklAnmAH	jyklɑnmɑɯ	jyklenmei
jɑzmAH	jɑzmei	jɑzmɑɯ
ɑrtmA	ɑrtme	ɑrtmɑ
ɑtHp	ɑtip	ɑtɯp
bytynlAʃmA	bytynlɑʃmɑ	bytynleʃme
dɑvɑlArDA	dɑvɑlɑrde	dɑvɑlɑrdɑ
distribytørH	distribytøri	distribytøry
durumlArHHn	durumleriin	durumlɑrɯɯn
ekonomiDAki	ekonomiteki	ekonomideki
firmɑlArDA	firmɑlɑrde	firmɑlɑrdɑ
fijɑtlArA	fijɑtlere	fijɑtlɑrɑ
hɑʧlH	hɑʧli	hɑʧlɯ
irtibɑtA	irtibɑte	irtibɑtɑ
kesimA	kesimɑ	kesime
kuruluʃDA	kuruluʃte	kuruluʃtɑ
mɑdenlAr	mɑdenlɑr	mɑdenler
petrolHn	petrolin	petrolyn
sɑnɯklAr	sɑnɯkler	sɑnɯklɑr
sɑntrɑlH	sɑntrɑli	sɑntrɑlɯ
stɑndɑrtlArDA	stɑndɑrtlerde	stɑndɑrtlɑrdɑ
jɑʃlHlHk	jɑʃlilik	jɑʃlɯlɯk
ʧøzymHn	ʧøzymin	ʧøzymyn
ʃɑhɯslArHn	ʃɑhɯslerin	ʃɑhɯslɑrɯn
ystynlHk	ystynlɯk	ystynlyk
ɑkʃɑmlArH	ɑkʃɑmleri	ɑkʃɑmlɑrɯ
birimA	birimɑ	birime
ekipmɑnlArH	ekipmɑnleri	ekipmɑnlɑrɯ
gønylDAn	gønyltɑn	gønylden
gønyllHlArH	gønyllileri	gønyllyleri
geʧmAAn	geʧmɑɑn	geʧmeen
hɑlkmHzA	hɑlkmize	hɑlkmɯzɑ
kɑpɑtHp	kɑpɑtip	kɑpɑtɯp
liderlAr	liderlɑr	liderler
prensiplAr	prensiplɑr	prensipler
rɑkɑmlArA	rɑkɑmlere	rɑkɑmlɑrɑ
tɑɑhhytlH	tɑɑhhytli	tɑɑhhytly
tɑrɑfmHzDAn	tɑrɑfmizdɑn	tɑrɑfmɯzdɑn
uzɑkDAki	uzɑkteki	uzɑktɑki
jønetimDA	jønetimdɑ	jønetimde
ʃikɑjetʧH	ʃikɑjetʧɯ	ʃikɑjetʧi
yretimDAn	yretimdɑn	yretimden
ʤihɑzlArHHn	ʤihɑzleriin	ʤihɑzlɑrɯɯn
dostlAr	dostler	dostlɑr
gørynHʃ	gøryniʃ	gørynyʃ
kurɑllArHn	kurɑllerin	kurɑllɑrɯn
pɑzɑrlArA	pɑzɑrlere	pɑzɑrlɑrɑ
sɑtHʃlAr	sɑtiʃler	sɑtɯʃlɑr
senɑtoH	senɑtoi	senɑtou
sorumlHlArH	sorumlileri	sorumlulɑrɯ
tɑkɯmmHz	tɑkɯmmiz	tɑkɯmmɯz
tɑrɑflArDAn	tɑrɑflerden	tɑrɑflɑrdɑn
vɑrlɯklArHn	vɑrlɯklerin	vɑrlɯklɑrɯn
jɑtɑklArH	jɑtɑkleri	jɑtɑklɑrɯ
bølmA	bølmɑ	bølme
burslAr	bursler	burslɑr
dɑvrɑnHʃlArHHn	dɑvrɑniʃleriin	dɑvrɑnɯʃlɑrɯɯn
deɰiʃmAAn	deɰiʃmɑɑn	deɰiʃmeen
dinlAHʤH	dinlɑɯʤɯ	dinleiʤi
dozDA	dozde	dozdɑ
gørmAAn	gørmɑɑn	gørmeen
herʃejA	herʃejɑ	herʃeje
kɑnunlArHn	kɑnunlerin	kɑnunlɑrɯn
kɑjnɑklArDA	kɑjnɑklerde	kɑjnɑklɑrdɑ
koʃulDA	koʃultɑ	koʃuldɑ
kullɑnɯmlArH	kullɑnɯmleri	kullɑnɯmlɑrɯ
kusurH	kusuri	kusuru
okulDAki	okulteki	okuldɑki
olAlHm	olɑlim	olɑlɯm
opsijonlArH	opsijonleri	opsijonlɑrɯ
sɯnɯrlArHHn	sɯnɯrleriin	sɯnɯrlɑrɯɯn
sɑlonA	sɑlone	sɑlonɑ
jɑnɯtlAr	jɑnɯtler	jɑnɯtlɑr
ɑʧmAH	ɑʧmei	ɑʧmɑɯ
dostlArH	dostleri	dostlɑrɯ
hykymlHlArHn	hykymlilerin	hykymlylerin
hukukHHn	hukukiin	hukukuun
ihrɑʤɑtHn	ihrɑʤɑtin	ihrɑʤɑtɯn
tutɑrlArH	tutɑrleri	tutɑrlɑrɯ
jɑrH	jɑrɯ	jɑri
jɑvɑʃʧA	jɑvɑʃʧe	jɑvɑʃʧɑ
ɑrtHʃHn	ɑrtiʃin	ɑrtɯʃɯn
bɑlɯklArH	bɑlɯkleri	bɑlɯklɑrɯ
durumlArHn	durumlerin	durumlɑrɯn
itirɑzlAr	itirɑzler	itirɑzlɑr
kullɑnmAlArH	kullɑnmeleri	kullɑnmɑlɑrɯ
nyfuslH	nyfusli	nyfuslu
typH	typi	typy
tyzykDA	tyzyktɑ	tyzykte
jɑʃDAki	jɑʃteki	jɑʃtɑki
jerlArDAki	jerlɑrdeki	jerlerdeki
ɑjɑklAr	ɑjɑkler	ɑjɑklɑr
bɑʃkɑnlArHHn	bɑʃkɑnleriin	bɑʃkɑnlɑrɯɯn
derinlHk	derinlɯk	derinlik
doktorlArHn	doktorlerin	doktorlɑrɯn
dujusAl	dujusel	dujusɑl
hɑsɑrlH	hɑsɑrli	hɑsɑrlɯ
meslektɑʃlArmHzHn	meslektɑʃlermizin	meslektɑʃlɑrmɯzɯn
sɑɰlɯksHz	sɑɰlɯksiz	sɑɰlɯksɯz
ɑlHnʤA	ɑlinʤe	ɑlɯnʤɑ
bildirimDA	bildirimdɑ	bildirimde
dɑɰɯlɯmlArH	dɑɰɯlɯmleri	dɑɰɯlɯmlɑrɯ
dɑvɑlH	dɑvɑli	dɑvɑlɯ
hɑstɑlArDAn	hɑstɑlɑrden	hɑstɑlɑrdɑn
køtylHk	køtylɯk	køtylyk
kɑslArH	kɑsleri	kɑslɑrɯ
kɑvrɑmsAl	kɑvrɑmsel	kɑvrɑmsɑl
kumlH	kumli	kumlu
odɑHHn	odɑiin	odɑɯɯn
ormɑnlArH	ormɑnleri	ormɑnlɑrɯ
ortɑklArHn	ortɑklerin	ortɑklɑrɯn
teminɑtlAr	teminɑtler	teminɑtlɑr
vɑtɑndɑʃlArA	vɑtɑndɑʃlere	vɑtɑndɑʃlɑrɑ
jorHʤH	joriʤi	joruʤu
ʧekilmA	ʧekilmɑ	ʧekilme
ɑhlɑkH	ɑhlɑki	ɑhlɑkɯ
ɑlɯʃkɑnlɯklArH	ɑlɯʃkɑnlɯkleri	ɑlɯʃkɑnlɯklɑrɯ
deɰinmA	deɰinmɑ	deɰinme
denetimA	denetimɑ	denetime
doɰHʃH	doɰiʃi	doɰuʃu
dokuHHn	dokuiin	dokuuun
evDAki	evteki	evdeki
kurɑllArHHn	kurɑlleriin	kurɑllɑrɯɯn
sistemDAki	sistemdɑki	sistemdeki
usulA	usulɑ	usule
ujgulɑmɑlArDAn	ujgulɑmɑlɑrden	ujgulɑmɑlɑrdɑn
vɑtɑndɑʃlArH	vɑtɑndɑʃleri	vɑtɑndɑʃlɑrɯ
vɑzijetDA	vɑzijettɑ	vɑzijette
vermAnHz	vermɑniz	vermeniz
jɑrɑtArAk	jɑrɑterek	jɑrɑtɑrɑk
ønDAn	øndɑn	ønden
ɑdlAr	ɑdler	ɑdlɑr
getirmAAn	getirmɑɑn	getirmeen
hɑjɑtmHzHn	hɑjɑtmizin	hɑjɑtmɯzɯn
huzurH	huzuri	huzuru
medjɑDA	medjɑte	medjɑdɑ
memurHn	memurin	memurun
olɑjlArDA	olɑjlerde	olɑjlɑrdɑ
syryʤyHn	syryʤyin	syryʤyyn
tyrHn	tyrin	tyryn
toplɑHp	toplɑip	toplɑɯp
vermAAʤAk	vermɑɑʤɑk	vermeeʤek
jykseklHkDA	jykseklɯktɑ	jykseklikte
ɑlɑʤɑklArHHn	ɑlɑʤɑkleriin	ɑlɑʤɑklɑrɯɯn
ɑjrɯlHp	ɑjrɯlup	ɑjrɯlɯp
dyrystlHk	dyrystlik	dyrystlyk
gyneʃDAn	gyneʃtɑn	gyneʃten
kurslArA	kurslere	kurslɑrɑ
metotlArH	metotleri	metotlɑrɯ
okuHʤHA	okuuʤie	okuuʤuɑ
semptomlArH	semptomleri	semptomlɑrɯ
tuʃlAr	tuʃler	tuʃlɑr
zɑmɑnlArH	zɑmɑnleri	zɑmɑnlɑrɯ
ʧorlH	ʧorli	ʧorlu
øɰrenmAH	øɰrenmɑɯ	øɰrenmei
bɑlɯklArHn	bɑlɯklerin	bɑlɯklɑrɯn
ʤɑmlAr	ʤɑmler	ʤɑmlɑr
deɰerlendirmAH	deɰerlendirmɑɯ	deɰerlendirmei
etmAnHzH	etmɑnizi	etmenizi
girmAAn	girmɑɑn	girmeen
kɑnɑtlH	kɑnɑtli	kɑnɑtlɯ
kɑslArHn	kɑslerin	kɑslɑrɯn
kɑtlAr	kɑtler	kɑtlɑr
kulyplArH	kulyplɑrɯ	kulypleri
myslymɑnlArHn	myslymɑnlerin	myslymɑnlɑrɯn
pɑzɑrDAki	pɑzɑrdeki	pɑzɑrdɑki
sɯnɯflArH	sɯnɯfleri	sɯnɯflɑrɯ
sɑtɯrA	sɑtɯre	sɑtɯrɑ
sigortɑlHA	sigortɑlie	sigortɑlɯɑ
tytynH	tytyni	tytyny
jykHHn	jykiin	jykyyn
ʧɯkDHkDAn	ʧɯktiktɑn	ʧɯktɯktɑn
ønmHzDA	ønmizde	ønmyzde
ʃifɑlH	ʃifɑli	ʃifɑlɯ
ɑʧɯklɑmAlArDA	ɑʧɯklɑmɑlɑrde	ɑʧɯklɑmɑlɑrdɑ
ɑʧɯlArDAn	ɑʧɯlɑrden	ɑʧɯlɑrdɑn
bɑsmA	bɑsme	bɑsmɑ
bilgisɑjɑrnHzH	bilgisɑjɑrnizi	bilgisɑjɑrnɯzɯ
ʤɑmlArH	ʤɑmleri	ʤɑmlɑrɯ
devletDA	devlettɑ	devlette
ekDA	ektɑ	ekte
gørmADAn	gørmɑdɑn	gørmeden
gynlArDAn	gynlɑrden	gynlerden
kyresAllAʃmAHn	kyreselleʃmɑɯn	kyreselleʃmein
kɑdrolH	kɑdroli	kɑdrolu
kɑnDAki	kɑnteki	kɑndɑki
kɑrtlArHn	kɑrtlerin	kɑrtlɑrɯn
sɑtɯrlArH	sɑtɯrleri	sɑtɯrlɑrɯ
sessHzlHk	sessɯzlɯk	sessizlik
unutmAAlHm	unutmɑɑlim	unutmɑɑlɯm
vɑtɑndɑʃlArmHz	vɑtɑndɑʃlermiz	vɑtɑndɑʃlɑrmɯz
ɑdlArHHn	ɑdleriin	ɑdlɑrɯɯn
ɑmɑʧlArHHn	ɑmɑʧleriin	ɑmɑʧlɑrɯɯn
ɑnlAAbilmA	ɑnlɑɑbilmɑ	ɑnlɑɑbilme
bølymmHz	bølymmiz	bølymmyz
borʧlArHn	borʧlerin	borʧlɑrɯn
dojurHʤH	dojuriʤi	dojuruʤu
gørynHʃH	gøryniʃi	gørynyʃy
gidermA	gidermɑ	giderme
gitmAH	gitmɑɯ	gitmei
iletiʃimA	iletiʃimɑ	iletiʃime
kɑɰɯtlAr	kɑɰɯtler	kɑɰɯtlɑr
kɑtɯlmAlArH	kɑtɯlmeleri	kɑtɯlmɑlɑrɯ
rɑporlArDA	rɑporlɑrde	rɑporlɑrdɑ
sɑbɑhHn	sɑbɑhin	sɑbɑhɯn
sezAn	sezɑn	sezen
vyʤutDAki	vyʤutteki	vyʤuttɑki
jyznʤH	jyznʤi	jyznʤy
bɑkHʃH	bɑkiʃi	bɑkɯʃɯ
bɑnkɑDAn	bɑnkɑtɑn	bɑnkɑdɑn
eriʃkinlArDA	eriʃkinlɑrde	eriʃkinlerde
hɑrʤɑmAlArHHn	hɑrʤɑmeleriin	hɑrʤɑmɑlɑrɯɯn
huzursHzlHk	huzursizlɯk	huzursuzluk
iʧimDA	iʧimdɑ	iʧimde
iliʃkiDA	iliʃkite	iliʃkide
kɯrɯklArH	kɯrɯkleri	kɯrɯklɑrɯ
mɑkɑmlAr	mɑkɑmler	mɑkɑmlɑr
onnʤH	onnʤi	onnʤu
tebliɰlAr	tebliɰlɑr	tebliɰler
tedɑviDAn	tedɑviten	tedɑviden
jɑtArAk	jɑterek	jɑtɑrɑk
zijɑretDA	zijɑrettɑ	zijɑrette
benimseAn	benimseɑn	benimseen
dɑɰlArHn	dɑɰlerin	dɑɰlɑrɯn
gɑzlArn	gɑzlern	gɑzlɑrn
iʧermAAn	iʧermɑɑn	iʧermeen
kɑlmAksHzHn	kɑlmeksizin	kɑlmɑksɯzɯn
olgunlHk	olgunlɯk	olgunluk
syrmADA	syrmɑdɑ	syrmete
sɑnɑtʧHlArH	sɑnɑtʧileri	sɑnɑtʧɯlɑrɯ
sɑjmHzDA	sɑjmizde	sɑjmɯzdɑ
sijɑsetDA	sijɑsettɑ	sijɑsette
sokɑklArA	sokɑklere	sokɑklɑrɑ
jɯldɯzH	jɯldɯzi	jɯldɯzɯ
jyryArAk	jyryɑrɑk	jyryerek
jetersizlHk	jetersizlɯk	jetersizlik
ʧɯkmADA	ʧɯkmede	ʧɯkmɑtɑ
ɯʃɯnlArH	ɯʃɯnleri	ɯʃɯnlɑrɯ
øzDAn	øzdɑn	øzden
binDAn	bindɑn	binden
bloklAr	blokler	bloklɑr
kɯzlArHn	kɯzlerin	kɯzlɑrɯn
kɑnɯtlAr	kɑnɯtler	kɑnɯtlɑr
kɑrɑrlArDA	kɑrɑrlɑrde	kɑrɑrlɑrdɑ
kɑrtnHzHn	kɑrtnizin	kɑrtnɯzɯn
kɑzɑnʧlH	kɑzɑnʧli	kɑzɑnʧlɯ
memurlArHHn	memurleriin	memurlɑrɯɯn
mesɑʒlArHn	mesɑʒlerin	mesɑʒlɑrɯn
sɯnɑvDAn	sɯnɑvtɑn	sɯnɑvdɑn
sɑlonlArH	sɑlonleri	sɑlonlɑrɯ
sevijeDAki	sevijeteki	sevijedeki
solDA	solde	soldɑ
solDAn	solden	soldɑn
sunuʤuA	sunuʤue	sunuʤuɑ
tohumlArH	tohumleri	tohumlɑrɯ
jɑzɯlArDA	jɑzɯlɑrde	jɑzɯlɑrdɑ
ʧevirmA	ʧevirmɑ	ʧevirme
ʃɑrtlH	ʃɑrtli	ʃɑrtlɯ
ɑdɑjlArDAn	ɑdɑjlerden	ɑdɑjlɑrdɑn
ɑrɑʧlArDA	ɑrɑʧlɑrde	ɑrɑʧlɑrdɑ
bilgisɑjɑrnHz	bilgisɑjɑrniz	bilgisɑjɑrnɯz
dønDHkDAn	døndiktɑn	døndykten
døvHʃ	døviʃ	døvyʃ
gøzlH	gøzlɯ	gøzly
gelmAAn	gelmɑɑn	gelmeen
hykymetDAn	hykymettɑn	hykymetten
insɑnlArHHn	insɑnleriin	insɑnlɑrɯɯn
kɑrtnHz	kɑrtniz	kɑrtnɯz
kɑrtlH	kɑrtli	kɑrtlɯ
mɑkɑmlArH	mɑkɑmleri	mɑkɑmlɑrɯ
mekɑnlArH	mekɑnleri	mekɑnlɑrɯ
meslekDAn	meslektɑn	meslekten
onɑjlAr	onɑjler	onɑjlɑr
sɯnɑvHHn	sɯnɑviin	sɯnɑvɯɯn
sɑnɑjinDA	sɑnɑjindɑ	sɑnɑjinde
uʧAn	uʧen	uʧɑn
jetiʃkinlAr	jetiʃkinlɑr	jetiʃkinler
ʧekilmA	ʧekilmɑ	ʧekilme
ɑɰɯrlɯklArH	ɑɰɯrlɯkleri	ɑɰɯrlɯklɑrɯ
ɑlmADAn	ɑlmɑdɑn	ɑlmɑtɑn
ɑrɑʧlArA	ɑrɑʧlere	ɑrɑʧlɑrɑ
bildirArAk	bildirɑrɑk	bildirerek
girmAH	girmɑɯ	girmei
hɑklArDAn	hɑklerden	hɑklɑrdɑn
kɑrʃɯlɯklArH	kɑrʃɯlɯkleri	kɑrʃɯlɯklɑrɯ
kɑrtnHzH	kɑrtnizi	kɑrtnɯzɯ
kɑslAr	kɑsler	kɑslɑr
mɑnzɑrɑlH	mɑnzɑrɑli	mɑnzɑrɑlɯ
mezunlArHHn	mezunleriin	mezunlɑrɯɯn
operɑsjonlArH	operɑsjonleri	operɑsjonlɑrɯ
rɑkɑmlArHn	rɑkɑmlerin	rɑkɑmlɑrɯn
vɑlilHkʧA	vɑlilikʧɑ	vɑlilikʧe
jɯldɯzlArH	jɯldɯzleri	jɯldɯzlɑrɯ
jyklAnAn	jyklɑnɑn	jyklenen
jɑjɯnlArDA	jɑjɯnlɑrde	jɑjɯnlɑrdɑ
jurtlArDA	jurtlerde	jurtlɑrdɑ
ɯslɑhH	ɯslɑhi	ɯslɑhɯ
ɑrtHʃHHn	ɑrtiʃiin	ɑrtɯʃɯɯn
byjyDHkʧA	byjydikʧɑ	byjydykʧe
dɑvrɑnHʃlArDA	dɑvrɑniʃlerde	dɑvrɑnɯʃlɑrdɑ
gørmADA	gørmɑdɑ	gørmete
izinlAr	izinlɑr	izinler
kodlAr	kodler	kodlɑr
noktɑlArDAn	noktɑlɑrden	noktɑlɑrdɑn
noktɑHHn	noktɑiin	noktɑɯɯn
normɑlDAn	normɑltɑn	normɑlden
pɑdiʃɑhHn	pɑdiʃɑhin	pɑdiʃɑhɯn
syrtynmA	syrtynmɑ	syrtynme
soruHHn	soruiin	soruuun
uluslH	ulusli	uluslu
virysHn	virysɯn	virysyn
jɑpAbilmAH	jɑpɑbilmɑɯ	jɑpɑbilmei
bɑkɑnlArH	bɑkɑnleri	bɑkɑnlɑrɯ
bɑrɯʃʧH	bɑrɯʃʧi	bɑrɯʃʧɯ
bɑsHp	bɑsip	bɑsɯp
bugynlArA	bugynlɑrɑ	bugynlere
fonksijonlArHHn	fonksijonleriin	fonksijonlɑrɯɯn
fonlArHn	fonlerin	fonlɑrɯn
hykymlHlAr	hykymliler	hykymlyler
kullɑnmADAn	kullɑnmɑdɑn	kullɑnmɑtɑn
jykHn	jykin	jykyn
ørgytlAnmAH	ørgytlɑnmɑɯ	ørgytlenmei
boʃluklArH	boʃlukleri	boʃluklɑrɯ
fijɑtHHn	fijɑtiin	fijɑtɯɯn
køkH	køki	køky
menyDAki	menyteki	menydeki
olHʃ	oliʃ	oluʃ
orgɑnizɑsjonlArH	orgɑnizɑsjonleri	orgɑnizɑsjonlɑrɯ
sɯnɯrlArHn	sɯnɯrlerin	sɯnɯrlɑrɯn
sertifikɑlH	sertifikɑli	sertifikɑlɯ
tymørlAr	tymørlɑr	tymørler
tɑbɑnlArH	tɑbɑnleri	tɑbɑnlɑrɯ
ujumlHlHk	ujumlilik	ujumluluk
jyzjɯllArDA	jyzjɯllerde	jyzjɯllɑrdɑ
jɑpmAnHzH	jɑpmɑnizi	jɑpmɑnɯzɯ
ʧɑɰmHzDA	ʧɑɰmizde	ʧɑɰmɯzdɑ
øzgyrlHklArHn	øzgyrliklerin	øzgyrlyklerin
yrynDA	yryndɑ	yrynde
bølymmHzDA	bølymmizde	bølymmyzde
dokymɑnlArH	dokymɑnleri	dokymɑnlɑrɯ
emzirmA	emzirmɑ	emzirme
hɯzlArDA	hɯzlerde	hɯzlɑrdɑ
kɑnɑllH	kɑnɑlli	kɑnɑllɯ
kodlH	kodli	kodlu
kontrolA	kontrolɑ	kontrole
merɑklH	merɑkli	merɑklɯ
pɑmuklH	pɑmukli	pɑmuklu
sɯnɯfHHn	sɯnɯfiin	sɯnɯfɯɯn
sɑbɯrlH	sɑbɯrli	sɑbɯrlɯ
jɑzlArH	jɑzleri	jɑzlɑrɯ
ølymDAn	ølymdɑn	ølymden
ɑkHp	ɑkip	ɑkɯp
besinlAr	besinlɑr	besinler
gøryʃArAk	gøryʃɑrɑk	gøryʃerek
gebelHkDA	gebeliktɑ	gebelikte
impɑrɑtorlHk	impɑrɑtorlik	impɑrɑtorluk
køjlHlArHn	køjlilerin	køjlylerin
mɑhijetDA	mɑhijettɑ	mɑhijette
sevArAk	sevɑrɑk	severek
topluluklAr	toplulukler	topluluklɑr
jɑʃɑmADA	jɑʃɑmɑdɑ	jɑʃɑmɑtɑ
jɑprɑklArHHn	jɑprɑkleriin	jɑprɑklɑrɯɯn
jetkinlHk	jetkinlɯk	jetkinlik
ysH	ysi	ysy
ɑkHʃHHn	ɑkiʃiin	ɑkɯʃɯɯn
birejA	birejɑ	bireje
birejH	birejɯ	bireji
bozHʤH	boziʤi	bozuʤu
durgunlHk	durgunlɯk	durgunluk
dujHnʤA	dujinʤe	dujunʤɑ
firmɑnHzHn	firmɑnizin	firmɑnɯzɯn
hukukʧH	hukukʧi	hukukʧu
kɑpɑklAr	kɑpɑkler	kɑpɑklɑr
kɑtɯlHp	kɑtɯlup	kɑtɯlɯp
kimjɑsAllAr	kimjɑsɑller	kimjɑsɑllɑr
kirlAnmA	kirlɑnmɑ	kirlenme
konumHz	konumiz	konumuz
orgɑnizɑsjonA	orgɑnizɑsjone	orgɑnizɑsjonɑ
pɑnoH	pɑnoi	pɑnou
subɑjlAr	subɑjler	subɑjlɑr
topA	tope	topɑ
toplummHzDA	toplummizde	toplummuzdɑ
unutmA	unutme	unutmɑ
ɯʃɯklArH	ɯʃɯkleri	ɯʃɯklɑrɯ
ørmA	ørmɑ	ørme
ʃiʃmA	ʃiʃmɑ	ʃiʃme
ɑkɯlDA	ɑkɯlde	ɑkɯldɑ
ɑrkɑdɑʃlArHn	ɑrkɑdɑʃlerin	ɑrkɑdɑʃlɑrɯn
ɑtɑmAlArH	ɑtɑmeleri	ɑtɑmɑlɑrɯ
ɑvH	ɑvu	ɑvɯ
ɑjrɯʤɑlɯklH	ɑjrɯʤɑlɯkli	ɑjrɯʤɑlɯklɯ
bɑʃnHzA	bɑʃnize	bɑʃnɯzɑ
bildiriDA	bildirite	bildiride
dyʃynmADAn	dyʃynmɑdɑn	dyʃynmeden
doktornHzA	doktornize	doktornuzɑ
dozlArDA	dozlerde	dozlɑrdɑ
etmenlAr	etmenlɑr	etmenler
iʧermAH	iʧermɑɯ	iʧermei
ilɑʧlArA	ilɑʧlere	ilɑʧlɑrɑ
kɑpɑklArH	kɑpɑkleri	kɑpɑklɑrɯ
kɑrdeʃlHk	kɑrdeʃlɯk	kɑrdeʃlik
mɑhɑllinDA	mɑhɑllindɑ	mɑhɑllinde
oɰullArH	oɰulleri	oɰullɑrɯ
ormɑnlArHn	ormɑnlerin	ormɑnlɑrɯn
sokɑklAr	sokɑkler	sokɑklɑr
tezlH	tezlɯ	tezli
jøreDAki	jøreteki	jøredeki
ʧɯkHʃlArH	ʧɯkiʃleri	ʧɯkɯʃlɑrɯ
ʧevirmA	ʧevirmɑ	ʧevirme
ɯsrɑrlH	ɯsrɑrli	ɯsrɑrlɯ
ɑlɯnmADA	ɑlɯnmɑdɑ	ɑlɯnmɑtɑ
ɑlmAnHzH	ɑlmɑnizi	ɑlmɑnɯzɯ
ɑnlɑmlArH	ɑnlɑmleri	ɑnlɑmlɑrɯ
dɑllArHHn	dɑlleriin	dɑllɑrɯɯn
hɑvɑDAki	hɑvɑteki	hɑvɑdɑki
kɯzlArH	kɯzleri	kɯzlɑrɯ
kesinlAʃAn	kesinlɑʃɑn	kesinleʃen
kitɑplArHHn	kitɑpleriin	kitɑplɑrɯɯn
konuʃmAlArHn	konuʃmelerin	konuʃmɑlɑrɯn
konutlArHn	konutlerin	konutlɑrɯn
okulHHn	okuliin	okuluun
sɑʧlArH	sɑʧleri	sɑʧlɑrɯ
sɑjfɑmHzDA	sɑjfɑmizde	sɑjfɑmɯzdɑ
uzmɑnlArHHn	uzmɑnleriin	uzmɑnlɑrɯɯn
jɑrɑlAnmAlArH	jɑrɑlɑnmeleri	jɑrɑlɑnmɑlɑrɯ
ʧøzHʤH	ʧøziʤi	ʧøzyʤy
ʃɑrtsHz	ʃɑrtsiz	ʃɑrtsɯz
ystDAn	ysttɑn	ystten
ɑrkɑdɑʃmHzHn	ɑrkɑdɑʃmizin	ɑrkɑdɑʃmɯzɯn
ɑrkɑdɑʃlArmA	ɑrkɑdɑʃlermɑ	ɑrkɑdɑʃlɑrmɑ
bɑʃɑrɯlArHHn	bɑʃɑrɯleriin	bɑʃɑrɯlɑrɯɯn
dønmAA	dønmɑɑ	dønmee
fotoɰrɑfʧHlHk	fotoɰrɑfʧilik	fotoɰrɑfʧɯlɯk
fotoɰrɑfʧHlAr	fotoɰrɑfʧiler	fotoɰrɑfʧɯlɑr
gruplArDA	gruplɑrde	gruplɑrdɑ
hyzynlH	hyzynli	hyzynly
hɑjɑtmHzDA	hɑjɑtmizde	hɑjɑtmɯzdɑ
insɑnmHzHn	insɑnmizin	insɑnmɯzɯn
kɑtArAk	kɑterek	kɑtɑrɑk
metodlAr	metodler	metodlɑr
reɑksijonA	reɑksijone	reɑksijonɑ
reɑksijonlArH	reɑksijonleri	reɑksijonlɑrɯ
sytʧH	sytʧɯ	sytʧy
sɑjɯlArHHn	sɑjɯleriin	sɑjɯlɑrɯɯn
sɑjfɑmHz	sɑjfɑmiz	sɑjfɑmɯz
senDA	sendɑ	sende
tɑhminlAr	tɑhminlɑr	tɑhminler
toplɑntɯHHn	toplɑntɯiin	toplɑntɯɯɯn
jɑptɯrɯmlAr	jɑptɯrɯmler	jɑptɯrɯmlɑr
yrynlArDAn	yrynlɑrden	yrynlerden
ɑɰɯzlArH	ɑɰɯzleri	ɑɰɯzlɑrɯ
ɑksesuɑrlArH	ɑksesuɑrleri	ɑksesuɑrlɑrɯ
ɑsɯllH	ɑsɯlli	ɑsɯllɯ
bloklArH	blokleri	bloklɑrɯ
bulmADA	bulmɑdɑ	bulmɑtɑ
bulutlAr	bulutler	bulutlɑr
dyʃynyrlAr	dyʃynyrlɑr	dyʃynyrler
emirlAr	emirlɑr	emirler
gyʧDA	gyʧtɑ	gyʧte
geʧirmAA	geʧirmɑɑ	geʧirmee
hɑlsHzlHk	hɑlsizlɯk	hɑlsizlik
kɑdroA	kɑdroe	kɑdroɑ
kɑnɑtlArH	kɑnɑtleri	kɑnɑtlɑrɯ
kɑplɑmɑlH	kɑplɑmɑli	kɑplɑmɑlɯ
meslektɑʃlArmHz	meslektɑʃlermiz	meslektɑʃlɑrmɯz
modernlAʃmA	modernlɑʃmɑ	modernleʃme
plɑnlArHn	plɑnlerin	plɑnlɑrɯn
ruhsɑtlH	ruhsɑtli	ruhsɑtlɯ
sɑjɯlArHn	sɑjɯlerin	sɑjɯlɑrɯn
sinirlAr	sinirlɑr	sinirler
sporDA	sportɑ	spordɑ
suʧlArHn	suʧlerin	suʧlɑrɯn
tɑnkH	tɑnki	tɑnkɯ
tiplAr	tiplɑr	tipler
jɯldɯzlArHn	jɯldɯzlerin	jɯldɯzlɑrɯn
jɑɰlArH	jɑɰleri	jɑɰlɑrɯ
jɑpmAlArnH	jɑpmelerni	jɑpmɑlɑrnɯ
ʧoʤuklArDAn	ʧoʤuklerden	ʧoʤuklɑrdɑn
dønyʃmAH	dønyʃmɑɯ	dønyʃmei
deriDA	derite	deride
dokuznʤH	dokuznʤi	dokuznʤu
donɑnɯmlArH	donɑnɯmleri	donɑnɯmlɑrɯ
dostʧA	dostʧe	dostʧɑ
elmA	elmɑ	elme
hɑftɑlArDA	hɑftɑlɑrde	hɑftɑlɑrdɑ
iʃverenlAr	iʃverenlɑr	iʃverenler
konsoloslHk	konsoloslik	konsolosluk
misɑfirlAr	misɑfirlɑr	misɑfirler
orɑlArDA	orɑlɑrde	orɑlɑrdɑ
progrɑmlArDAn	progrɑmlerden	progrɑmlɑrdɑn
rektørHn	rektørin	rektøryn
ruhsɑtsHz	ruhsɑtsiz	ruhsɑtsɯz
sɑʧlH	sɑʧli	sɑʧlɯ
silɑhHn	silɑhin	silɑhɯn
telefonnHzHn	telefonnizin	telefonnuzun
televizjonlArDA	televizjonlɑrde	televizjonlɑrdɑ
zɑmɑnlArHn	zɑmɑnlerin	zɑmɑnlɑrɯn
ɑdnHz	ɑdniz	ɑdnɯz
ɑlAbilmAH	ɑlɑbilmɑɯ	ɑlɑbilmei
denejimA	denejimɑ	denejime
editørH	editøri	editøry
fɑrkHn	fɑrkin	fɑrkɯn
gynHHn	gyniin	gynyyn
kømyrH	kømyri	kømyry
kyltyrlAr	kyltyrlɑr	kyltyrler
kɑtɯlDHklArH	kɑtɯldikleri	kɑtɯldɯklɑrɯ
metinDA	metindɑ	metinde
olumsuzlHklAr	olumsuzlɯkler	olumsuzluklɑr
sɑjgɯlArmH	sɑjgɯlɑrmi	sɑjgɯlɑrmɯ
sorulArnHzH	sorulɑrnizi	sorulɑrnɯzɯ
telefonnHzA	telefonnize	telefonnuzɑ
zɑmɑnkinDAn	zɑmɑnkindɑn	zɑmɑnkinden
ʧɑtlɑklAr	ʧɑtlɑkler	ʧɑtlɑklɑr
ɑdnHzH	ɑdnizi	ɑdnɯzɯ
ɑtlAr	ɑtler	ɑtlɑr
bɑnkɑlArDAn	bɑnkɑlɑrden	bɑnkɑlɑrdɑn
boʃluklAr	boʃlukler	boʃluklɑr
bozmA	bozme	bozmɑ
denejH	denejɯ	deneji
gyʧsHz	gyʧsiz	gyʧsyz
gylAn	gylɑn	gylen
gerʧeklAʃmA	gerʧekleʃmɑ	gerʧekleʃme
itirɑzlArH	itirɑzleri	itirɑzlɑrɯ
kullAnHʤHlH	kulleniʤili	kullɑnɯʤɯlɯ
mekɑnlArHn	mekɑnlerin	mekɑnlɑrɯn
oluʃmADA	oluʃmɑdɑ	oluʃmɑtɑ
olHnʤAA	olinʤɑɑ	olunʤɑɑ
pyryzsHz	pyryzsiz	pyryzsyz
proteinlAr	proteinlɑr	proteinler
rekɑbetDA	rekɑbettɑ	rekɑbette
tyketimA	tyketimɑ	tyketime
tozlH	tozlɯ	tozlu
jyzejHn	jyzejɯn	jyzejin
jɑpmAnHzA	jɑpmɑnize	jɑpmɑnɯzɑ
jɑrɯʃlArH	jɑrɯʃleri	jɑrɯʃlɑrɯ
jɑzɯlɯmlArHHn	jɑzɯlɯmleriin	jɑzɯlɯmlɑrɯɯn
ʧɯkHʃlH	ʧɯkiʃli	ʧɯkɯʃlɯ
ʧɑlɯʃɑnlArmHzHn	ʧɑlɯʃɑnlɑrmizin	ʧɑlɯʃɑnlɑrmɯzɯn
ʧɑlɯʃmAlArmHzDA	ʧɑlɯʃmɑlɑrmizde	ʧɑlɯʃmɑlɑrmɯzdɑ
ɑdHn	ɑdin	ɑdɯn
ɑnlɑmlAr	ɑnlɑmler	ɑnlɑmlɑr
bɑʃmHzA	bɑʃmize	bɑʃmɯzɑ
bɑkmADAn	bɑkmeden	bɑkmɑdɑn
buluʃH	buluʃɯ	buluʃu
buzlH	buzlɯ	buzlu
etkenlArDAn	etkenlɑrden	etkenlerden
frekɑnslH	frekɑnsli	frekɑnslɯ
gøndermAnHz	gøndermɑniz	gøndermeniz
kɯrɯklAr	kɯrɯkler	kɯrɯklɑr
kɑdroHn	kɑdroin	kɑdroun
kɑrʃɯmHzDA	kɑrʃɯmɯzde	kɑrʃɯmɯzdɑ
kesinlHk	kesinlɯk	kesinlik
koʃulsHz	koʃulsiz	koʃulsuz
kutlɑmAlArH	kutlɑmeleri	kutlɑmɑlɑrɯ
modellAnmAH	modellɑnmɑɯ	modellenmei
plɑtformlArDA	plɑtformlerde	plɑtformlɑrdɑ
sɑɰlɑDHklArH	sɑɰlɑtɯkleri	sɑɰlɑdɯklɑrɯ
sɑjɯmHz	sɑjɯmiz	sɑjɯmɯz
tɯklAHp	tɯkleip	tɯklɑɯp
tijɑtroHn	tijɑtroin	tijɑtroun
jɑɰlArHn	jɑɰlerin	jɑɰlɑrɯn
ʧɑlɯʃDHkDAn	ʧɑlɯʃdiktɑn	ʧɑlɯʃtɯktɑn
øɰrenʤiDAn	øɰrenʤiten	øɰrenʤiden
ʃehirlArɑrɑsɯ	ʃehirlɑrɑrɑsɯ	ʃehirlerɑrɑsɯ
ɑdnHzA	ɑdnize	ɑdnɯzɑ
ɑnlArDA	ɑnlɑrde	ɑnlɑrdɑ
ɑrɑʤɯnHzHn	ɑrɑʤɯnizin	ɑrɑʤɯnɯzɯn
byjyklHklArH	byjyklikleri	byjyklykleri
byjyklHkDAki	byjyklɯkteki	byjyklykteki
bɑkɑnlɯklAr	bɑkɑnlɯkler	bɑkɑnlɯklɑr
borʧlArHHn	borʧleriin	borʧlɑrɯɯn
borʧlHHn	borʧliin	borʧluun
enflɑsjonA	enflɑsjone	enflɑsjonɑ
gørDHkDAn	gørdiktɑn	gørdykten
girmADA	girmɑdɑ	girmete
hɑberleʃmAH	hɑberleʃmɑɯ	hɑberleʃmei
kɯʃlArH	kɯʃleri	kɯʃlɑrɯ
kyʧylmA	kyʧylmɑ	kyʧylme
kɑnɑllArHHn	kɑnɑlleriin	kɑnɑllɑrɯɯn
kirlAnmAH	kirlɑnmɑɯ	kirlenmei
kuʃɑklAr	kuʃɑkler	kuʃɑklɑr
kuʃlArHn	kuʃlerin	kuʃlɑrɯn
lifA	lifɑ	life
nedenDAn	nedendɑn	nedenden
ojunlArHn	ojunlerin	ojunlɑrɯn
prosedyrH	prosedyri	prosedyry
sɑjfɑDAki	sɑjfɑteki	sɑjfɑdɑki
unsurlArDAn	unsurlɑrden	unsurlɑrdɑn
vermAmAH	vermɑmɑɯ	vermemei
jykymlHlHklAr	jykymlilikler	jykymlylykler
ʧɑlɯʃmAmHz	ʧɑlɯʃmemiz	ʧɑlɯʃmɑmɯz
ynH	yni	yny
ɑlɑʤɑklH	ɑlɑʤɑkli	ɑlɑʤɑklɯ
ɑvukɑtA	ɑvukɑte	ɑvukɑtɑ
ɑjɑrlH	ɑjɑrli	ɑjɑrlɯ
bitmAH	bitmɑɯ	bitmei
ʤihɑzlArA	ʤihɑzlere	ʤihɑzlɑrɑ
dɑkikɑDAn	dɑkikɑtɑn	dɑkikɑdɑn
doɰuDAn	doɰutɑn	doɰudɑn
dolɑrDAn	dolɑrden	dolɑrdɑn
etkinlHkDA	etkinlɯktɑ	etkinlikte
fonA	fone	fonɑ
gøʧH	gøʧi	gøʧy
gørmADAn	gørmɑdɑn	gørmeten
gɑlɑtA	gɑlɑte	gɑlɑtɑ
hesɑplArHHn	hesɑpleriin	hesɑplɑrɯɯn
iplAr	iplɑr	ipler
kɑnɑlHn	kɑnɑlin	kɑnɑlɯn
kɑvrɑmlArHHn	kɑvrɑmleriin	kɑvrɑmlɑrɯɯn
kitɑplArDAn	kitɑplɑrden	kitɑplɑrdɑn
koʃAn	koʃen	koʃɑn
komplikɑsjonlArH	komplikɑsjonleri	komplikɑsjonlɑrɯ
miktɑrDAki	miktɑrdeki	miktɑrdɑki
odɑlH	odɑli	odɑlɯ
odɑmHzA	odɑmize	odɑmɯzɑ
sɑntrɑllAr	sɑntrɑller	sɑntrɑllɑr
telefonnHzH	telefonnizi	telefonnuzu
teminɑtA	teminɑte	teminɑtɑ
teminɑtlArH	teminɑtleri	teminɑtlɑrɯ
tijɑtroA	tijɑtroe	tijɑtroɑ
jɑnsɯmAlArH	jɑnsɯmeleri	jɑnsɯmɑlɑrɯ
jɑsɑklAr	jɑsɑkler	jɑsɑklɑr
zehirlAnmA	zehirlɑnmɑ	zehirlenme
ʧɑlHʃ	ʧɑliʃ	ʧɑlɯʃ
ʧɑlɯʃmADAn	ʧɑlɯʃmɑdɑn	ʧɑlɯʃmɑtɑn
ʃɑnlH	ʃɑnli	ʃɑnlɯ
ɑnlɑtmA	ɑnlɑtme	ɑnlɑtmɑ
ɑrɑʧlArDAn	ɑrɑʧlɑrden	ɑrɑʧlɑrdɑn
ɑrkɑdɑʃlArmHzA	ɑrkɑdɑʃlermize	ɑrkɑdɑʃlɑrmɯzɑ
bɑɰlɑntɯHHn	bɑɰlɑntɯiin	bɑɰlɑntɯɯɯn
bɑrɑʒlAr	bɑrɑʒler	bɑrɑʒlɑr
birimDA	birimdɑ	birimde
eserlArDAn	eserlɑrden	eserlerden
gøkjyzynDA	gøkjyzyndɑ	gøkjyzynde
kɯzA	kɯze	kɯzɑ
køjHHn	køjiin	køjyyn
kɑnunlArDA	kɑnunlɑrde	kɑnunlɑrdɑ
mydyrlAr	mydyrlɑr	mydyrler
memurHHn	memuriin	memuruun
ortɑklɯklAr	ortɑklɯkler	ortɑklɯklɑr
progrɑmlH	progrɑmli	progrɑmlɯ
rɑdjoH	rɑdjoi	rɑdjou
reklɑmlAr	reklɑmler	reklɑmlɑr
sergilAAn	sergilɑɑn	sergileen
tytynDA	tytyndɑ	tytynde
tɑʃlArHn	tɑʃlerin	tɑʃlɑrɯn
teminɑtHn	teminɑtin	teminɑtɯn
uɰurlH	uɰurli	uɰurlu
uzɑklArA	uzɑklere	uzɑklɑrɑ
jɑnmHzDA	jɑnmizde	jɑnmɯzdɑ
zɑrɑrsHz	zɑrɑrsiz	zɑrɑrsɯz
ʧɑlɯʃmɑlArnHzDA	ʧɑlɯʃmɑlɑrnizde	ʧɑlɯʃmɑlɑrnɯzdɑ
ødeAn	ødeɑn	ødeen
ølmA	ølmɑ	ølme
ɑɰlArHHn	ɑɰleriin	ɑɰlɑrɯɯn
ɑdɑDAki	ɑdɑteki	ɑdɑdɑki
ɑrɑlɯklArH	ɑrɑlɯkleri	ɑrɑlɯklɑrɯ
dykkɑnlArHn	dykkɑnlerin	dykkɑnlɑrɯn
dɑɰɯtmA	dɑɰɯtme	dɑɰɯtmɑ
gyvenDA	gyvendɑ	gyvende
gɑzlArH	gɑzleri	gɑzlɑrɯ
geʧmADA	geʧmede	geʧmete
iʧmDAn	iʧmdɑn	iʧmden
ihtijɑʧlArHn	ihtijɑʧlerin	ihtijɑʧlɑrɯn
insɑnlArmHzHn	insɑnlɑrmizin	insɑnlɑrmɯzɯn
istɑsjonlArHHn	istɑsjonleriin	istɑsjonlɑrɯɯn
kɑrDAn	kɑrden	kɑrdɑn
kontrolHHn	kontroliin	kontrolyyn
oʤɑklArDA	oʤɑklerde	oʤɑklɑrdɑ
ortɑklArHHn	ortɑkleriin	ortɑklɑrɯɯn
portføjH	portføjɯ	portføjy
rolA	rolɑ	role
sonlArH	sonleri	sonlɑrɯ
tɑbloDAki	tɑblodeki	tɑblodɑki
teʃkilɑtHn	teʃkilɑtin	teʃkilɑtɯn
vɑtɑndɑʃlArHHn	vɑtɑndɑʃleriin	vɑtɑndɑʃlɑrɯɯn
jemekDA	jemektɑ	jemekte
yrynlArmHzH	yrynlɑrmizi	yrynlermizi
ɑtɑklAr	ɑtɑkler	ɑtɑklɑr
bølymDAki	bølymteki	bølymdeki
bɑʃlAnAʤAk	bɑʃleneʤek	bɑʃlɑnɑʤɑk
ʤumhurijetnHn	ʤumhurijetnɯn	ʤumhurijetnin
dyzenDA	dyzendɑ	dyzende
dɑnɯʃmɑnlArH	dɑnɯʃmɑnleri	dɑnɯʃmɑnlɑrɯ
endystriDA	endystrite	endystride
fɑɑlijetDAn	fɑɑlijettɑn	fɑɑlijetten
fotoɰrɑflArHHn	fotoɰrɑfleriin	fotoɰrɑflɑrɯɯn
gøtyrHp	gøtyrup	gøtyryp
geʧirmAH	geʧirmɑɯ	geʧirmei
getirAbilmA	getirɑbilmɑ	getirebilme
kɑsɯtlH	kɑsɯtli	kɑsɯtlɯ
kɑzɑnDHklArH	kɑzɑndikleri	kɑzɑndɯklɑrɯ
kɑzmA	kɑzme	kɑzmɑ
kitɑplArDA	kitɑplɑrde	kitɑplɑrdɑ
kodHHn	kodiin	koduun
pɑrtiDAn	pɑrtiten	pɑrtiden
performɑnsHHn	performɑnsiin	performɑnsɯɯn
sɯnɯflArA	sɯnɯflere	sɯnɯflɑrɑ
sɑhɑHHn	sɑhɑiin	sɑhɑɯɯn
tymørHn	tymørin	tymøryn
tɑrzHHn	tɑrziin	tɑrzɯɯn
telefonlArHHn	telefonleriin	telefonlɑrɯɯn
toplɑntɯlArHHn	toplɑntɯleriin	toplɑntɯlɑrɯɯn
uʧlH	uʧli	uʧlu
uzɑklɯkDAki	uzɑklɯkteki	uzɑklɯktɑki
zɑrɑrlArDAn	zɑrɑrlɑrden	zɑrɑrlɑrdɑn
ʧevirArAk	ʧevirɑrɑk	ʧevirerek
ɑrzH	ɑrzi	ɑrzɯ
ɑtɑklArH	ɑtɑkleri	ɑtɑklɑrɯ
byroDA	byrode	byrodɑ
bildirmA	bildirmɑ	bildirme
dynDAn	dyndɑn	dynden
deɰerlendirmAHn	deɰerlendirmɑɯn	deɰerlendirmein
deɰinAn	deɰinɑn	deɰinen
kɯzHHn	kɯziin	kɯzɯɯn
kɑjmɑkɑmlHk	kɑjmɑkɑmlik	kɑjmɑkɑmlɯk
kolɑjlɯklArH	kolɑjlɯkleri	kolɑjlɯklɑrɯ
koordinɑtlArH	koordinɑtleri	koordinɑtlɑrɯ
kulyplAr	kulyplɑr	kulypler
kurummHz	kurummiz	kurummuz
lɑborɑtuvɑrlArH	lɑborɑtuvɑrleri	lɑborɑtuvɑrlɑrɯ
odɑmHzHn	odɑmizin	odɑmɯzɯn
olumsuzlHklArA	olumsuzlɯklere	olumsuzluklɑrɑ
ojunlArDA	ojunlɑrde	ojunlɑrdɑ
pɑrkHn	pɑrkin	pɑrkɯn
sɯkɯntɯlArHn	sɯkɯntɯlerin	sɯkɯntɯlɑrɯn
sɯnɯflArHn	sɯnɯflerin	sɯnɯflɑrɯn
sɯnɑvlArHHn	sɯnɑvleriin	sɯnɑvlɑrɯɯn
silɑhsHzlAnmA	silɑhsizlɑnmɑ	silɑhsɯzlɑnmɑ
skorH	skori	skoru
sonuʧsHz	sonuʧsiz	sonuʧsuz
suʧlArDAn	suʧlɑrden	suʧlɑrdɑn
telefonnHz	telefonniz	telefonnuz
tutɑnɑklArH	tutɑnɑkleri	tutɑnɑklɑrɯ
unsurlArHHn	unsurleriin	unsurlɑrɯɯn
jɑnɯtlArH	jɑnɯtleri	jɑnɯtlɑrɯ
jɑzɑrlArA	jɑzɑrlere	jɑzɑrlɑrɑ
jerleʃmAH	jerleʃmɑɯ	jerleʃmei
ʧøkmAH	ʧøkmɑɯ	ʧøkmei
ʧɑɰlArDA	ʧɑɰlɑrde	ʧɑɰlɑrdɑ
øɰrenimA	øɰrenimɑ	øɰrenime
ødemAAn	ødemɑɑn	ødemeen
øneriDA	ønerite	øneride
ɑlmAmHz	ɑlmemiz	ɑlmɑmɯz
ɑjɑklH	ɑjɑkli	ɑjɑklɯ
bɑsɑmɑklH	bɑsɑmɑkli	bɑsɑmɑklɯ
ʤoɰrɑfjɑDA	ʤoɰrɑfjɑte	ʤoɰrɑfjɑdɑ
dyʃArAk	dyʃɑrɑk	dyʃerek
dynH	dyni	dyny
diskDA	disktɑ	diskte
filmA	filmɑ	filme
gørynmAAn	gørynmɑɑn	gørynmeen
gøsterimA	gøsterimɑ	gøsterime
getirmADA	getirmɑdɑ	getirmete
gitDHklArH	gitdikleri	gittikleri
hɑtlArDA	hɑtlerde	hɑtlɑrdɑ
hɑjɑtmHzH	hɑjɑtmizi	hɑjɑtmɯzɯ
ihrɑʤɑtHHn	ihrɑʤɑtiin	ihrɑʤɑtɯɯn
kɑtkɯlArDA	kɑtkɯlɑrde	kɑtkɯlɑrdɑ
mevzuɑtHHn	mevzuɑtiin	mevzuɑtɯɯn
sɑtmA	sɑtme	sɑtmɑ
sijɑsetʧH	sijɑsetʧɯ	sijɑsetʧi
uʧɑklAr	uʧɑkler	uʧɑklɑr
vɑrlɯklArHHn	vɑrlɯkleriin	vɑrlɯklɑrɯɯn
jɑkɯnmAlArH	jɑkɯnmeleri	jɑkɯnmɑlɑrɯ
jɑrɯʃmɑlArDA	jɑrɯʃmɑlɑrde	jɑrɯʃmɑlɑrdɑ
jerjyzynDAki	jerjyzynteki	jerjyzyndeki
ʧɑlɯʃmAlArmHzA	ʧɑlɯʃmɑlɑrmize	ʧɑlɯʃmɑlɑrmɯzɑ
ʧekmAH	ʧekmɑɯ	ʧekmei
ʧoʤuklArmHzH	ʧoʤuklermizi	ʧoʤuklɑrmɯzɯ
ɑlbymHn	ɑlbymin	ɑlbymyn
ɑnlɑtArAk	ɑnlɑterek	ɑnlɑtɑrɑk
ɑteʃDAn	ɑteʃtɑn	ɑteʃten
bɑnkɑlArDA	bɑnkɑlɑrde	bɑnkɑlɑrdɑ
doɰumsAl	doɰumsel	doɰumsɑl
duvɑrlArHn	duvɑrlerin	duvɑrlɑrɯn
gøʧHn	gøʧin	gøʧyn
gereʧlAr	gereʧlɑr	gereʧler
kɑlmADA	kɑlmɑdɑ	kɑlmɑtɑ
kɑtlArH	kɑtleri	kɑtlɑrɯ
kuʃɑklArA	kuʃɑklere	kuʃɑklɑrɑ
kullɑnɯmlH	kullɑnɯmli	kullɑnɯmlɯ
kutuplH	kutupli	kutuplu
myrɑʤɑɑtlArH	myrɑʤɑɑtleri	myrɑʤɑɑtlɑrɯ
memurlArA	memurlere	memurlɑrɑ
oluʃumlAr	oluʃumler	oluʃumlɑr
onurH	onuri	onuru
ojlAr	ojler	ojlɑr
tyrlArDA	tyrlɑrde	tyrlerde
toplumlArH	toplumleri	toplumlɑrɯ
turDA	turde	turdɑ
ujkusHzlHk	ujkusizlɯk	ujkusuzluk
jɑʃlHlArHn	jɑʃlilerin	jɑʃlɯlɑrɯn
jɑpɯtlArH	jɑpɯtleri	jɑpɯtlɑrɯ
ʧekilmAA	ʧekilmɑɑ	ʧekilmee
ølmAH	ølmɑɯ	ølmei
ɑrkɑdɑʃlArmHn	ɑrkɑdɑʃlermin	ɑrkɑdɑʃlɑrmɯn
bɑʃkɑnlHklArH	bɑʃkɑnlikleri	bɑʃkɑnlɯklɑrɯ
bɑroA	bɑroe	bɑroɑ
bejA	bejɑ	beje
dɑvrɑnHʃHn	dɑvrɑniʃin	dɑvrɑnɯʃɯn
deɰiʃkenlHk	deɰiʃkenlɯk	deɰiʃkenlik
deɰiʃmAA	deɰiʃmɑɑ	deɰiʃmee
dengesHzlHk	dengesizlɯk	dengesizlik
doɰɑDAki	doɰɑteki	doɰɑdɑki
dokulArDA	dokulɑrde	dokulɑrdɑ
durHʃ	duriʃ	duruʃ
fɑrklɯlHklArHn	fɑrklɯlɯklerin	fɑrklɯlɯklɑrɯn
firmɑmHzHn	firmɑmizin	firmɑmɯzɯn
formlArHn	formlerin	formlɑrɯn
gruplArDAn	gruplɑrden	gruplɑrdɑn
hoʤɑmHz	hoʤɑmiz	hoʤɑmɯz
kɑʧmA	kɑʧme	kɑʧmɑ
kɑʧmAA	kɑʧmee	kɑʧmɑɑ
kollAr	koller	kollɑr
komʃulHk	komʃulɯk	komʃuluk
nedenlArA	nedenlɑrɑ	nedenlere
pɑrɑlH	pɑrɑli	pɑrɑlɯ
ryzgɑrlArH	ryzgɑrleri	ryzgɑrlɑrɯ
syrmA	syrmɑ	syrme
sɑtHʃlArDA	sɑtiʃlerde	sɑtɯʃlɑrdɑ
sitemHzDAn	sitemizdɑn	sitemizden
sokɑkDAki	sokɑkteki	sokɑktɑki
sunmADA	sunmɑdɑ	sunmɑtɑ
tutumlArH	tutumleri	tutumlɑrɯ
jyzHn	jyzɯn	jyzyn
jɑʃɑmnHzDA	jɑʃɑmnizde	jɑʃɑmnɯzdɑ
jolDAki	joldeki	joldɑki
ʧoɰumHz	ʧoɰumiz	ʧoɰumuz
ɯlɯmlH	ɯlɯmli	ɯlɯmlɯ
ʃirketDAn	ʃirkettɑn	ʃirketten
yrynlArmHzHn	yrynlɑrmizin	yrynlermizin
ɑrkɑdɑʃlArA	ɑrkɑdɑʃlere	ɑrkɑdɑʃlɑrɑ
ɑrtɯklArH	ɑrtɯkleri	ɑrtɯklɑrɯ
bɑkɯmlH	bɑkɯmli	bɑkɯmlɯ
dyzlemDA	dyzlemdɑ	dyzlemde
dɑllArDA	dɑllerde	dɑllɑrdɑ
esenlAr	esenlɑr	esenler
fɑturɑlH	fɑturɑli	fɑturɑlɯ
hɑlklArHn	hɑlklerin	hɑlklɑrɯn
kyltyrlH	kyltyrli	kyltyrly
konferɑnslArH	konferɑnsleri	konferɑnslɑrɯ
kuzejDAn	kuzejdɑn	kuzejden
mirɑsH	mirɑsi	mirɑsɯ
okuDHkDAn	okudiktɑn	okuduktɑn
olumsuzlHklArH	olumsuzlɯkleri	olumsuzluklɑrɯ
sosH	sosi	sosu
tɑʃɯDHklArH	tɑʃɯdikleri	tɑʃɯdɯklɑrɯ
tɑkHp	tɑkip	tɑkɯp
temɑsDA	temɑste	temɑstɑ
tohumlHk	tohumlik	tohumluk
toprɑklArA	toprɑklere	toprɑklɑrɑ
vɑrlɯklH	vɑrlɯkli	vɑrlɯklɯ
jyksekokullArH	jyksekokulleri	jyksekokullɑrɯ
jɑnlArH	jɑnleri	jɑnlɑrɯ
jurttɑʃlAr	jurttɑʃler	jurttɑʃlɑr
ʧøkmA	ʧøkmɑ	ʧøkme
ʧekmAH	ʧekmɑɯ	ʧekmei
ølʧylH	ølʧyli	ølʧyly
ʃuurH	ʃuuri	ʃuuru
yrynHHn	yryniin	yrynyyn
ɑlɯmlArH	ɑlɯmleri	ɑlɯmlɑrɯ
ɑlɑnlH	ɑlɑnli	ɑlɑnlɯ
ɑlbymDA	ɑlbymdɑ	ɑlbymde
ɑtlH	ɑtli	ɑtlɯ
byjyArAk	byjyɑrɑk	byjyerek
bɑʃvuruHHn	bɑʃvuruiin	bɑʃvuruuun
bilDHklArH	biltikleri	bildikleri
bulAbilmA	bulɑbilmɑ	bulɑbilme
defterlAr	defterlɑr	defterler
dinlenmA	dinlenmɑ	dinlenme
hɑjɑtmHzA	hɑjɑtmize	hɑjɑtmɯzɑ
hususHn	hususɯn	hususun
huzursHz	huzursiz	huzursuz
ilɑnlArH	ilɑnleri	ilɑnlɑrɯ
kontrolsHz	kontrolsiz	kontrolsyz
menfɑɑtH	menfɑɑtɯ	menfɑɑti
mevsimDA	mevsimdɑ	mevsimde
pɑhɑlHA	pɑhɑlie	pɑhɑlɯɑ
sɯfɯrA	sɯfɯre	sɯfɯrɑ
sɑtɯʃlArHn	sɑtɯʃlerin	sɑtɯʃlɑrɯn
seʧDHklArH	seʧdikleri	seʧtikleri
sokɑklArH	sokɑkleri	sokɑklɑrɯ
teʧhizɑtHn	teʧhizɑtin	teʧhizɑtɯn
tohumlAr	tohumler	tohumlɑr
unlH	unli	unlu
jurttɑʃlArHn	jurttɑʃlerin	jurttɑʃlɑrɯn
zorlHklArA	zorliklere	zorluklɑrɑ
ʧɑɰlArDAn	ʧɑɰlɑrden	ʧɑɰlɑrdɑn
yretkenlHk	yretkenlɯk	yretkenlik
ɑlmAlH	ɑlmɑli	ɑlmɑlɯ
ɑrɑmAlArDA	ɑrɑmɑlɑrde	ɑrɑmɑlɑrdɑ
belkiDA	belkite	belkide
bildirmAH	bildirmɑɯ	bildirmei
bilgisɑjɑrlArDAn	bilgisɑjɑrlɑrden	bilgisɑjɑrlɑrdɑn
ʤiltDA	ʤilttɑ	ʤiltte
devɑmsHzlHk	devɑmsizlɯk	devɑmsɯzlɯk
dezɑvɑntɑʒlArH	dezɑvɑntɑʒleri	dezɑvɑntɑʒlɑrɯ
fuɑrlArA	fuɑrlere	fuɑrlɑrɑ
gøryntylAAn	gøryntylɑɑn	gøryntyleen
gelDHkʧA	geldukʧɑ	geldikʧe
gelAnlArA	gelenlɑrɑ	gelenlere
hɑlklArH	hɑlkleri	hɑlklɑrɯ
hɑjɑtnHzH	hɑjɑtnizi	hɑjɑtnɯzɯ
iʃlemDA	iʃlemdɑ	iʃlemde
kɯzlArDA	kɯzlerde	kɯzlɑrdɑ
kɑlɑnlArHn	kɑlɑnlerin	kɑlɑnlɑrɯn
kɑmpɑnjɑDA	kɑmpɑnjɑte	kɑmpɑnjɑdɑ
kɑnɯtlAmHʃ	kɑnɯtlemiʃ	kɑnɯtlɑmɯʃ
kesimDAn	kesimdɑn	kesimden
konuʃHp	konuʃip	konuʃup
kutuHHn	kutuiin	kutuuun
lezjonlArH	lezjonleri	lezjonlɑrɯ
myrɑʤɑɑtlAr	myrɑʤɑɑtler	myrɑʤɑɑtlɑr
okullArDAn	okullerden	okullɑrdɑn
ojunʤɑklAr	ojunʤɑkler	ojunʤɑklɑr
sɯrɑDAki	sɯrɑteki	sɯrɑdɑki
syrmA	syrmɑ	syrme
sɑvɑʃlArDA	sɑvɑʃlerde	sɑvɑʃlɑrdɑ
seʧimDAn	seʧimdɑn	seʧimden
uluslArHn	uluslerin	uluslɑrɯn
vɑtɑndɑʃlArmHzA	vɑtɑndɑʃlermize	vɑtɑndɑʃlɑrmɯzɑ
jykselmAA	jykselmɑɑ	jykselmee
jɑʃlHlArDA	jɑʃlilerde	jɑʃlɯlɑrdɑ
ʧelikDAn	ʧeliktɑn	ʧelikten
ɑdresDAn	ɑdrestɑn	ɑdresten
ɑrɯzɑlH	ɑrɯzɑli	ɑrɯzɑlɯ
ɑrɑmHzDAn	ɑrɑmizdɑn	ɑrɑmɯzdɑn
bɯrɑkmADAn	bɯrɑkmeden	bɯrɑkmɑdɑn
bɑkɯmlArH	bɑkɯmleri	bɑkɯmlɑrɯ
bilmAnHz	bilmɑniz	bilmeniz
dønyʃymlH	dønyʃymli	dønyʃymly
døvmA	døvmɑ	døvme
dɑɰlArHHn	dɑɰleriin	dɑɰlɑrɯɯn
direnmA	direnmɑ	direnme
duvɑrlArA	duvɑrlere	duvɑrlɑrɑ
dujsAl	dujsel	dujsɑl
elmDAn	elmdɑn	elmden
geliʃArAk	geliʃɑrɑk	geliʃerek
hɯzA	hɯze	hɯzɑ
hɑmurH	hɑmuri	hɑmuru
hɑnɯmlAr	hɑnɯmler	hɑnɯmlɑr
hɑtlArn	hɑtlern	hɑtlɑrn
kɯsɯtlAHʤH	kɯsɯtleiʤi	kɯsɯtlɑɯʤɯ
kømyrHn	kømyrin	kømyryn
kɑlHnʤA	kɑlinʤe	kɑlɯnʤɑ
kɑlɯtsAl	kɑlɯtsel	kɑlɯtsɑl
kɑjɯplArHn	kɑjɯplerin	kɑjɯplɑrɯn
kurɑmlArH	kurɑmleri	kurɑmlɑrɯ
mutlulHklAr	mutlulikler	mutluluklɑr
olmAnHzH	olmɑnizi	olmɑnɯzɯ
pilotH	pilotɯ	pilotu
sytHHn	sytiin	sytyyn
sektørDAn	sektørtɑn	sektørden
suDAki	suteki	sudɑki
tɑzminɑtHn	tɑzminɑtin	tɑzminɑtɯn
uzɑtmA	uzɑtme	uzɑtmɑ
jyryHʃA	jyryiʃe	jyryyʃe
yzermA	yzermɑ	yzerme
ɑʃɑmɑlArDA	ɑʃɑmɑlɑrde	ɑʃɑmɑlɑrdɑ
ɑrɑmHzA	ɑrɑmize	ɑrɑmɯzɑ
byjylH	byjyli	byjyly
bɑʃvurDHklArH	bɑʃvurdikleri	bɑʃvurduklɑrɯ
bɑʃvurmAnHz	bɑʃvurmɑniz	bɑʃvurmɑnɯz
dønymlHk	dønymlik	dønymlyk
dynjɑmHzDA	dynjɑmizde	dynjɑmɯzdɑ
dyzejlH	dyzejlɯ	dyzejli
etkilAnmA	etkilɑnmɑ	etkilenme
evrɑklArH	evrɑkleri	evrɑklɑrɯ
gøryʃlH	gøryʃli	gøryʃly
gøryntylAnmAH	gøryntylɑnmɑɯ	gøryntylenmei
gyndemDAki	gyndemdɑki	gyndemdeki
gitmAAn	gitmɑɑn	gitmeen
køjlyHn	køjlyin	køjlyyn
kɑbuklH	kɑbukli	kɑbuklu
kɑrɑrDAn	kɑrɑrden	kɑrɑrdɑn
kɑsH	kɑsi	kɑsɯ
kɑtɯlɯmlH	kɑtɯlɯmli	kɑtɯlɯmlɯ
kolHHn	koliin	koluun
lɑborɑtuvɑrlArDA	lɑborɑtuvɑrlɑrde	lɑborɑtuvɑrlɑrdɑ
mɑllArHHn	mɑlleriin	mɑllɑrɯɯn
mɑllArA	mɑllere	mɑllɑrɑ
mɑnɑsH	mɑnɑsi	mɑnɑsɯ
olguHHn	olguiin	olguuun
pɑrklAr	pɑrkler	pɑrklɑr
pɑrlɑmentoA	pɑrlɑmentoe	pɑrlɑmentoɑ
pɑrtiDA	pɑrtite	pɑrtide
pilotlAr	pilotler	pilotlɑr
profesørH	profesøri	profesøry
psikologlAr	psikologler	psikologlɑr
sɑvɑʃlArHn	sɑvɑʃlerin	sɑvɑʃlɑrɯn
suʧA	suʧe	suʧɑ
ujgulɑDHklArH	ujgulɑtɯkleri	ujgulɑdɯklɑrɯ
verAbilAn	verɑbilen	verebilen
jɑnlɯʃlAr	jɑnlɯʃler	jɑnlɯʃlɑr
jɑzDHklArH	jɑzdikleri	jɑzdɯklɑrɯ
jerjyzyHn	jerjyzyin	jerjyzyyn
ʧɑɰmHzHn	ʧɑɰmizin	ʧɑɰmɯzɯn
ʧɑɰdɑʃlAʃmA	ʧɑɰdɑʃleʃmɑ	ʧɑɰdɑʃlɑʃmɑ
ɯʃɯklAr	ɯʃɯkler	ɯʃɯklɑr
ørtAn	ørtɑn	ørten
ɑɰɑbejH	ɑɰɑbejɯ	ɑɰɑbeji
ɑkɑdemisjenlAr	ɑkɑdemisjenlɑr	ɑkɑdemisjenler
ɑkɑlHn	ɑkɑlin	ɑkɑlɯn
ɑlkolHn	ɑlkolin	ɑlkolyn
ɑnɯtsAl	ɑnɯtsel	ɑnɯtsɑl
bɑkɑnmHz	bɑkɑnmiz	bɑkɑnmɯz
burslArH	bursleri	burslɑrɯ
dyʃHp	dyʃip	dyʃyp
dynjɑmHzHn	dynjɑmizin	dynjɑmɯzɯn
duvɑrDAn	duvɑrden	duvɑrdɑn
enginA	enginɑ	engine
gøʧlAr	gøʧlɑr	gøʧler
gøzykAn	gøzykɑn	gøzyken
geʧAnlArA	geʧenlɑrɑ	geʧenlere
hɑrʧlArH	hɑrʧleri	hɑrʧlɑrɯ
irtifɑkH	irtifɑki	irtifɑkɯ
itirɑzDA	itirɑzde	itirɑzdɑ
kɯsɯmlArHHn	kɯsɯmleriin	kɯsɯmlɑrɯɯn
kɑʧnʤH	kɑʧnʤi	kɑʧnʤɯ
kɑjɯplArHHn	kɑjɯpleriin	kɑjɯplɑrɯɯn
konumlArH	konumleri	konumlɑrɯ
kullAnHʤHH	kulleniʤii	kullɑnɯʤɯɯ
kullɑnɯmlAr	kullɑnɯmler	kullɑnɯmlɑr
kumɑʃlAr	kumɑʃler	kumɑʃlɑr
kurlArH	kurleri	kurlɑrɯ
logoH	logoi	logou
onursAl	onursel	onursɑl
orɑnlH	orɑnli	orɑnlɯ
otlAr	otler	otlɑr
pɑjlArHHn	pɑjleriin	pɑjlɑrɯɯn
performɑnsA	performɑnse	performɑnsɑ
performɑnslArH	performɑnsleri	performɑnslɑrɯ
rɑporlArA	rɑporlere	rɑporlɑrɑ
sɑntrɑllArH	sɑntrɑlleri	sɑntrɑllɑrɯ
semptomlArHn	semptomlerin	semptomlɑrɯn
solDAki	soldeki	soldɑki
soluklH	solukli	soluklu
sorunlArDA	sorunlɑrde	sorunlɑrdɑ
tɑʃɯmADA	tɑʃɯmɑdɑ	tɑʃɯmɑtɑ
jɑʃɑHp	jɑʃɑip	jɑʃɑɯp
jɑsɑlArDA	jɑsɑlɑrde	jɑsɑlɑrdɑ
jorumlArH	jorumleri	jorumlɑrɯ
ʧɑlɯʃAlHm	ʧɑlɯʃɑlim	ʧɑlɯʃɑlɯm
ølAnlArHn	ølɑnlerin	ølenlerin
ɑdɯmlArHn	ɑdɯmlerin	ɑdɯmlɑrɯn
ɑnlɑmADA	ɑnlɑmɑdɑ	ɑnlɑmɑtɑ
ɑnlɑjɯʃlArH	ɑnlɑjɯʃleri	ɑnlɑjɯʃlɑrɯ
bebekDA	bebektɑ	bebekte
bejH	bejɯ	beji
boɰɑzDA	boɰɑzde	boɰɑzdɑ
bojutHHn	bojutiin	bojutuun
bulDHklArH	bultikleri	bulduklɑrɯ
døkymɑnlArH	døkymɑnleri	døkymɑnlɑrɯ
dɑɰlArDA	dɑɰlɑrde	dɑɰlɑrdɑ
dɑvɑHHn	dɑvɑiin	dɑvɑɯɯn
fonksijonlH	fonksijonli	fonksijonlu
gøʧmenlAr	gøʧmenlɑr	gøʧmenler
hususDAki	hususteki	husustɑki
iʧermADA	iʧermɑdɑ	iʧermete
ileriDAki	ileriteki	ilerideki
kɯsɯtlAmAH	kɯsɯtlemei	kɯsɯtlɑmɑɯ
konforH	konfori	konforu
kutlAr	kutler	kutlɑr
reformlArH	reformleri	reformlɑrɯ
sɑɰlAHʤHH	sɑɰleiʤii	sɑɰlɑɯʤɯɯ
sɑntrɑllArHn	sɑntrɑllerin	sɑntrɑllɑrɯn
typHn	typin	typyn
tɑmɑmlAHp	tɑmɑmleip	tɑmɑmlɑɯp
topʧHlAr	topʧiler	topʧulɑr
toplɑmlArH	toplɑmleri	toplɑmlɑrɯ
ulusHHn	ulusiin	ulusuun
jønHHn	jøniin	jønyyn
jɑɰmurlH	jɑɰmurli	jɑɰmurlu
jɑprɑklArDA	jɑprɑklerde	jɑprɑklɑrdɑ
jɑzmADAn	jɑzmeden	jɑzmɑdɑn
joɰunlHklH	joɰunlikli	joɰunluklu
ʧizArAk	ʧizɑrɑk	ʧizerek
ʧoʤuklArnHzHn	ʧoʤuklernizin	ʧoʤuklɑrnɯzɯn
ʧoʤuklH	ʧoʤukli	ʧoʤuklu
ʃiddetDA	ʃiddettɑ	ʃiddette
ɑsɯrDA	ɑsɯrde	ɑsɯrdɑ
bɑʃvurulArDA	bɑʃvurulɑrde	bɑʃvurulɑrdɑ
bɑjrɑmlAr	bɑjrɑmler	bɑjrɑmlɑr
bilgiDAn	bilgiten	bilgiden
bojutDAki	bojutteki	bojuttɑki
buhɑrlH	buhɑrli	buhɑrlɯ
dynjɑmHz	dynjɑmiz	dynjɑmɯz
dɑvrɑnHʃDA	dɑvrɑnɯʃte	dɑvrɑnɯʃtɑ
deɰiʃmADAn	deɰiʃmɑdɑn	deɰiʃmeden
dujguHHn	dujguiin	dujguuun
gøryʃHHn	gøryʃiin	gøryʃyyn
gɑjrimenkulHn	gɑjrimenkulin	gɑjrimenkulyn
gidermAA	gidermɑɑ	gidermee
hɑjɑtDAki	hɑjɑtteki	hɑjɑttɑki
hɑjvɑnlArDAn	hɑjvɑnlɑrden	hɑjvɑnlɑrdɑn
insɑnlArmHz	insɑnlɑrmiz	insɑnlɑrmɯz
kyresAllAʃAn	kyresellɑʃɑn	kyreselleʃen
kɑlmAlArH	kɑlmeleri	kɑlmɑlɑrɯ
kɑtmɑnlH	kɑtmɑnli	kɑtmɑnlɯ
kollH	kolli	kollu
konutlArDA	konutlerde	konutlɑrdɑ
kotH	kotɯ	kotu
okuHʤHnHn	okuuʤɯnɯn	okuuʤunun
rɑhɑtsHzlHklAr	rɑhɑtsizlɯkler	rɑhɑtsɯzlɯklɑr
reformlArHn	reformlerin	reformlɑrɯn
teknoloʒiDAki	teknoloʒiteki	teknoloʒideki
turlArH	turleri	turlɑrɯ
ujkusHz	ujkusiz	ujkusuz
jyksekDA	jyksektɑ	jyksekte
jyzHHn	jyziin	jyzyyn
jɑʃɑmlArHHn	jɑʃɑmleriin	jɑʃɑmlɑrɯɯn
ʃɑirlAr	ʃɑirlɑr	ʃɑirler
ʃekilDAki	ʃekilteki	ʃekildeki
ɑʧɯlɯʃDA	ɑʧɯlɯʃte	ɑʧɯlɯʃtɑ
ɑrɑʃtɯrmɑʤɯlArHn	ɑrɑʃtɯrmɑʤɯlerin	ɑrɑʃtɯrmɑʤɯlɑrɯn
ɑrɑHʃlArH	ɑrɑiʃleri	ɑrɑɯʃlɑrɯ
ɑzotlH	ɑzotli	ɑzotlu
bɑlkɑnlArDA	bɑlkɑnlɑrde	bɑlkɑnlɑrdɑ
døkymDA	døkymdɑ	døkymde
dyʃynmAH	dyʃynmɑɯ	dyʃynmei
dɑvrɑnHʃlArA	dɑvrɑniʃlere	dɑvrɑnɯʃlɑrɑ
dekontH	dekonti	dekontu
dilDAki	dilteki	dildeki
dostlHklAr	dostlikler	dostluklɑr
ekipmɑnlArHn	ekipmɑnlerin	ekipmɑnlɑrɯn
fɑbrikɑlArDA	fɑbrikɑlɑrde	fɑbrikɑlɑrdɑ
hykymetDA	hykymettɑ	hykymette
hɑreketDA	hɑrekettɑ	hɑrekette
hɑriʤinDAki	hɑriʤinteki	hɑriʤindeki
hɑjɑtnHzDA	hɑjɑtnizde	hɑjɑtnɯzdɑ
hujlH	hujlɯ	hujlu
ilDAki	ilteki	ildeki
ilkbɑhɑrDA	ilkbɑhɑrde	ilkbɑhɑrdɑ
kɑtkɯHHn	kɑtkɯiin	kɑtkɯɯɯn
korumɑlH	korumɑli	korumɑlɯ
kuʃɑtmA	kuʃɑtme	kuʃɑtmɑ
kumɑndɑlH	kumɑndɑli	kumɑndɑlɯ
miktɑrlArHHn	miktɑrleriin	miktɑrlɑrɯɯn
olAʤAklArH	olɑʤɑkleri	olɑʤɑklɑrɯ
politikɑmHz	politikɑmiz	politikɑmɯz
rizikoHn	rizikoin	rizikoun
suʧlHlHk	suʧlilik	suʧluluk
sunumlAr	sunumler	sunumlɑr
tɑʃɯmAlArH	tɑʃɯmeleri	tɑʃɯmɑlɑrɯ
tɑkɯlHp	tɑkɯlup	tɑkɯlɯp
tɑksitDA	tɑksittɑ	tɑksitte
teklifDA	tekliftɑ	teklifte
trɑfikDA	trɑfiktɑ	trɑfikte
ufuklAr	ufukler	ufuklɑr
ulɑʃAbilmAH	ulɑʃɑbilmɑɯ	ulɑʃɑbilmei
umutsHz	umutsiz	umutsuz
jyksekokullArDA	jyksekokullerde	jyksekokullɑrdɑ
jetiʃmA	jetiʃmɑ	jetiʃme
ʧɑresHzlHk	ʧɑresizlɯk	ʧɑresizlik
ʧubuklArH	ʧubukleri	ʧubuklɑrɯ
bɑʃlɑDHklArH	bɑʃlɑtɯkleri	bɑʃlɑdɯklɑrɯ
bɑʃlArH	bɑʃleri	bɑʃlɑrɯ
bɑhɑdɯrlH	bɑhɑdɯrli	bɑhɑdɯrlɯ
bozmADAn	bozmeden	bozmɑdɑn
bulDHkʧA	bultɯkʧɑ	buldukʧɑ
destekDAn	destektɑn	destekten
eɰilmA	eɰilmɑ	eɰilme
editørlAr	editørlɑr	editørler
fijɑtHn	fijɑtin	fijɑtɯn
fotoɰrɑflH	fotoɰrɑfli	fotoɰrɑflɯ
gøstermAAn	gøstermɑɑn	gøstermeen
geliʃmAHHn	geliʃmɑɯɯn	geliʃmeiin
hɑlykɑrDA	hɑlykɑrde	hɑlykɑrdɑ
hesɑplH	hesɑpli	hesɑplɯ
inʃɑɑtHn	inʃɑɑtin	inʃɑɑtɯn
kɑpɑtArAk	kɑpɑterek	kɑpɑtɑrɑk
kɑrɑrsHz	kɑrɑrsiz	kɑrɑrsɯz
konutlArH	konutleri	konutlɑrɯ
konutH	konutɯ	konutu
kullAnHʤHHHn	kulleniʤiiin	kullɑnɯʤɯɯɯn
meslektɑʃmHz	meslektɑʃmiz	meslektɑʃmɯz
notlArHn	notlerin	notlɑrɯn
okʧHlHk	okʧilik	okʧuluk
olɑnɑklArDAn	olɑnɑklerden	olɑnɑklɑrdɑn
oluʃumlArH	oluʃumleri	oluʃumlɑrɯ
pɑrmɑklArH	pɑrmɑkleri	pɑrmɑklɑrɯ
pɑzɑrlArH	pɑzɑrleri	pɑzɑrlɑrɯ
progrɑmmHz	progrɑmmiz	progrɑmmɯz
ruhsɑtlArH	ruhsɑtleri	ruhsɑtlɑrɯ
sɯnɯfDAki	sɯnɯfteki	sɯnɯftɑki
sɑɰlɑmlHk	sɑɰlɑmlik	sɑɰlɑmlɯk
sɑhiplAr	sɑhiplɑr	sɑhipler
sɑjfɑmHzDAn	sɑjfɑmizdɑn	sɑjfɑmɯzdɑn
sorulArDAn	sorulɑrden	sorulɑrdɑn
sponsorH	sponsori	sponsoru
sunDHklArH	sundikleri	sunduklɑrɯ
tymørlArDA	tymørlɑrde	tymørlerde
tɑbiɑtHn	tɑbiɑtin	tɑbiɑtɯn
tɑlimɑtlAr	tɑlimɑtler	tɑlimɑtlɑr
tutɑrlHlHk	tutɑrlilik	tutɑrlɯlɯk
umutlAr	umutler	umutlɑr
jønlAr	jønlɑr	jønler
jɑkɯtlArHn	jɑkɯtlerin	jɑkɯtlɑrɯn
zijɑretDAn	zijɑrettɑn	zijɑretten
ɯʃɯnlArHHn	ɯʃɯnleriin	ɯʃɯnlɑrɯɯn
ɯrkʧH	ɯrkʧi	ɯrkʧɯ
ɑksɑklHklAr	ɑksɑklikler	ɑksɑklɯklɑr
ɑnɑhtɑrlAmAlH	ɑnɑhtɑrlɑmɑli	ɑnɑhtɑrlɑmɑlɯ
byrokrɑtlAr	byrokrɑtler	byrokrɑtlɑr
bɑʃlɑngɯʧDAki	bɑʃlɑngɯʧteki	bɑʃlɑngɯʧtɑki
bellekDA	bellektɑ	bellekte
bilɑnʧoH	bilɑnʧoi	bilɑnʧou
bilimDA	bilimdɑ	bilimde
binɑlArDAn	binɑlɑrden	binɑlɑrdɑn
broʃyrlAr	broʃyrlɑr	broʃyrler
derinlHkDA	derinlɯktɑ	derinlikte
dileDHklArH	diletikleri	diledikleri
disiplinA	disiplinɑ	disipline
ekAn	ekɑn	eken
ejlemDA	ejlemdɑ	ejlemde
gørmAnHzH	gørmɑnizi	gørmenizi
gydymlH	gydymli	gydymly
geniʃlAAn	geniʃlɑɑn	geniʃleen
inArAk	inɑrɑk	inerek
kɑdromHz	kɑdromiz	kɑdromuz
koʤɑHHn	koʤɑiin	koʤɑɯɯn
kolHn	kolin	kolun
lisɑnsnH	lisɑnsni	lisɑnsnɯ
numɑrɑnHz	numɑrɑniz	numɑrɑnɯz
operɑsjonA	operɑsjone	operɑsjonɑ
ortɑklɯklArH	ortɑklɯkleri	ortɑklɯklɑrɯ
ortɑmlArA	ortɑmlere	ortɑmlɑrɑ
ojlAmADA	ojlemede	ojlɑmɑdɑ
sɑtArAk	sɑterek	sɑtɑrɑk
slogɑnlArH	slogɑnleri	slogɑnlɑrɯ
terʤihlAr	terʤihlɑr	terʤihler
ufɑklH	ufɑkli	ufɑklɯ
ujgunsHz	ujgunsɯz	ujgunsuz
verAbiljor	verɑbiljor	verebiljor
vergiDAn	vergiten	vergiden
vizjonmHz	vizjonmiz	vizjonmuz
jɑɰsHz	jɑɰsiz	jɑɰsɯz
jɑnlɯʃlArH	jɑnlɯʃleri	jɑnlɯʃlɑrɯ
jɑtɑklArHHn	jɑtɑkleriin	jɑtɑklɑrɯɯn
zɑmɑnmHzDA	zɑmɑnmizde	zɑmɑnmɯzdɑ
zɑrɑrDAn	zɑrɑrden	zɑrɑrdɑn
ʧɯkɑrlArHHn	ʧɯkɑrleriin	ʧɯkɑrlɑrɯɯn
ønmDA	ønmdɑ	ønmde
ʃɑnsnHz	ʃɑnsniz	ʃɑnsnɯz
ɑɰlArHn	ɑɰlerin	ɑɰlɑrɯn
ɑmelijɑtA	ɑmelijɑte	ɑmelijɑtɑ
ɑsfɑltH	ɑsfɑlty	ɑsfɑltɯ
ɑvukɑtlArA	ɑvukɑtlere	ɑvukɑtlɑrɑ
bɯrɑkAlHm	bɯrɑkɑlim	bɯrɑkɑlɯm
bɑkɯmsHz	bɑkɯmsiz	bɑkɯmsɯz
bɑtɯlHlAʃmA	bɑtɯlileʃmɑ	bɑtɯlɯlɑʃmɑ
ʤɑnlHlArH	ʤɑnlileri	ʤɑnlɯlɑrɯ
dyzenlAnHp	dyzenlɑnɯp	dyzenlenip
dosjɑDAn	dosjɑtɑn	dosjɑdɑn
fɑrkHHn	fɑrkiin	fɑrkɯɯn
gøkDAn	gøktɑn	gøkten
gømylH	gømyli	gømyly
gørAnlArHn	gørɑnlerin	gørenlerin
gynejDAn	gynejdɑn	gynejden
geʧirmAH	geʧirmɑɯ	geʧirmei
genʧlArDA	genʧlɑrde	genʧlerde
gururH	gururi	gururu
hɑlklAr	hɑlkler	hɑlklɑr
hɑstɑlArmHzHn	hɑstɑlɑrmizin	hɑstɑlɑrmɯzɯn
hɑtɑlArDAn	hɑtɑlɑrden	hɑtɑlɑrdɑn
hɑjɑtlArH	hɑjɑtleri	hɑjɑtlɑrɯ
hektɑrlHk	hektɑrlik	hektɑrlɯk
hoʃgørylH	hoʃgøryli	hoʃgøryly
iʃleDHklArH	iʃletikleri	iʃledikleri
køpryHn	køpryin	køpryyn
kɑlDHkDAn	kɑltiktɑn	kɑldɯktɑn
kɑlkHʃ	kɑlkiʃ	kɑlkɯʃ
kɑpɑklH	kɑpɑkli	kɑpɑklɯ
kɑtHn	kɑtin	kɑtɯn
kɑjbetmAH	kɑjbetmɑɯ	kɑjbetmei
kenɑrDA	kenɑrde	kenɑrdɑ
klɑsørH	klɑsøri	klɑsøry
kuʃlArH	kuʃleri	kuʃlɑrɯ
kurulmHzHn	kurulmizin	kurulmuzun
mimɑrlArHn	mimɑrlerin	mimɑrlɑrɯn
modDA	modde	moddɑ
olɑnɑklArA	olɑnɑklere	olɑnɑklɑrɑ
oturDHklArH	oturdikleri	oturduklɑrɯ
pozisjonA	pozisjone	pozisjonɑ
ruhHHn	ruhiin	ruhuun
tɑnɯmnA	tɑnɯmne	tɑnɯmnɑ
turizmnHn	turizmnɯn	turizmnin
tutɑnɑklAr	tutɑnɑkler	tutɑnɑklɑr
ujgulɑmADA	ujgulɑmɑdɑ	ujgulɑmɑtɑ
jɑʃɑmlArH	jɑʃɑmleri	jɑʃɑmlɑrɯ
jɑrdɯmʤɯlArHHn	jɑrdɯmʤɯleriin	jɑrdɯmʤɯlɑrɯɯn
jɑrdɯmlArHn	jɑrdɯmlerin	jɑrdɯmlɑrɯn
jɑjɯnlArHHn	jɑjɯnleriin	jɑjɯnlɑrɯɯn
ʧɑlɯʃAbilmAH	ʧɑlɯʃɑbilmɑɯ	ʧɑlɯʃɑbilmei
øzerklHk	øzerklɯk	øzerklik
ʃɑnsmHz	ʃɑnsmiz	ʃɑnsmɯz
ɑnlɑHnʤA	ɑnlɑɯnʤe	ɑnlɑɯnʤɑ
ɑrkɑdɑʃlArmHzH	ɑrkɑdɑʃlermizi	ɑrkɑdɑʃlɑrmɯzɯ
bileʃenlAr	bileʃenlɑr	bileʃenler
ʤumhurbɑʃkɑnɯmHz	ʤumhurbɑʃkɑnɯmiz	ʤumhurbɑʃkɑnɯmɯz
dyʃmAA	dyʃmɑɑ	dyʃmee
deɰerlArDAn	deɰerlɑrden	deɰerlerden
devɑmlHlHk	devɑmlilik	devɑmlɯlɯk
dosjɑDAki	dosjɑteki	dosjɑdɑki
duvɑrDA	duvɑrde	duvɑrdɑ
enstityHHn	enstityiin	enstityyyn
eserlArDA	eserlɑrde	eserlerde
fijɑtlH	fijɑtli	fijɑtlɯ
gøkjyzyHn	gøkjyzyin	gøkjyzyyn
gyʧlAnmAH	gyʧlɑnmɑɯ	gyʧlenmei
geʧirmADAn	geʧirmɑdɑn	geʧirmeden
gezArAk	gezɑrɑk	gezerek
gijmA	gijmɑ	gijme
iʧeriDAn	iʧeriten	iʧeriden
insɑnmHz	insɑnmiz	insɑnmɯz
kɯsɯmlArDA	kɯsɯmlerde	kɯsɯmlɑrdɑ
kɑʧɑkʧHlHk	kɑʧɑkʧilik	kɑʧɑkʧɯlɯk
kɑbulA	kɑbulɑ	kɑbule
kɑzɯlArDA	kɑzɯlɑrde	kɑzɯlɑrdɑ
kimjɑsAllArHn	kimjɑsɑllerin	kimjɑsɑllɑrɯn
klinikDA	kliniktɑ	klinikte
krɑllHk	krɑllik	krɑllɯk
kurtulHʃH	kurtuliʃi	kurtuluʃu
kuzejH	kuzejɯ	kuzeji
mɑsrɑflArHn	mɑsrɑflerin	mɑsrɑflɑrɯn
mesɑʒnHzH	mesɑʒnizi	mesɑʒnɯzɯ
okullArmHzDA	okullermizde	okullɑrmɯzdɑ
oluklH	olukli	oluklu
onɑjlAmA	onɑjleme	onɑjlɑmɑ
otH	otɯ	otu
pɑrʧɑʤɯklAr	pɑrʧɑʤɯkler	pɑrʧɑʤɯklɑr
refɑhH	refɑhi	refɑhɯ
sɑɰlɑHp	sɑɰlɑip	sɑɰlɑɯp
sektørlArDAn	sektørlɑrden	sektørlerden
stɑʒlAr	stɑʒler	stɑʒlɑr
uʧɑklArHn	uʧɑklerin	uʧɑklɑrɯn
uʧsHz	uʧsiz	uʧsuz
versijonlArH	versijonleri	versijonlɑrɯ
jɑɰmurH	jɑɰmuri	jɑɰmuru
jɑklɑʃɯmlArHn	jɑklɑʃɯmlerin	jɑklɑʃɯmlɑrɯn
jɑnnHzA	jɑnnize	jɑnnɯzɑ
jɑpmAmA	jɑpmeme	jɑpmɑmɑ
jɑzDHkDAn	jɑzdiktɑn	jɑzdɯktɑn
zɯrhlH	zɯrhli	zɯrhlɯ
zeminlArDA	zeminlɑrde	zeminlerde
ʧɯkHʃDA	ʧɯkiʃte	ʧɯkɯʃtɑ
ʧɑlɯʃɑnlArmHz	ʧɑlɯʃɑnlɑrmiz	ʧɑlɯʃɑnlɑrmɯz
ʧɑmurH	ʧɑmuri	ʧɑmuru
ʧɑtɯʃmAlArH	ʧɑtɯʃmeleri	ʧɑtɯʃmɑlɑrɯ
ʧekerlAr	ʧekerlɑr	ʧekerler
ødeDHklArH	ødetikleri	ødedikleri
yʧnʤHlHk	yʧnʤilik	yʧnʤylyk
yrynDAn	yryndɑn	yrynden
ɑʧmADAn	ɑʧmeden	ɑʧmɑdɑn
ɑmelijɑtlArH	ɑmelijɑtleri	ɑmelijɑtlɑrɯ
ɑtɑlHm	ɑtɑlim	ɑtɑlɯm
ɑvHn	ɑvin	ɑvɯn
ɑzɯnlɯklAr	ɑzɯnlɯkler	ɑzɯnlɯklɑr
ɑzɑlmADA	ɑzɑlmɑdɑ	ɑzɑlmɑtɑ
bɑkHʃlArH	bɑkiʃleri	bɑkɯʃlɑrɯ
blokH	bloki	bloku
bonoH	bonoi	bonou
derinA	derinɑ	derine
donɑnɯmlAr	donɑnɯmler	donɑnɯmlɑr
dosjɑlArDA	dosjɑlɑrde	dosjɑlɑrdɑ
frekɑnslArDA	frekɑnslerde	frekɑnslɑrdɑ
gørynymDA	gørynymdɑ	gørynymde
gørDHkʧA	gørtɯkʧɑ	gørdykʧe
gøzHHn	gøziin	gøzyyn
gelmAmAH	gelmɑmɑɯ	gelmemei
hykymlHHn	hykymliin	hykymlyyn
hɑtlArA	hɑtlere	hɑtlɑrɑ
hɑvuzlArH	hɑvuzleri	hɑvuzlɑrɯ
hɑjɑtmHn	hɑjɑtmin	hɑjɑtmɯn
køjlHlArH	køjlileri	køjlyleri
kɑnɑlDA	kɑnɑltɑ	kɑnɑldɑ
kɑnɑlDAn	kɑnɑltɑn	kɑnɑldɑn
kɑslArHHn	kɑsleriin	kɑslɑrɯɯn
kɑjɯtlArDA	kɑjɯtlerde	kɑjɯtlɑrdɑ
kimDAn	kimdɑn	kimden
klɑsørHn	klɑsørin	klɑsøryn
kuʃH	kuʃɯ	kuʃu
meslektɑʃlArmHzA	meslektɑʃlermize	meslektɑʃlɑrmɯzɑ
metotlAr	metotler	metotlɑr
normlArH	normleri	normlɑrɯ
prosedyrlAr	prosedyrlɑr	prosedyrler
sɯzmA	sɯzme	sɯzmɑ
syslAAn	syslɑɑn	sysleen
suʧlArA	suʧlere	suʧlɑrɑ
sunumlArH	sunumleri	sunumlɑrɯ
typlAr	typlɑr	typler
tɑʃɯnmɑzlArHn	tɑʃɯnmɑzlerin	tɑʃɯnmɑzlɑrɯn
tɑɑrruzA	tɑɑrruze	tɑɑrruzɑ
tɑbloHHn	tɑbloiin	tɑblouun
vɑsɯflArH	vɑsɯfleri	vɑsɯflɑrɯ
jønlArDAn	jønlɑrden	jønlerden
jyryHʃlArH	jyryiʃleri	jyryyʃleri
jɑkɯnnA	jɑkɯnne	jɑkɯnnɑ
jɑnlɯʃlHklAr	jɑnlɯʃlikler	jɑnlɯʃlɯklɑr
jɑrɑtDHklArH	jɑrɑttikleri	jɑrɑttɯklɑrɯ
jɑtɯrɯmlArDA	jɑtɯrɯmlerde	jɑtɯrɯmlɑrdɑ
jɑtɑklArDA	jɑtɑklerde	jɑtɑklɑrdɑ
jɑzɑrlArHHn	jɑzɑrleriin	jɑzɑrlɑrɯɯn
jemeklHk	jemeklɯk	jemeklik
ødylHn	ødylin	ødylyn
ʃykrɑnlArmH	ʃykrɑnlɑrmi	ʃykrɑnlɑrmɯ
ɑʧDHklArH	ɑʧdikleri	ɑʧtɯklɑrɯ
ɑdɑptørH	ɑdɑptøri	ɑdɑptøry
ɑlɯʃkɑnlɯklAr	ɑlɯʃkɑnlɯkler	ɑlɯʃkɑnlɯklɑr
ɑsɯrlHk	ɑsɯrlik	ɑsɯrlɯk
bɑroHn	bɑroin	bɑroun
bitymlH	bitymli	bitymly
dɯʃDA	dɯʃte	dɯʃtɑ
dønerlAr	dønerlɑr	dønerler
dɑɰɯtHʤH	dɑɰɯtiʤi	dɑɰɯtɯʤɯ
dijɑgrɑmlArH	dijɑgrɑmleri	dijɑgrɑmlɑrɯ
dizinA	dizinɑ	dizine
durHʃH	duriʃi	duruʃu
duvɑrlArHHn	duvɑrleriin	duvɑrlɑrɯɯn
elimDAki	elimdɑki	elimdeki
enfeksijonA	enfeksijone	enfeksijonɑ
inmA	inmɑ	inme
kitɑpDAki	kitɑpteki	kitɑptɑki
kullɑnmAnHzH	kullɑnmɑnizi	kullɑnmɑnɯzɯ
kutuA	kutue	kutuɑ
meʤlisDAn	meʤlistɑn	meʤlisten
oʤɑklArHHn	oʤɑkleriin	oʤɑklɑrɯɯn
oruʧlArH	oruʧleri	oruʧlɑrɯ
poliplAr	poliplɑr	polipler
sorunmHz	sorunmiz	sorunmuz
tɑblolArDA	tɑblolɑrde	tɑblolɑrdɑ
tɑrɑfsHzlHk	tɑrɑfsizlɯk	tɑrɑfsɯzlɯk
tɑrzlArH	tɑrzleri	tɑrzlɑrɯ
telefonlArHn	telefonlerin	telefonlɑrɯn
tuzlArH	tuzleri	tuzlɑrɯ
umutlH	umutli	umutlu
ujumsHzlHk	ujumsizlɯk	ujumsuzluk
vɑtɑndɑʃmHz	vɑtɑndɑʃmiz	vɑtɑndɑʃmɯz
jɑɰHʃlAr	jɑɰiʃler	jɑɰɯʃlɑr
jɑzɑrlHk	jɑzɑrlik	jɑzɑrlɯk
jenilAʃmA	jenileʃmɑ	jenileʃme
jurtlArH	jurtleri	jurtlɑrɯ
ɑʧɯklɑmɑlH	ɑʧɯklɑmɑli	ɑʧɯklɑmɑlɯ
ɑʧmAH	ɑʧmei	ɑʧmɑɯ
ɑlemDA	ɑlemdɑ	ɑlemde
ɑrkɑdɑʃnHz	ɑrkɑdɑʃniz	ɑrkɑdɑʃnɯz
ɑzɑlHʃ	ɑzɑliʃ	ɑzɑlɯʃ
byroA	byroe	byroɑ
bɑʤɑklArH	bɑʤɑkleri	bɑʤɑklɑrɯ
bɑkɑnlɯklArHn	bɑkɑnlɯklerin	bɑkɑnlɯklɑrɯn
ʤinsDAn	ʤinstɑn	ʤinsten
denetlAAn	denetlɑɑn	denetleen
devirlArDA	devirlɑrde	devirlerde
esinlAnArAk	esinlɑnɑrɑk	esinlenerek
etkilAnmAH	etkilɑnmɑɯ	etkilenmei
fɑizlH	fɑizlɯ	fɑizli
fɑzDA	fɑzde	fɑzdɑ
fotoɰrɑflArA	fotoɰrɑflere	fotoɰrɑflɑrɑ
gyʧsHzlHk	gyʧsizlɯk	gyʧsyzlyk
kɑnɯtlAmA	kɑnɯtleme	kɑnɯtlɑmɑ
kɑnɑtlAr	kɑnɑtler	kɑnɑtlɑr
kɑpɯlArHn	kɑpɯlerin	kɑpɯlɑrɯn
kɑrDA	kɑrde	kɑrdɑ
kɑtDAki	kɑtteki	kɑttɑki
klorlH	klorli	klorlu
kolesterolH	kolesteroli	kolesteroly
kontrolHn	kontrolin	kontrolyn
konuʃmAlArDA	konuʃmɑlɑrde	konuʃmɑlɑrdɑ
konutHn	konutin	konutun
mezɑrlHk	mezɑrlik	mezɑrlɯk
ortɑmlArHn	ortɑmlerin	ortɑmlɑrɯn
otomɑsjonA	otomɑsjone	otomɑsjonɑ
ojunlArDAn	ojunlɑrden	ojunlɑrdɑn
protokolHn	protokolin	protokolyn
sɯnɯrlArDA	sɯnɯrlɑrde	sɯnɯrlɑrdɑ
sɑvɑʃʧH	sɑvɑʃʧi	sɑvɑʃʧɯ
sendikɑmHz	sendikɑmiz	sendikɑmɯz
sunAbilmA	sunɑbilmɑ	sunɑbilme
tymørH	tymøri	tymøry
tytynlArA	tytynlɑrɑ	tytynlere
tɑʃlArHHn	tɑʃleriin	tɑʃlɑrɯɯn
tɑkɯmlArHHn	tɑkɯmleriin	tɑkɯmlɑrɯɯn
tɑkvimDA	tɑkvimdɑ	tɑkvimde
tɑrɑfnHzA	tɑrɑfnize	tɑrɑfnɯzɑ
temɑslAr	temɑsler	temɑslɑr
teminɑtlArHn	teminɑtlerin	teminɑtlɑrɯn
tijɑtroDA	tijɑtrode	tijɑtrodɑ
turizmDA	turizmdɑ	turizmde
tutAbilmA	tutɑbilmɑ	tutɑbilme
tutHʃ	tutɯʃ	tutuʃ
unutHp	unutip	unutup
vɑsɯflH	vɑsɯfli	vɑsɯflɯ
jɯlDAki	jɯldeki	jɯldɑki
jønetimDAn	jønetimdɑn	jønetimden
jɑʃlHlArA	jɑʃlilere	jɑʃlɯlɑrɑ
zɑrɑrlArA	zɑrɑrlere	zɑrɑrlɑrɑ
ʧɑlɯʃmAlArnHz	ʧɑlɯʃmelerniz	ʧɑlɯʃmɑlɑrnɯz
ʧizimA	ʧizimɑ	ʧizime
ɑlmAlArnA	ɑlmelerne	ɑlmɑlɑrnɑ
ɑnlArH	ɑnleri	ɑnlɑrɯ
byjyHp	byjyip	byjyyp
bɑɰlArHn	bɑɰlerin	bɑɰlɑrɯn
ʤiroH	ʤiroi	ʤirou
elmɑlH	elmɑli	elmɑlɯ
gørynmAH	gørynmɑɯ	gørynmei
gøtyrmA	gøtyrmɑ	gøtyrme
gynʤellAnmAH	gynʤellɑnmɑɯ	gynʤellenmei
gynlH	gynli	gynly
gereksinmA	gereksinmɑ	gereksinme
gitmADA	gitmede	gitmete
hɑvuzA	hɑvuze	hɑvuzɑ
hɑjɑtmHz	hɑjɑtmiz	hɑjɑtmɯz
idrɑrDA	idrɑrde	idrɑrdɑ
ihtijɑʧlArnHzA	ihtijɑʧlernize	ihtijɑʧlɑrnɯzɑ
ikiDAn	ikiten	ikiden
kɑnɑllArHn	kɑnɑllerin	kɑnɑllɑrɯn
kɑnɑllArDAn	kɑnɑllerden	kɑnɑllɑrdɑn
kɑrbonhidrɑtlAr	kɑrbonhidrɑtler	kɑrbonhidrɑtlɑr
kɑtɑloglAr	kɑtɑlogler	kɑtɑloglɑr
kɑzɑlArDA	kɑzɑlɑrde	kɑzɑlɑrdɑ
konuklArHn	konuklerin	konuklɑrɯn
korkAn	korken	korkɑn
koroH	koroi	korou
koruHp	koruip	koruup
kurmAlArH	kurmeleri	kurmɑlɑrɯ
kurullArDA	kurullerde	kurullɑrdɑ
lɑborɑtuɑrlArH	lɑborɑtuɑrleri	lɑborɑtuɑrlɑrɯ
nɑmuslH	nɑmusli	nɑmuslu
noktɑlH	noktɑli	noktɑlɯ
olAʤAklArnH	olɑʤɑklerni	olɑʤɑklɑrnɯ
rolHHn	roliin	rolyyn
sɑɰlɑmADAn	sɑɰlɑmɑdɑn	sɑɰlɑmɑtɑn
senɑrjoH	senɑrjoi	senɑrjou
sensHz	sensɯz	sensiz
sorguA	sorgue	sorguɑ
tɑrɑfmHzA	tɑrɑfmize	tɑrɑfmɯzɑ
tempoH	tempoi	tempou
uzɑklArDAn	uzɑklerden	uzɑklɑrdɑn
vɑkɯflArHn	vɑkɯflerin	vɑkɯflɑrɯn
vermAlH	vermɑli	vermeli
jyklAnHʤHA	jyklɑnɯʤɯɑ	jykleniʤie
jɑʃlAr	jɑʃler	jɑʃlɑr
jɑpɯlArDAn	jɑpɯlɑrden	jɑpɯlɑrdɑn
jɑrɯjɯlDAn	jɑrɯjɯlden	jɑrɯjɯldɑn
jɑtHp	jɑtip	jɑtɯp
jetiʃmAH	jetiʃmɑɯ	jetiʃmei
jollH	jolli	jollu
ylkemHzDAn	ylkemizdɑn	ylkemizden
ɑʃɑmɑlArDAn	ɑʃɑmɑlɑrden	ɑʃɑmɑlɑrdɑn
ɑrkɑdɑʃmHn	ɑrkɑdɑʃmin	ɑrkɑdɑʃmɯn
ɑtsHz	ɑtsiz	ɑtsɯz
ɑjrɯlDHkDAn	ɑjrɯldiktɑn	ɑjrɯldɯktɑn
bɑɰɯʃlAr	bɑɰɯʃler	bɑɰɯʃlɑr
bɑʃlArDA	bɑʃlerde	bɑʃlɑrdɑ
beklAnmAH	beklɑnmɑɯ	beklenmei
buʤɑksHz	buʤɑksiz	buʤɑksɯz
døllAnmA	døllɑnmɑ	døllenme
dønHnʤA	døninʤe	dønynʤe
deɰiʃmADA	deɰiʃmɑdɑ	deɰiʃmete
deriDAn	deriten	deriden
desteklAmAA	desteklɑmɑɑ	desteklemee
dostmHz	dostmiz	dostmuz
evrɑklArHn	evrɑklerin	evrɑklɑrɯn
fuɑrlArH	fuɑrleri	fuɑrlɑrɯ
gøkjyzynH	gøkjyzyni	gøkjyzyny
gøndermAA	gøndermɑɑ	gøndermee
gørmAHn	gørmɑɯn	gørmein
geʤikmAH	geʤikmɑɯ	geʤikmei
gerekAnH	gerekɑnɯ	gerekeni
girmAnHzDAn	girmɑnɯzdɑn	girmenizden
grɑfikDA	grɑfiktɑ	grɑfikte
ijilAʃmAH	ijileʃmɑɯ	ijileʃmei
kɑbuklArH	kɑbukleri	kɑbuklɑrɯ
kɑdɯnlArDAn	kɑdɯnlɑrden	kɑdɯnlɑrdɑn
kɑslArDA	kɑslerde	kɑslɑrdɑ
kɑzɑnʧlArH	kɑzɑnʧleri	kɑzɑnʧlɑrɯ
koltuklAr	koltukler	koltuklɑr
konArAk	konerek	konɑrɑk
konseptH	konseptɯ	konsepti
kullHk	kullik	kulluk
kurslArHn	kurslerin	kurslɑrɯn
lɑborɑtuɑrDA	lɑborɑtuɑrde	lɑborɑtuɑrdɑ
lɑfH	lɑfi	lɑfɯ
lɑflAr	lɑfler	lɑflɑr
mɑʧA	mɑʧe	mɑʧɑ
mɑʧlArH	mɑʧleri	mɑʧlɑrɯ
mɑkbuzlArH	mɑkbuzleri	mɑkbuzlɑrɯ
mɑkinɑlArDA	mɑkinɑlɑrde	mɑkinɑlɑrdɑ
merdivenlAr	merdivenlɑr	merdivenler
mezunlArHn	mezunlerin	mezunlɑrɯn
odɑlArDAn	odɑlɑrden	odɑlɑrdɑn
pɑrlɑmentoDA	pɑrlɑmentode	pɑrlɑmentodɑ
pɑrlɑmentoHn	pɑrlɑmentoin	pɑrlɑmentoun
pɑsɑportlAr	pɑsɑportler	pɑsɑportlɑr
ryzgɑrlH	ryzgɑrli	ryzgɑrlɯ
sɯʤɑklɯklArH	sɯʤɑklɯkleri	sɯʤɑklɯklɑrɯ
sɯrlArH	sɯrleri	sɯrlɑrɯ
sɑɰlAnmADA	sɑɰlɑnmɑdɑ	sɑɰlɑnmɑtɑ
sɑjfɑmHzA	sɑjfɑmize	sɑjfɑmɯzɑ
silɑhsHz	silɑhsiz	silɑhsɯz
stɑndH	stɑndi	stɑndɯ
umutlArH	umutleri	umutlɑrɯ
ujmAlArH	ujmeleri	ujmɑlɑrɯ
ujumsHz	ujumsiz	ujumsuz
jyksekøɰretimA	jyksekøɰretimɑ	jyksekøɰretime
jyzejDAn	jyzejdɑn	jyzejden
jɑrɯʃDA	jɑrɯʃte	jɑrɯʃtɑ
jɑzmAH	jɑzmei	jɑzmɑɯ
ʧɯkHʃlAr	ʧɯkiʃler	ʧɯkɯʃlɑr
ʧɑlɯʃmAlArmHzHn	ʧɑlɯʃmɑlɑrmizin	ʧɑlɯʃmɑlɑrmɯzɯn
ʧɑlɯʃmAlArnHzH	ʧɑlɯʃmelernizi	ʧɑlɯʃmɑlɑrnɯzɯ
ʃɑrtlArDAn	ʃɑrtlerden	ʃɑrtlɑrdɑn
ɑʧɯklɑmAlArHn	ɑʧɯklɑmelerin	ɑʧɯklɑmɑlɑrɯn
ɑidɑtlArH	ɑidɑtleri	ɑidɑtlɑrɯ
ɑmelijɑtHn	ɑmelijɑtin	ɑmelijɑtɯn
ɑnɑjɑsɑmHzHn	ɑnɑjɑsɑmizin	ɑnɑjɑsɑmɯzɯn
ɑrɑHʃlAr	ɑrɑiʃler	ɑrɑɯʃlɑr
ɑromɑlH	ɑromɑli	ɑromɑlɯ
ɑtɯklArHHn	ɑtɯkleriin	ɑtɯklɑrɯɯn
bɑʃnHzH	bɑʃnizi	bɑʃnɯzɯ
bɑnjoH	bɑnjoi	bɑnjou
bɑsmɑnHz	bɑsmɑniz	bɑsmɑnɯz
bitmAAn	bitmɑɑn	bitmeen
døkmA	døkmɑ	døkme
dyʃmA	dyʃmɑ	dyʃme
dɑmɑrlArDA	dɑmɑrlɑrde	dɑmɑrlɑrdɑ
dolulHk	dolulɯk	doluluk
evlenmA	evlenmɑ	evlenme
fɑrklHlHklArA	fɑrkliliklere	fɑrklɯlɯklɑrɑ
formlArHHn	formleriin	formlɑrɯɯn
gøryntylAnAn	gøryntylɑnɑn	gøryntylenen
gørmAnHz	gørmɑniz	gørmeniz
gøzlAnmAH	gøzlɑnmɑɯ	gøzlenmei
geniʃlikDA	geniʃliktɑ	geniʃlikte
gijAn	gijɑn	gijen
hɑlkmHzH	hɑlkmizi	hɑlkmɯzɯ
hɑjɑtmH	hɑjɑtmi	hɑjɑtmɯ
ihtijɑʧlArnHzH	ihtijɑʧlernizi	ihtijɑʧlɑrnɯzɯ
ilgiDAn	ilgiten	ilgiden
ilgilenmA	ilgilenmɑ	ilgilenme
istɑsjonA	istɑsjone	istɑsjonɑ
kyrlAʃAn	kyrlɑʃɑn	kyrleʃen
kɑbulnH	kɑbulnɯ	kɑbulny
kɑdemeDAki	kɑdemeteki	kɑdemedeki
kɑdroHHn	kɑdroiin	kɑdrouun
kɑhrɑmɑnlArH	kɑhrɑmɑnleri	kɑhrɑmɑnlɑrɯ
kɑnɑlHHn	kɑnɑliin	kɑnɑlɯɯn
koʃullH	koʃulli	koʃullu
konuklArA	konuklere	konuklɑrɑ
opsijonlArHn	opsijonlerin	opsijonlɑrɯn
otobysH	otobysi	otobysy
ojlArH	ojleri	ojlɑrɯ
pijɑsɑlArDAki	pijɑsɑlɑrdeki	pijɑsɑlɑrdɑki
pozisjonlArH	pozisjonleri	pozisjonlɑrɯ
rekorH	rekori	rekoru
sytunlArH	sytunleri	sytunlɑrɯ
sɑʧAn	sɑʧen	sɑʧɑn
sɑrkAn	sɑrken	sɑrkɑn
senɑtoHn	senɑtoin	senɑtoun
skorlArH	skorleri	skorlɑrɯ
tɑkɯmlArHn	tɑkɯmlerin	tɑkɯmlɑrɯn
tɑnklArH	tɑnkleri	tɑnklɑrɯ
topluluklArHn	topluluklerin	topluluklɑrɯn
toplummHz	toplummiz	toplummuz
turlH	turli	turlu
jykselDHkʧA	jykseldukʧɑ	jykseldikʧe
jyrytmADA	jyrytmede	jyrytmete
jolsuzlHklArHn	jolsuzlɯklerin	jolsuzluklɑrɯn
zeminlAr	zeminlɑr	zeminler
ʧøkHʃ	ʧøkiʃ	ʧøkyʃ
ʧøzymlAmAH	ʧøzymlɑmɑɯ	ʧøzymlemei
ʧɑlɯʃmAnHz	ʧɑlɯʃmɑniz	ʧɑlɯʃmɑnɯz
ʧekmADA	ʧekmede	ʧekmete
ølymsHz	ølymsiz	ølymsyz
ølHnʤAA	ølinʤɑɑ	ølynʤee
øzgyrlHklArHHn	øzgyrlikleriin	øzgyrlykleriin
ɑʧmADA	ɑʧmede	ɑʧmɑtɑ
ɑɰɯzDA	ɑɰɯzde	ɑɰɯzdɑ
ɑmirlAr	ɑmirlɑr	ɑmirler
ɑjɑklArHHn	ɑjɑkleriin	ɑjɑklɑrɯɯn
ɑjɑrlArHHn	ɑjɑrleriin	ɑjɑrlɑrɯɯn
ɑjlArA	ɑjlere	ɑjlɑrɑ
ɑzɯnlɯklArHn	ɑzɯnlɯklerin	ɑzɯnlɯklɑrɯn
bølmA	bølmɑ	bølme
bɑnkɑmHzHn	bɑnkɑmizin	bɑnkɑmɯzɯn
bɑnjoA	bɑnjoe	bɑnjoɑ
bɑjlAr	bɑjler	bɑjlɑr
bitHnʤAA	bitinʤɑɑ	bitinʤee
bulHʃlAr	buliʃler	buluʃlɑr
ʤihɑzlArDA	ʤihɑzlerde	ʤihɑzlɑrdɑ
dyʃmɑnlArH	dyʃmɑnleri	dyʃmɑnlɑrɯ
dykkɑnlArH	dykkɑnleri	dykkɑnlɑrɯ
dyzeltmAA	dyzeltmɑɑ	dyzeltmee
dolɑjsHz	dolɑjsiz	dolɑjsɯz
dosjɑlArnHzH	dosjɑlɑrnizi	dosjɑlɑrnɯzɯ
dojAsHjA	dojɑsije	dojɑsɯjɑ
durumlArDAn	durumlerden	durumlɑrdɑn
enstitymHz	enstitymiz	enstitymyz
erozjonA	erozjone	erozjonɑ
etDHkʧA	ettɯkʧɑ	ettikʧe
fɑktørHHn	fɑktøriin	fɑktøryyn
fotoɰrɑflArDAn	fotoɰrɑflerden	fotoɰrɑflɑrdɑn
gøndermAH	gøndermɑɯ	gøndermei
geʧDHklArH	geʧdikleri	geʧtikleri
geliʃDHkʧA	geliʃtɯkʧɑ	geliʃtikʧe
hɑkikɑtH	hɑkikɑtɯ	hɑkikɑti
hɑlDAki	hɑlteki	hɑldeki
hesɑplArDA	hesɑplɑrde	hesɑplɑrdɑ
hukukʧHlAr	hukukʧiler	hukukʧulɑr
inDA	indɑ	inde
istekDA	istektɑ	istekte
kɯlɑvuzDA	kɯlɑvuzde	kɯlɑvuzdɑ
kyʧylAn	kyʧylɑn	kyʧylen
kɑʧmA	kɑʧme	kɑʧmɑ
kɑtAʤAk	kɑteʤek	kɑtɑʤɑk
kurɑmlAr	kurɑmler	kurɑmlɑr
mɑɰdurH	mɑɰduri	mɑɰduru
metinlArDA	metinlɑrde	metinlerde
misjonmHz	misjonmiz	misjonmuz
motorlArHn	motorlerin	motorlɑrɯn
okullArDAki	okullerdeki	okullɑrdɑki
orgɑnizɑsjonlArHn	orgɑnizɑsjonlerin	orgɑnizɑsjonlɑrɯn
pɑrmɑklAr	pɑrmɑkler	pɑrmɑklɑr
ruhsɑtA	ruhsɑte	ruhsɑtɑ
sɯfɯrDAn	sɯfɯrtɑn	sɯfɯrdɑn
sojsAl	sojsel	sojsɑl
stoklArH	stokleri	stoklɑrɯ
tɑhɑkkukH	tɑhɑkkuki	tɑhɑkkuku
tɑzminɑtsHz	tɑzminɑtsiz	tɑzminɑtsɯz
telefonlArDA	telefonlɑrde	telefonlɑrdɑ
tutumlAr	tutumler	tutumlɑr
uʧɑklArH	uʧɑkleri	uʧɑklɑrɯ
verAbilmAH	verɑbilmɑɯ	verebilmei
vitɑminlAr	vitɑminlɑr	vitɑminler
jɯɰɯnlArH	jɯɰɯnleri	jɯɰɯnlɑrɯ
jønetmAA	jønetmɑɑ	jønetmee
jyrytDHklArH	jyrytdikleri	jyryttykleri
jɑkHp	jɑkip	jɑkɯp
jɑpɯtlAr	jɑpɯtler	jɑpɯtlɑr
ʧɑmlHk	ʧɑmlik	ʧɑmlɯk
ørtyHHn	ørtyiin	ørtyyyn
ʃiʃirmA	ʃiʃirmɑ	ʃiʃirme
yrynmHz	yrynmiz	yrynmyz
ɑʧɯHHn	ɑʧɯiin	ɑʧɯɯɯn
ɑkɯmlArHHn	ɑkɯmleriin	ɑkɯmlɑrɯɯn
ɑlmAksHzHn	ɑlmeksizin	ɑlmɑksɯzɯn
ɑjnɑlH	ɑjnɑli	ɑjnɑlɯ
bytynHn	bytynin	bytynyn
bɑskɯlArHn	bɑskɯlerin	bɑskɯlɑrɯn
bɑjɑnlArHn	bɑjɑnlerin	bɑjɑnlɑrɯn
bɑjrɑklH	bɑjrɑkli	bɑjrɑklɯ
bojHHn	bojiin	bojuun
bozuklHklArHn	bozukliklerin	bozukluklɑrɯn
bulunmADAn	bulunmɑdɑn	bulunmɑtɑn
bulutlArH	bulutleri	bulutlɑrɯ
ʤevizlH	ʤevizlɯ	ʤevizli
dyzenlAnmADA	dyzenlɑnmɑdɑ	dyzenlenmete
etmADHklArH	etmetikleri	etmedikleri
formɑtA	formɑte	formɑtɑ
gøryʃHp	gøryʃip	gøryʃyp
hɑvuzlH	hɑvuzlɯ	hɑvuzlu
ilgilenmAA	ilgilenmɑɑ	ilgilenmee
inʃɑɑtlArH	inʃɑɑtleri	inʃɑɑtlɑrɯ
inɑnʧlArH	inɑnʧleri	inɑnʧlɑrɯ
izlAnArAk	izlɑnɑrɑk	izlenerek
komisjonlArHHn	komisjonleriin	komisjonlɑrɯɯn
koordinɑtlAr	koordinɑtler	koordinɑtlɑr
kulɑkDAki	kulɑkteki	kulɑktɑki
myʃɑvirlAr	myʃɑvirlɑr	myʃɑvirler
oʤɑklAr	oʤɑkler	oʤɑklɑr
okuDHklArH	okudikleri	okuduklɑrɯ
okullAʃmA	okulleʃmɑ	okullɑʃmɑ
olmAlArHHn	olmeleriin	olmɑlɑrɯɯn
plɑtformlArH	plɑtformleri	plɑtformlɑrɯ
resulH	resulu	resuly
tɑʃɯHʤHH	tɑʃɯiʤii	tɑʃɯɯʤɯɯ
tɑnɯmlAmHʃ	tɑnɯmlemiʃ	tɑnɯmlɑmɯʃ
tɑnɯmlAmADA	tɑnɯmlemede	tɑnɯmlɑmɑtɑ
tɑvlH	tɑvli	tɑvlɯ
tuzlHlHk	tuzlilik	tuzluluk
jɑɰmurHn	jɑɰmurin	jɑɰmurun
ʧɑmurlH	ʧɑmurli	ʧɑmurlu
ʧɑtɯʃmAlArHn	ʧɑtɯʃmelerin	ʧɑtɯʃmɑlɑrɯn
ʧimlAnmA	ʧimlɑnmɑ	ʧimlenme
ɯsɯHHn	ɯsɯiin	ɯsɯɯɯn
ølymHHn	ølymiin	ølymyyn
ʃehirlAʃmA	ʃehirlɑʃmɑ	ʃehirleʃme
ʃikɑjetDA	ʃikɑjettɑ	ʃikɑjette
ɑʒɑnlArHn	ɑʒɑnlerin	ɑʒɑnlɑrɯn
ɑlɯʤɯlArHn	ɑlɯʤɯlerin	ɑlɯʤɯlɑrɯn
ɑlejhDA	ɑlejhde	ɑlejhte
ɑrɑʤɯnHzH	ɑrɑʤɯnizi	ɑrɑʤɯnɯzɯ
ɑrɑnHzDA	ɑrɑnɯzde	ɑrɑnɯzdɑ
ɑsɯlsHz	ɑsɯlsiz	ɑsɯlsɯz
bɑɰlɑntɯlArHn	bɑɰlɑntɯlerin	bɑɰlɑntɯlɑrɯn
bɑʃmH	bɑʃmi	bɑʃmɯ
bilmA	bilmɑ	bilme
bollHk	bollik	bolluk
bojutlArHHn	bojutleriin	bojutlɑrɯɯn
ʤilɑlH	ʤilɑli	ʤilɑlɯ
dɑvrɑnɯʃsAl	dɑvrɑnɯʃsel	dɑvrɑnɯʃsɑl
dersnDAn	dersndɑn	dersnden
dokymɑnlArHn	dokymɑnlerin	dokymɑnlɑrɯn
doktorlArH	doktorleri	doktorlɑrɯ
formDAki	formteki	formdɑki
gørAbiljor	gørɑbiljor	gørebiljor
gynlAnmAH	gynlɑnmɑɯ	gynlenmei
gytmAAn	gytmɑɑn	gytmeen
gyzellHkDA	gyzelliktɑ	gyzellikte
geliʃimA	geliʃimɑ	geliʃime
girmAnHzH	girmɑnizi	girmenizi
hɑtlH	hɑtli	hɑtlɯ
hɑjɑtnHz	hɑjɑtniz	hɑjɑtnɯz
hususA	hususe	hususɑ
iktidɑrDA	iktidɑrde	iktidɑrdɑ
kɯjAsHjA	kɯjɑsije	kɯjɑsɯjɑ
kykyrtlH	kykyrtli	kykyrtly
kodHn	kodin	kodun
konsɑntrɑsjonlArH	konsɑntrɑsjonleri	konsɑntrɑsjonlɑrɯ
lyzumsHz	lyzumsiz	lyzumsuz
listelAnmAH	listelenmɑɯ	listelenmei
mevsimA	mevsimɑ	mevsime
motorlArDA	motorlɑrde	motorlɑrdɑ
normlArA	normlere	normlɑrɑ
okʧH	okʧi	okʧu
syzylAn	syzylɑn	syzylen
sɑɰlɑmAlArH	sɑɰlɑmeleri	sɑɰlɑmɑlɑrɯ
tɑkɯmmHzHn	tɑkɯmmizin	tɑkɯmmɯzɯn
tedirginlHk	tedirginlɯk	tedirginlik
tezgɑhH	tezgɑhi	tezgɑhɯ
tezgɑhlArH	tezgɑhleri	tezgɑhlɑrɯ
uzɑklAʃmA	uzɑkleʃmɑ	uzɑklɑʃmɑ
jyksekokullAr	jyksekokuller	jyksekokullɑr
jɑjɯnlArDAn	jɑjɯnlɑrden	jɑjɯnlɑrdɑn
joɰunlHkDA	joɰunlɯktɑ	joɰunluktɑ
ɯsɯtHʤH	ɯsɯtiʤi	ɯsɯtɯʤɯ
øɰrenimmH	øɰrenimmu	øɰrenimmi
øɰretmenlArmHz	øɰretmenlɑrmiz	øɰretmenlermiz
ølDHkDAn	øltiktɑn	øldykten
øzgyrlHklArA	øzgyrliklere	øzgyrlyklere
ɑnlɑʃmɑzlɯklArHn	ɑnlɑʃmɑzlɯklerin	ɑnlɑʃmɑzlɯklɑrɯn
ɑrɑmHzDAki	ɑrɑmizdeki	ɑrɑmɯzdɑki
ɑrkɑdɑʃlArmH	ɑrkɑdɑʃlermi	ɑrkɑdɑʃlɑrmɯ
ɑsmA	ɑsme	ɑsmɑ
bɯrɑkDHklArH	bɯrɑktikleri	bɯrɑktɯklɑrɯ
bɑɰlɑntɯlArHHn	bɑɰlɑntɯleriin	bɑɰlɑntɯlɑrɯɯn
bɑʃørtylH	bɑʃørtyli	bɑʃørtyly
bɑntlH	bɑntli	bɑntlɯ
bɑntlAr	bɑntler	bɑntlɑr
binɑDAn	binɑtɑn	binɑdɑn
binAn	binɑn	binen
bozmA	bozme	bozmɑ
ʤɑnlɯlArDA	ʤɑnlɯlɑrde	ʤɑnlɯlɑrdɑ
dyʃHʃH	dyʃiʃi	dyʃyʃy
dɑnɯʃmɑnlArHn	dɑnɯʃmɑnlerin	dɑnɯʃmɑnlɑrɯn
deɰerlendirmAlArDA	deɰerlendirmɑlɑrde	deɰerlendirmelerde
devirlAr	devirlɑr	devirler
devletlArɑrɑsɯ	devletlɑrɑrɑsɯ	devletlerɑrɑsɯ
disiplinlAr	disiplinlɑr	disiplinler
doɰuDAki	doɰuteki	doɰudɑki
eɰitimDAki	eɰitimdɑki	eɰitimdeki
erimA	erimɑ	erime
evrenDA	evrendɑ	evrende
firmɑnHz	firmɑniz	firmɑnɯz
fotoɰrɑfʧHHn	fotoɰrɑfʧiin	fotoɰrɑfʧɯɯn
gønyllylHk	gønyllylɯk	gønyllylyk
gøndermAH	gøndermɑɯ	gøndermei
gynejDAki	gynejdɑki	gynejdeki
hɑvɑHHn	hɑvɑiin	hɑvɑɯɯn
hɑvuzlAr	hɑvuzler	hɑvuzlɑr
hɑzɯrDA	hɑzɯrde	hɑzɯrdɑ
hormonlArHn	hormonlerin	hormonlɑrɯn
iʃgyʤyHn	iʃgyʤyin	iʃgyʤyyn
kɯsɯmlArA	kɯsɯmlere	kɯsɯmlɑrɑ
køjDAki	køjdɑki	køjdeki
kɑdroDA	kɑdrode	kɑdrodɑ
kɑlkHnʤA	kɑlkinʤe	kɑlkɯnʤɑ
kɑnɑmAlArH	kɑnɑmeleri	kɑnɑmɑlɑrɯ
kɑrɑrlArDAn	kɑrɑrlɑrden	kɑrɑrlɑrdɑn
kɑsɑbɑlArDA	kɑsɑbɑlɑrde	kɑsɑbɑlɑrdɑ
kɑtmɑnlArH	kɑtmɑnleri	kɑtmɑnlɑrɯ
kesirlAr	kesirlɑr	kesirler
kokusHz	kokusiz	kokusuz
kurmADA	kurmɑdɑ	kurmɑtɑ
lezjonlArDA	lezjonlɑrde	lezjonlɑrdɑ
milletDAn	millettɑn	milletten
muhtɑrlHk	muhtɑrlik	muhtɑrlɯk
orgɑnlArDA	orgɑnlɑrde	orgɑnlɑrdɑ
ortɑklArA	ortɑklere	ortɑklɑrɑ
pejgɑmberlAr	pejgɑmberlɑr	pejgɑmberler
plɑtformlAr	plɑtformler	plɑtformlɑr
protokolA	protokolɑ	protokole
sɑldɯrɯlArHn	sɑldɯrɯlerin	sɑldɯrɯlɑrɯn
sɑpmAlAr	sɑpmeler	sɑpmɑlɑr
selɑmlAr	selɑmler	selɑmlɑr
siDA	site	side
sorumsHz	sorumsiz	sorumsuz
stoklAr	stokler	stoklɑr
suʧlArDA	suʧlɑrde	suʧlɑrdɑ
tɯklAmA	tɯkleme	tɯklɑmɑ
typlArH	typlɑrɯ	typleri
tɑkHn	tɑkin	tɑkɯn
tɑvɯrlArH	tɑvɯrleri	tɑvɯrlɑrɯ
teʃekkylH	teʃekkyli	teʃekkyly
titizlHk	titizlɯk	titizlik
tutDHklArH	tutdikleri	tuttuklɑrɯ
uzɑtArAk	uzɑterek	uzɑtɑrɑk
uzmɑnlArDAn	uzmɑnlɑrden	uzmɑnlɑrdɑn
jønlArA	jønlɑrɑ	jønlere
jyryHʃlAr	jyryiʃler	jyryyʃler
jɑkɯtlAr	jɑkɯtler	jɑkɯtlɑr
jɑzɯmHzDA	jɑzɯmɯzde	jɑzɯmɯzdɑ
jenilAAn	jenilɑɑn	jenileen
jetiʃkinlArDA	jetiʃkinlɑrde	jetiʃkinlerde
jetiʃkinlArA	jetiʃkinlɑrɑ	jetiʃkinlere
zɑmɑnlArHHn	zɑmɑnleriin	zɑmɑnlɑrɯɯn
zɑrɑrlArHn	zɑrɑrlerin	zɑrɑrlɑrɯn
zɑrfH	zɑrfi	zɑrfɯ
ʧɑlHp	ʧɑlip	ʧɑlɯp
ʧekinmADAn	ʧekinmɑdɑn	ʧekinmeden
ønnHzA	ønnize	ønnyze
ʃoførH	ʃoføri	ʃoføry
ystynlHklArH	ystynlikleri	ystynlykleri
ɑmɑʧlArHn	ɑmɑʧlerin	ɑmɑʧlɑrɯn
ɑrɑbuluʤulHk	ɑrɑbuluʤulɯk	ɑrɑbuluʤuluk
bytynlAʃmAH	bytynlɑʃmɑɯ	bytynleʃmei
bɑʃlAAlHm	bɑʃlɑɑlim	bɑʃlɑɑlɯm
bɑhɑrDA	bɑhɑrde	bɑhɑrdɑ
bɑkɑnlɯklArH	bɑkɑnlɯkleri	bɑkɑnlɯklɑrɯ
bɑsɑmɑklArH	bɑsɑmɑkleri	bɑsɑmɑklɑrɯ
biʧimA	biʧimɑ	biʧime
binmA	binmɑ	binme
boɰɑzlAr	boɰɑzler	boɰɑzlɑr
bulunmADHkʧA	bulunmɑtɯkʧɑ	bulunmɑdɯkʧɑ
ʤihɑzDA	ʤihɑzde	ʤihɑzdɑ
dyʃynmAH	dyʃynmɑɯ	dyʃynmei
dyzensHzlHk	dyzensɯzlɯk	dyzensizlik
delmA	delmɑ	delme
depoA	depoe	depoɑ
dolgunlHk	dolgunlɯk	dolgunluk
eʃmA	eʃmɑ	eʃme
elnHzDAn	elnizdɑn	elnizden
etkenlArA	etkenlɑrɑ	etkenlere
etmADHk	etmetik	etmedik
gølHHn	gøliin	gølyyn
gøzlemlAnAn	gøzlemlɑnɑn	gøzlemlenen
gylH	gyli	gyly
iʧDA	iʧtɑ	iʧte
imkɑnlArDAn	imkɑnlɑrden	imkɑnlɑrdɑn
ithɑlɑtA	ithɑlɑte	ithɑlɑtɑ
kɯsɯrlHk	kɯsɯrlik	kɯsɯrlɯk
kɯjɯlArDA	kɯjɯlɑrde	kɯjɯlɑrdɑ
kyltyrmHzHn	kyltyrmizin	kyltyrmyzyn
kɑmplArDA	kɑmplɑrde	kɑmplɑrdɑ
kɑrikɑtyrlAr	kɑrikɑtyrlɑr	kɑrikɑtyrler
kɑrtnHzA	kɑrtnize	kɑrtnɯzɑ
konuʃmɑʤɯlArHn	konuʃmɑʤɯlerin	konuʃmɑʤɯlɑrɯn
kulɑklArH	kulɑkleri	kulɑklɑrɯ
mɑhɑllinA	mɑhɑllinɑ	mɑhɑlline
mɑkɑmlArHn	mɑkɑmlerin	mɑkɑmlɑrɯn
mɑksɑtlH	mɑksɑtli	mɑksɑtlɯ
monitørlAr	monitørlɑr	monitørler
olmAHnʤA	olmɑɯnʤe	olmɑɯnʤɑ
olumsuzlHk	olumsuzlɯk	olumsuzluk
pɑdiʃɑhH	pɑdiʃɑhi	pɑdiʃɑhɯ
sɯnɑvlArDAn	sɯnɑvlerden	sɯnɑvlɑrdɑn
sɑtɯrlArHn	sɑtɯrlerin	sɑtɯrlɑrɯn
suʧlHlAr	suʧliler	suʧlulɑr
tørenlAr	tørenlɑr	tørenler
tɑbɑkɑlH	tɑbɑkɑli	tɑbɑkɑlɯ
tɑrtɯʃmAlArDA	tɑrtɯʃmɑlɑrde	tɑrtɯʃmɑlɑrdɑ
temɑslArDA	temɑslerde	temɑslɑrdɑ
uʧmA	uʧme	uʧmɑ
umutsHzlHk	umutsizlɯk	umutsuzluk
uzɑklArDA	uzɑklerde	uzɑklɑrdɑ
uzunluklArH	uzunlukleri	uzunluklɑrɯ
vermADA	vermɑdɑ	vermede
vurHʃ	vuriʃ	vuruʃ
jønelmAH	jønelmɑɯ	jønelmei
jɑnmHzA	jɑnmize	jɑnmɯzɑ
jɑtmA	jɑtme	jɑtmɑ
ʧøzymHHn	ʧøzymiin	ʧøzymyyn
ʧoɰumHzHn	ʧoɰumizin	ʧoɰumuzun
ʧoʤuklArnHzA	ʧoʤuklernize	ʧoʤuklɑrnɯzɑ
ønDAki	ønteki	øndeki
yjelArmHzDAn	yjelermizdɑn	yjelermizden
ɑnɯtlAr	ɑnɯtler	ɑnɯtlɑr
ɑtomlAr	ɑtomler	ɑtomlɑr
bɯrɑkDHkDAn	bɯrɑktiktɑn	bɯrɑktɯktɑn
bɑjrɑmlArDA	bɑjrɑmlerde	bɑjrɑmlɑrdɑ
belgelAnmAH	belgelenmɑɯ	belgelenmei
bulutlArHn	bulutlerin	bulutlɑrɯn
dɯʃsAl	dɯʃsel	dɯʃsɑl
deɰerlArDA	deɰerlɑrde	deɰerlerde
devletʧH	devletʧɯ	devletʧi
dinDAn	dindɑn	dinden
dostlArHHn	dostleriin	dostlɑrɯɯn
dojumsHz	dojumsiz	dojumsuz
enfeksijonlArDA	enfeksijonlɑrde	enfeksijonlɑrdɑ
evmA	evmɑ	evme
fijɑtlArmHzA	fijɑtlermize	fijɑtlɑrmɯzɑ
fijɑtlArDA	fijɑtlerde	fijɑtlɑrdɑ
gynlArDAki	gynlɑrdeki	gynlerdeki
geʧirDHkDAn	geʧirdiktɑn	geʧirdikten
gelmAH	gelmɑɯ	gelmei
grevA	grevɑ	greve
ilɑʧlArDAn	ilɑʧlɑrden	ilɑʧlɑrdɑn
iplArH	iplɑrɯ	ipleri
ijiDAn	ijiten	ijiden
kɯsɯmDAki	kɯsɯmteki	kɯsɯmdɑki
kɑʧArAk	kɑʧerek	kɑʧɑrɑk
kɑnɑllArA	kɑnɑllere	kɑnɑllɑrɑ
kɑtɑlogH	kɑtɑlogi	kɑtɑlogu
kɑvrɑmlArA	kɑvrɑmlere	kɑvrɑmlɑrɑ
kirlAnmAHn	kirlɑnmɑɯn	kirlenmein
komutɑnlArH	komutɑnleri	komutɑnlɑrɯ
konAʤAk	koneʤek	konɑʤɑk
konuDAn	konutɑn	konudɑn
kullɑnmAlArnH	kullɑnmelerni	kullɑnmɑlɑrnɯ
kumɑʃlArHn	kumɑʃlerin	kumɑʃlɑrɯn
kursijerlAr	kursijerlɑr	kursijerler
lɑborɑtuvɑrlArHn	lɑborɑtuvɑrlerin	lɑborɑtuvɑrlɑrɯn
mɑɰɑzɑlArDA	mɑɰɑzɑlɑrde	mɑɰɑzɑlɑrdɑ
mɑɰdurHn	mɑɰdurin	mɑɰdurun
miktɑrDAn	miktɑrden	miktɑrdɑn
mirɑsʧHlArH	mirɑsʧileri	mirɑsʧɯlɑrɯ
normlAr	normler	normlɑr
omuzA	omuze	omuzɑ
pɑrɑnHz	pɑrɑniz	pɑrɑnɯz
pistH	pisty	pisti
rɑkɑmsAl	rɑkɑmsel	rɑkɑmsɑl
rektørlHkʧA	rektørlɯkʧɑ	rektørlykʧe
robotlAr	robotler	robotlɑr
sɯnɯrlArA	sɯnɯrlere	sɯnɯrlɑrɑ
sɯnɑvsHz	sɯnɑvsiz	sɯnɑvsɯz
søkmA	søkmɑ	søkme
sɑnɑtlArHHn	sɑnɑtleriin	sɑnɑtlɑrɯɯn
sɑjfɑlArmHzDA	sɑjfɑlɑrmizde	sɑjfɑlɑrmɯzdɑ
seklHnDAki	seklinteki	seklindeki
sektørmHzHn	sektørmizin	sektørmyzyn
seminerlArDA	seminerlɑrde	seminerlerde
sevmAH	sevmɑɯ	sevmei
stokH	stoki	stoku
tytynlArDAn	tytynlɑrden	tytynlerden
telefonlArDAn	telefonlɑrden	telefonlɑrdɑn
topluluklArHHn	toplulukleriin	topluluklɑrɯɯn
triljonlHk	triljonlɯk	triljonluk
tutuklulHk	tutuklulɯk	tutukluluk
uɰurDA	uɰurde	uɰurdɑ
unsurHn	unsurin	unsurun
usulDA	usultɑ	usulde
ujgɑrlHklArHn	ujgɑrliklerin	ujgɑrlɯklɑrɯn
uzɑjlArH	uzɑjleri	uzɑjlɑrɯ
jɯɰmA	jɯɰme	jɯɰmɑ
jykymlHlHklArHn	jykymliliklerin	jykymlylyklerin
jyksekokulDA	jyksekokultɑ	jyksekokuldɑ
jyksekokulmHz	jyksekokulmiz	jyksekokulmuz
jyzejDAki	jyzejdɑki	jyzejdeki
jɑpmAmA	jɑpmeme	jɑpmɑmɑ
jorumlAmA	jorumleme	jorumlɑmɑ
ʧoɰulʤulHk	ʧoɰulʤulɯk	ʧoɰulʤuluk
øɰretmAA	øɰretmɑɑ	øɰretmee
yʧHHn	yʧiin	yʧyyn
ɑhlɑklH	ɑhlɑkli	ɑhlɑklɯ
ɑjdɯnlɑtmA	ɑjdɯnlɑtme	ɑjdɯnlɑtmɑ
belirtmADA	belirtmede	belirtmete
bilmAlH	bilmɑli	bilmeli
birikimA	birikimɑ	birikime
boruHHn	boruiin	boruuun
brɑnʃDA	brɑnʃte	brɑnʃtɑ
dinlAHʤHlArA	dinlɑɯʤilere	dinleiʤilere
enerʒiDAn	enerʒiten	enerʒiden
fɑturɑlArnHzH	fɑturɑlɑrnizi	fɑturɑlɑrnɯzɯ
gørmAmA	gørmɑmɑ	gørmeme
gøstermADAn	gøstermɑdɑn	gøstermeden
genʧlArDAn	genʧlɑrden	genʧlerden
getirmAHn	getirmɑɯn	getirmein
girAnlArA	girɑnlɑrɑ	girenlere
girAnlArHn	girɑnlerin	girenlerin
hɑzɯrlɯklArHn	hɑzɯrlɯklerin	hɑzɯrlɯklɑrɯn
ilDAn	iltɑn	ilden
kɯʃlAr	kɯʃler	kɯʃlɑr
kɯlɑvuzlHk	kɯlɑvuzlɯk	kɯlɑvuzluk
kɑnɯtlArH	kɑnɯtleri	kɑnɯtlɑrɯ
kɑrʃɯnHzDA	kɑrʃɯnɯzde	kɑrʃɯnɯzdɑ
kɑjɑʧlArHn	kɑjɑʧlerin	kɑjɑʧlɑrɯn
kɑjbetmAA	kɑjbetmɑɑ	kɑjbetmee
kendimDAn	kendimdɑn	kendimden
komʃumHz	komʃumiz	komʃumuz
krɑlHn	krɑlin	krɑlɯn
kurAbilmA	kurɑbilmɑ	kurɑbilme
kurslArDA	kurslerde	kurslɑrdɑ
kuruluʃmHz	kuruluʃmiz	kuruluʃmuz
kuzejDAki	kuzejdɑki	kuzejdeki
metinDAn	metindɑn	metinden
metrɑʒlH	metrɑʒli	metrɑʒlɯ
mimɑrlArH	mimɑrleri	mimɑrlɑrɯ
odɑklArH	odɑkleri	odɑklɑrɯ
otojolH	otojoli	otojolu
oturumlAr	oturumler	oturumlɑr
ojunlArHHn	ojunleriin	ojunlɑrɯɯn
plɑtformHn	plɑtformin	plɑtformun
resimDAn	resimdɑn	resimden
søkHp	søkup	søkyp
sɑntrɑlHn	sɑntrɑlin	sɑntrɑlɯn
sɑtHʃHn	sɑtiʃin	sɑtɯʃɯn
sɑtHʃHHn	sɑtiʃiin	sɑtɯʃɯɯn
sɑvɑʃlArA	sɑvɑʃlere	sɑvɑʃlɑrɑ
seʧDHkDAn	seʧdiktɑn	seʧtikten
stɑndɑrdlArH	stɑndɑrdleri	stɑndɑrdlɑrɯ
tɑʃɯtlAr	tɑʃɯtler	tɑʃɯtlɑr
tɑhɑmmylH	tɑhɑmmyli	tɑhɑmmyly
tozlAr	tozler	tozlɑr
jorgunlHkDAn	jorgunlɯktɑn	jorgunluktɑn
zɑmɑnlArDAn	zɑmɑnlɑrden	zɑmɑnlɑrdɑn
ølHnʤA	ølinʤe	ølynʤe
øzyrlylHk	øzyrlylɯk	øzyrlylyk
yretimDAki	yretimdɑki	yretimdeki
ɑʃɯlArHn	ɑʃɯlerin	ɑʃɯlɑrɯn
ɑmelijɑtlAr	ɑmelijɑtler	ɑmelijɑtlɑr
ɑnlɑjɯʃmHz	ɑnlɑjɯʃmiz	ɑnlɑjɯʃmɯz
ɑnlɑHp	ɑnlɑip	ɑnlɑɯp
ɑrɑplArHn	ɑrɑplerin	ɑrɑplɑrɯn
ɑsɯllArH	ɑsɯlleri	ɑsɯllɑrɯ
ɑjgɯtlAr	ɑjgɯtler	ɑjgɯtlɑr
byltenDA	byltendɑ	byltende
bɑkɑnlArHn	bɑkɑnlerin	bɑkɑnlɑrɯn
bɑjɑnlArDA	bɑjɑnlɑrde	bɑjɑnlɑrdɑ
bildirmAA	bildirmɑɑ	bildirmee
bozuklHklArHHn	bozuklikleriin	bozukluklɑrɯɯn
brɑnʃlArDA	brɑnʃlerde	brɑnʃlɑrdɑ
bulunmAmADA	bulunmɑmɑdɑ	bulunmɑmɑtɑ
dønyʃymHn	dønyʃymin	dønyʃymyn
dørtlH	dørtli	dørtly
demokrɑsiDAn	demokrɑsiten	demokrɑsiden
dikmA	dikmɑ	dikme
duvɑrlArDA	duvɑrlɑrde	duvɑrlɑrdɑ
erlAr	erlɑr	erler
etkiDA	etkite	etkide
etkilAmADA	etkilemede	etkilemete
formlArA	formlere	formlɑrɑ
formlArDA	formlerde	formlɑrdɑ
futbolH	futboli	futbolu
gøkDA	gøktɑ	gøkte
gørevsHzlHk	gørevsizlɯk	gørevsizlik
gøtyrmAA	gøtyrmɑɑ	gøtyrmee
gylmAA	gylmɑɑ	gylmee
gyzergɑhH	gyzergɑhi	gyzergɑhɯ
geliʃmADA	geliʃmɑdɑ	geliʃmede
gezmAA	gezmɑɑ	gezmee
globɑllAʃAn	globɑllɑʃɑn	globɑlleʃen
hɑberleʃmAHn	hɑberleʃmɑɯn	hɑberleʃmein
hɑlkɑlH	hɑlkɑli	hɑlkɑlɯ
hɑstɑlɯksHz	hɑstɑlɯksiz	hɑstɑlɯksɯz
hɑzɯrlɯksHz	hɑzɯrlɯksiz	hɑzɯrlɯksɯz
husulA	husulɑ	husule
ikɑmetgɑhH	ikɑmetgɑhi	ikɑmetgɑhɯ
iklimA	iklimɑ	iklime
kɯlɑvuzlArH	kɯlɑvuzleri	kɯlɑvuzlɑrɯ
køʃeDAki	køʃeteki	køʃedeki
kɑlHʃ	kɑliʃ	kɑlɯʃ
kɑmpʧHlHk	kɑmpʧilik	kɑmpʧɯlɯk
kesinlAʃmAH	kesinlɑʃmɑɯ	kesinleʃmei
koʃullArDAn	koʃullerden	koʃullɑrdɑn
koktejlH	koktejlɯ	koktejli
kopHp	kopip	kopup
koruAbilmA	koruɑbilmɑ	koruɑbilme
kurullArA	kurullere	kurullɑrɑ
lisɑnsA	lisɑnse	lisɑnsɑ
mɑɑʃlArH	mɑɑʃleri	mɑɑʃlɑrɯ
meslektɑʃlArm	meslektɑʃlerm	meslektɑʃlɑrm
noterlAr	noterlɑr	noterler
okullArmHzHn	okullermizin	okullɑrmɯzɯn
orgɑnizɑsjonlArDA	orgɑnizɑsjonlɑrde	orgɑnizɑsjonlɑrdɑ
ojlArDA	ojlerde	ojlɑrdɑ
pɑrʧɑlArDAn	pɑrʧɑlɑrden	pɑrʧɑlɑrdɑn
penʤereDAki	penʤereteki	penʤeredeki
puɑnlArHHn	puɑnleriin	puɑnlɑrɯɯn
reɑksijonlArHn	reɑksijonlerin	reɑksijonlɑrɯn
søjlemADAn	søjlemeden	søjlemeten
sɑnɯklArDAn	sɑnɯklerden	sɑnɯklɑrdɑn
seferlAr	seferlɑr	seferler
serbestlAʃmA	serbestleʃmɑ	serbestleʃme
sorumlulHklArHHn	sorumlulikleriin	sorumluluklɑrɯɯn
tørenlArDA	tørenlɑrde	tørenlerde
tyfA	tyfɑ	tyfe
tɑʃlH	tɑʃli	tɑʃlɯ
tɑrɑfnHzDAn	tɑrɑfnizdɑn	tɑrɑfnɯzdɑn
telefonnHzDAn	telefonnizdɑn	telefonnuzdɑn
tiplArDA	tiplɑrde	tiplerde
tonlArH	tonleri	tonlɑrɯ
toplɑDHklArH	toplɑtɯkleri	toplɑdɯklɑrɯ
tozlArH	tozleri	tozlɑrɯ
uʧmA	uʧme	uʧmɑ
ujgulɑmɑDAki	ujgulɑmɑteki	ujgulɑmɑdɑki
jɑʃɑmmHzDA	jɑʃɑmmizde	jɑʃɑmmɯzdɑ
jɑkɑlɑHp	jɑkɑlɑip	jɑkɑlɑɯp
jɑtɯrɯmlArDAn	jɑtɯrɯmlerden	jɑtɯrɯmlɑrdɑn
jɑtɑklArHn	jɑtɑklerin	jɑtɑklɑrɯn
jerleʃimA	jerleʃimɑ	jerleʃime
zɑrɑrlArHHn	zɑrɑrleriin	zɑrɑrlɑrɯɯn
zorlHklArHn	zorliklerin	zorluklɑrɯn
ʧøkHʃH	ʧøkiʃi	ʧøkyʃy
ʧyrymAA	ʧyrymɑɑ	ʧyrymee
ʧɑlɯʃɑnlArmHzA	ʧɑlɯʃɑnlɑrmize	ʧɑlɯʃɑnlɑrmɯzɑ
ʧiʧeklAnmA	ʧiʧeklɑnmɑ	ʧiʧeklenme
ʧoʤuklArDAki	ʧoʤuklerdeki	ʧoʤuklɑrdɑki
ønHHn	øniin	ønyyn
øzgyrlHkʧH	øzgyrlɯkʧi	øzgyrlykʧy
ʃejDA	ʃejdɑ	ʃejde
ɑʧɯklArHHn	ɑʧɯkleriin	ɑʧɯklɑrɯɯn
ɑɰɑʧlArHHn	ɑɰɑʧleriin	ɑɰɑʧlɑrɯɯn
ɑksɑklHklArn	ɑksɑkliklern	ɑksɑklɯklɑrn
ɑmbɑlɑʒlAr	ɑmbɑlɑʒler	ɑmbɑlɑʒlɑr
ɑntenlAr	ɑntenlɑr	ɑntenler
ɑtɯlɯmlAr	ɑtɯlɯmler	ɑtɯlɯmlɑr
bɑjrɑklArH	bɑjrɑkleri	bɑjrɑklɑrɯ
bilgisɑjɑrDAki	bilgisɑjɑrdeki	bilgisɑjɑrdɑki
bozuklHklArA	bozukliklere	bozukluklɑrɑ
broʃyrH	broʃyri	broʃyry
bulutlH	bulutli	bulutlu
ʤɑmlH	ʤɑmli	ʤɑmlɯ
døkymHn	døkymin	døkymyn
dɑvrɑnHʃlArDAn	dɑvrɑniʃlerden	dɑvrɑnɯʃlɑrdɑn
dernekDA	dernektɑ	dernekte
doɰmAH	doɰmei	doɰmɑɯ
dostlArmHz	dostlermiz	dostlɑrmɯz
ebɑtlArDA	ebɑtlerde	ebɑtlɑrdɑ
edinDHklArH	edintikleri	edindikleri
ekimDA	ekimdɑ	ekimde
ekrɑnlH	ekrɑnli	ekrɑnlɯ
eriʃmA	eriʃmɑ	eriʃme
erimAH	erimɑɯ	erimei
finɑlA	finɑlɑ	finɑle
fonlArHHn	fonleriin	fonlɑrɯɯn
fotoɰrɑfHHn	fotoɰrɑfiin	fotoɰrɑfɯɯn
frenlAr	frenlɑr	frenler
geʧmADHkʧA	geʧmetikʧɑ	geʧmedikʧe
gelAbilmAH	gelebilmɑɯ	gelebilmei
geriDAn	geriten	geriden
girmADAn	girmɑdɑn	girmeten
gitDHkDAn	gitdiktɑn	gittikten
hɑberleʃmAA	hɑberleʃmɑɑ	hɑberleʃmee
hɑsɑrlArH	hɑsɑrleri	hɑsɑrlɑrɯ
iʃlAnArAk	iʃlɑnɑrɑk	iʃlenerek
iʃlevA	iʃlevɑ	iʃleve
kɯrɯklArDA	kɯrɯklerde	kɯrɯklɑrdɑ
kɑdɯnlArHHn	kɑdɯnleriin	kɑdɯnlɑrɯɯn
kɑdɑrlHk	kɑdɑrlik	kɑdɑrlɯk
kɑrɑkolDA	kɑrɑkolde	kɑrɑkoldɑ
kɑjɑʧlArDA	kɑjɑʧlɑrde	kɑjɑʧlɑrdɑ
kesmAA	kesmɑɑ	kesmee
komisjonlArDA	komisjonlɑrde	komisjonlɑrdɑ
komutlArHn	komutlerin	komutlɑrɯn
konuʃmAlArDAn	konuʃmɑlɑrden	konuʃmɑlɑrdɑn
konuklArH	konukleri	konuklɑrɯ
mɑllArDA	mɑllerde	mɑllɑrdɑ
mɑsrɑflArHHn	mɑsrɑfleriin	mɑsrɑflɑrɯɯn
mɑtemɑtikDA	mɑtemɑtiktɑ	mɑtemɑtikte
mesɑʒlArA	mesɑʒlere	mesɑʒlɑrɑ
olɑnɑklArHn	olɑnɑklerin	olɑnɑklɑrɯn
olDHklArHHn	oldikleriin	olduklɑrɯɯn
olmAmHzA	olmemize	olmɑmɯzɑ
oluʃumlArHn	oluʃumlerin	oluʃumlɑrɯn
pɑrɑgrɑfH	pɑrɑgrɑfi	pɑrɑgrɑfɯ
pilɑvH	pilɑvi	pilɑvɯ
plɑnDAki	plɑnteki	plɑndɑki
profesørlHk	profesørlik	profesørlyk
protokolHHn	protokoliin	protokolyyn
rɑdjoDA	rɑdjode	rɑdjodɑ
rɑkɑmlArHHn	rɑkɑmleriin	rɑkɑmlɑrɯɯn
syreʧDAn	syreʧtɑn	syreʧten
sɑhɑDAki	sɑhɑteki	sɑhɑdɑki
sejɑhɑtH	sejɑhɑtɯ	sejɑhɑti
solH	soli	solu
sorHnʤA	sorinʤe	sorunʤɑ
sorunlArmHzH	sorunlɑrmizi	sorunlɑrmɯzɯ
suʧlHlArHn	suʧlilerin	suʧlulɑrɯn
tɑsɑrruflAr	tɑsɑrrufler	tɑsɑrruflɑr
teʃekkyllH	teʃekkylli	teʃekkylly
tebliɰDA	tebliɰdɑ	tebliɰde
tutɑrlArHn	tutɑrlerin	tutɑrlɑrɯn
tutmADA	tutmede	tutmɑtɑ
unutmA	unutme	unutmɑ
jɯllArHHn	jɯlleriin	jɯllɑrɯɯn
jønelmA	jønelmɑ	jønelme
jyklAnmA	jyklɑnmɑ	jyklenme
jɑʃɑmmHzA	jɑʃɑmmize	jɑʃɑmmɯzɑ
jɑngɯnlArH	jɑngɯnleri	jɑngɯnlɑrɯ
jetinmAHp	jetinmɑɯp	jetinmeip
jolluksHz	jolluksiz	jolluksuz
zɑrfHn	zɑrfin	zɑrfɯn
ʧɯkmAlArH	ʧɯkmeleri	ʧɯkmɑlɑrɯ
ʧoklHk	ʧoklɯk	ʧokluk
ʧubuklH	ʧubukli	ʧubuklu
ørgytlAnmAlArH	ørgytlɑnmeleri	ørgytlenmeleri
ʃokH	ʃoki	ʃoku
ʃuurlH	ʃuurli	ʃuurlu
ɑɰlArDA	ɑɰlɑrde	ɑɰlɑrdɑ
ɑrkɑdɑʃlArnHzA	ɑrkɑdɑʃlernize	ɑrkɑdɑʃlɑrnɯzɑ
ɑrtɯklAr	ɑrtɯkler	ɑrtɯklɑr
ɑrterlAr	ɑrterlɑr	ɑrterler
ɑtɑlArmHz	ɑtɑlɑrmiz	ɑtɑlɑrmɯz
bɑʃvurunHzH	bɑʃvurunizi	bɑʃvurunuzu
bɑnkɑmHzA	bɑnkɑmize	bɑnkɑmɯzɑ
bɑnjoDA	bɑnjode	bɑnjodɑ
bɑrɑʒlArHn	bɑrɑʒlerin	bɑrɑʒlɑrɯn
bilgilAnmA	bilgilɑnmɑ	bilgilenme
birimDAn	birimdɑn	birimden
bulmAnHz	bulmɑniz	bulmɑnɯz
ʤɑmlArHn	ʤɑmlerin	ʤɑmlɑrɯn
ʤemɑɑtH	ʤemɑɑtɯ	ʤemɑɑti
dyɰynlArDA	dyɰynlɑrde	dyɰynlerde
dyʃHʃlAr	dyʃiʃler	dyʃyʃler
dɑnslArH	dɑnsleri	dɑnslɑrɯ
deɰiʃmAHn	deɰiʃmɑɯn	deɰiʃmein
demirbɑʃlArHn	demirbɑʃlerin	demirbɑʃlɑrɯn
dernekDAn	dernektɑn	dernekten
dinlenmAA	dinlenmɑɑ	dinlenmee
editørDAn	editørtɑn	editørden
erenlAr	erenlɑr	erenler
fɯkrɑDAki	fɯkrɑteki	fɯkrɑdɑki
frekɑnsDA	frekɑnste	frekɑnstɑ
gelmAHHn	gelmɑɯɯn	gelmeiin
hɑlklArHHn	hɑlkleriin	hɑlklɑrɯɯn
hɑjɑtnHzA	hɑjɑtnize	hɑjɑtnɯzɑ
hɑjɑtlArHHn	hɑjɑtleriin	hɑjɑtlɑrɯɯn
hɑjvɑnlArHHn	hɑjvɑnleriin	hɑjvɑnlɑrɯɯn
hekimDAn	hekimdɑn	hekimden
inʃɑɑtHHn	inʃɑɑtiin	inʃɑɑtɯɯn
kɑdɑstroH	kɑdɑstroi	kɑdɑstrou
kɑjɯtlArDAn	kɑjɯtlerden	kɑjɯtlɑrdɑn
kollArHHn	kolleriin	kollɑrɯɯn
kullɑnmAnHzA	kullɑnmɑnize	kullɑnmɑnɯzɑ
kursDA	kurste	kurstɑ
lehDA	lehde	lehte
lezjonlArHn	lezjonlerin	lezjonlɑrɯn
mɑkbuzlAr	mɑkbuzler	mɑkbuzlɑr
mesɑʒlArnHzH	mesɑʒlernizi	mesɑʒlɑrnɯzɯ
militɑnlArH	militɑnleri	militɑnlɑrɯ
orɑnsAl	orɑnsel	orɑnsɑl
pɑrklArH	pɑrkleri	pɑrklɑrɯ
plɑklAr	plɑkler	plɑklɑr
puɑnlArHn	puɑnlerin	puɑnlɑrɯn
ryzgɑrDAn	ryzgɑrden	ryzgɑrdɑn
rɑflArDA	rɑflerde	rɑflɑrdɑ
sɑnɑtʧHlArA	sɑnɑtʧilere	sɑnɑtʧɯlɑrɑ
sɑnɑtlArHn	sɑnɑtlerin	sɑnɑtlɑrɯn
sɑndɯklArH	sɑndɯkleri	sɑndɯklɑrɯ
sɑtHʃlArHHn	sɑtiʃleriin	sɑtɯʃlɑrɯɯn
sɑtHʃDA	sɑtɯʃte	sɑtɯʃtɑ
sɑtɯʤɯlArHn	sɑtɯʤɯlerin	sɑtɯʤɯlɑrɯn
sɑtɯrDAki	sɑtɯrdeki	sɑtɯrdɑki
sɑjfɑlArDAn	sɑjfɑlɑrden	sɑjfɑlɑrdɑn
sektørlArDAki	sektørlɑrdeki	sektørlerdeki
sigortɑHHn	sigortɑiin	sigortɑɯɯn
sorunlArnHzH	sorunlernizi	sorunlɑrnɯzɯ
stɑndDA	stɑndde	stɑnddɑ
tɯkAlH	tɯkɑli	tɯkɑlɯ
tɑʃɯtlArHn	tɑʃɯtlerin	tɑʃɯtlɑrɯn
tɑkvimA	tɑkvimɑ	tɑkvime
tɑleplArA	tɑleplɑrɑ	tɑleplere
tɑsɑrɯmlArHn	tɑsɑrɯmlerin	tɑsɑrɯmlɑrɯn
tekrɑrDAn	tekrɑrden	tekrɑrdɑn
ujHp	ujip	ujup
vermAnHzH	vermɑnizi	vermenizi
virysHHn	virysiin	virysyyn
jɑnɯtlArHn	jɑnɯtlerin	jɑnɯtlɑrɯn
jɑpmAksHzHn	jɑpmeksizin	jɑpmɑksɯzɯn
jɑrdɯmlArDAn	jɑrdɯmlerden	jɑrdɯmlɑrdɑn
jolmHzA	jolmize	jolmuzɑ
ʧøzynyrlyklH	ʧøzynyrlykli	ʧøzynyrlykly
ʧizimDA	ʧizimdɑ	ʧizimde
ʧoʤuklArm	ʧoʤuklerm	ʧoʤuklɑrm
ʧubuklAr	ʧubukler	ʧubuklɑr
øɰretmenlArDAn	øɰretmenlɑrden	øɰretmenlerden
ønmA	ønmɑ	ønme
ʃɑnsA	ʃɑnse	ʃɑnsɑ
ɑɰɑʧlArDA	ɑɰɑʧlɑrde	ɑɰɑʧlɑrdɑ
ɑʃɯHHn	ɑʃɯiin	ɑʃɯɯɯn
ɑlɑʤɑklArHn	ɑlɑʤɑklerin	ɑlɑʤɑklɑrɯn
ɑrɑDHklArH	ɑrɑtɯkleri	ɑrɑdɯklɑrɯ
ɑvukɑtlArHHn	ɑvukɑtleriin	ɑvukɑtlɑrɯɯn
byroHn	byroin	byroun
bɑɰɯʃDA	bɑɰɯʃte	bɑɰɯʃtɑ
bɑʤɑklAr	bɑʤɑkler	bɑʤɑklɑr
boʃluklArHn	boʃluklerin	boʃluklɑrɯn
ʤevɑplArHn	ʤevɑplerin	ʤevɑplɑrɯn
ʤumhurijetʧH	ʤumhurijetʧɯ	ʤumhurijetʧi
dønmAH	dønmɑɯ	dønmei
dyʃmADAn	dyʃmɑdɑn	dyʃmeden
dɑɰɯtmA	dɑɰɯtme	dɑɰɯtmɑ
dɑlHp	dɑlip	dɑlɯp
detɑjlArA	detɑjlere	detɑjlɑrɑ
dinlenmAH	dinlenmɑɯ	dinlenmei
dujgulArmH	dujgulɑrmi	dujgulɑrmɯ
ekmeklHk	ekmeklɯk	ekmeklik
ekrɑnlArDA	ekrɑnlɑrde	ekrɑnlɑrdɑ
erkekDA	erkektɑ	erkekte
finɑlDA	finɑltɑ	finɑlde
fotoɰrɑfʧHlArH	fotoɰrɑfʧileri	fotoɰrɑfʧɯlɑrɯ
fotoɰrɑfʧHlArHn	fotoɰrɑfʧilerin	fotoɰrɑfʧɯlɑrɯn
fotoɰrɑflArDA	fotoɰrɑflerde	fotoɰrɑflɑrdɑ
gynejH	gynejɯ	gyneji
geʧirmADA	geʧirmɑdɑ	geʧirmete
germA	germɑ	germe
hɑritɑHHn	hɑritɑiin	hɑritɑɯɯn
hɑsɑrlArA	hɑsɑrlere	hɑsɑrlɑrɑ
hoʃA	hoʃe	hoʃɑ
iʃgɑlA	iʃgɑlɑ	iʃgɑle
kɯsɑsH	kɯsɑsi	kɯsɑsɯ
kɑmpHn	kɑmpin	kɑmpɯn
kɑrɯʃɯklHklAr	kɑrɯʃɯklikler	kɑrɯʃɯklɯklɑr
kɑrɑrgɑhH	kɑrɑrgɑhi	kɑrɑrgɑhɯ
kɑrtlArA	kɑrtlere	kɑrtlɑrɑ
kɑtɑloglArH	kɑtɑlogleri	kɑtɑloglɑrɯ
kɑtlArDA	kɑtlerde	kɑtlɑrdɑ
kesilmA	kesilmɑ	kesilme
komutHHn	komutiin	komutuun
kurumlArDAki	kurumlerdeki	kurumlɑrdɑki
kutlAnAn	kutlenen	kutlɑnɑn
mɑsɑlH	mɑsɑli	mɑsɑlɯ
merɑkH	merɑki	merɑkɯ
mesɑʒnHz	mesɑʒniz	mesɑʒnɯz
nezɑretʧH	nezɑretʧɯ	nezɑretʧi
okulmHzA	okulmize	okulmuzɑ
okuHnʤA	okuunʤe	okuunʤɑ
operɑsjonlArDA	operɑsjonlɑrde	operɑsjonlɑrdɑ
ormɑnlArHHn	ormɑnleriin	ormɑnlɑrɯɯn
otobysHn	otobysɯn	otobysyn
pɑrɑgrɑflAr	pɑrɑgrɑfler	pɑrɑgrɑflɑr
pɑrklArHn	pɑrklerin	pɑrklɑrɯn
pɑjlɑʃɯmlH	pɑjlɑʃɯmli	pɑjlɑʃɯmlɯ
pompɑlH	pompɑli	pompɑlɯ
portɑlH	portɑli	portɑlɯ
rɑdjɑsjonA	rɑdjɑsjone	rɑdjɑsjonɑ
ruhsɑtlAr	ruhsɑtler	ruhsɑtlɑr
sɯkɯntɯlArDAn	sɯkɯntɯlɑrden	sɯkɯntɯlɑrdɑn
sɯnɯrDA	sɯnɯrde	sɯnɯrdɑ
sɑkɑtlAr	sɑkɑtler	sɑkɑtlɑr
sɑnɑtkɑrlArHn	sɑnɑtkɑrlerin	sɑnɑtkɑrlɑrɯn
sigortɑlHlArHn	sigortɑlilerin	sigortɑlɯlɑrɯn
sinDA	sindɑ	sinde
sorumluHHn	sorumluiin	sorumluuun
sojɑdnHz	sojɑdniz	sojɑdnɯz
suʧlHlArH	suʧlileri	suʧlulɑrɯ
sunuʤuDA	sunuʤutɑ	sunuʤudɑ
sunuʤuDAn	sunuʤutɑn	sunuʤudɑn
tɑʃɯtlArH	tɑʃɯtleri	tɑʃɯtlɑrɯ
tɑnɯAlHm	tɑnɯelim	tɑnɯɑlɯm
tɑrɑftɑrlArH	tɑrɑftɑrleri	tɑrɑftɑrlɑrɯ
teʃkilɑtmHz	teʃkilɑtmiz	teʃkilɑtmɯz
testDA	testtɑ	testte
toplumlArHHn	toplumleriin	toplumlɑrɯɯn
uɰrɑDHklArH	uɰrɑtɯkleri	uɰrɑdɯklɑrɯ
unsurHHn	unsuriin	unsuruun
vyʤutlArH	vyʤutleri	vyʤutlɑrɯ
vɑkɯflArA	vɑkɯflere	vɑkɯflɑrɑ
vizjonA	vizjone	vizjonɑ
jøntemDAn	jøntemdɑn	jøntemden
jyklAnHʤHnHn	jyklɑnɯʤɯnɯn	jykleniʤinin
jɑzɯlArDAn	jɑzɯlɑrden	jɑzɯlɑrdɑn
jorumlArA	jorumlere	jorumlɑrɑ
zɑmɑnnHzH	zɑmɑnnizi	zɑmɑnnɯzɯ
zɑrflAr	zɑrfler	zɑrflɑr
zɑtHn	zɑtin	zɑtɯn
ʧɯɰlɯklArH	ʧɯɰlɯkleri	ʧɯɰlɯklɑrɯ
ʧøplArH	ʧøplɑrɯ	ʧøpleri
ʧɑɰmHz	ʧɑɰmiz	ʧɑɰmɯz
ʃerhlAr	ʃerhlɑr	ʃerhler
ystlenmA	ystlenmɑ	ystlenme
ɑɰɑʧlArDAn	ɑɰɑʧlɑrden	ɑɰɑʧlɑrdɑn
ɑdlArHn	ɑdlerin	ɑdlɑrɯn
ɑnɑhtɑrlArH	ɑnɑhtɑrleri	ɑnɑhtɑrlɑrɯ
ɑnlɑʃmɑzlɯklAr	ɑnlɑʃmɑzlɯkler	ɑnlɑʃmɑzlɯklɑr
ɑrɑmAlArHn	ɑrɑmelerin	ɑrɑmɑlɑrɯn
ɑrɑmAnHz	ɑrɑmɑniz	ɑrɑmɑnɯz
ɑjrɯlɯklArH	ɑjrɯlɯkleri	ɑjrɯlɯklɑrɯ
belirsizlHklAr	belirsizlɯkler	belirsizlikler
belirtmAH	belirtmɑɯ	belirtmei
bejinDAki	bejinteki	bejindeki
bildirmAnHz	bildirmɑniz	bildirmeniz
birʃejH	birʃejɯ	birʃeji
bojutlArDAki	bojutlerdeki	bojutlɑrdɑki
døngyHn	døngyin	døngyyn
dyzelmAH	dyzelmɑɯ	dyzelmei
dyzejHn	dyzejɯn	dyzejin
deɰinArAk	deɰinɑrɑk	deɰinerek
deDHkDAn	detiktɑn	dedikten
desenlAr	desenlɑr	desenler
doktornHzHn	doktornizin	doktornuzun
eriʃimA	eriʃimɑ	eriʃime
ejlylDA	ejlyltɑ	ejlylde
fɑbrikɑmHzDA	fɑbrikɑmizde	fɑbrikɑmɯzdɑ
fɑktørHn	fɑktørin	fɑktøryn
filozofH	filozofi	filozofu
fosforlH	fosforli	fosforlu
frekɑnslArH	frekɑnsleri	frekɑnslɑrɯ
gørmAmAH	gørmɑmɑɯ	gørmemei
gøzmHn	gøzmin	gøzmyn
geʤikAn	geʤikɑn	geʤiken
gelmAnHz	gelmɑniz	gelmeniz
genlAr	genlɑr	genler
gezegenlAr	gezegenlɑr	gezegenler
gitmADAn	gitmeden	gitmeten
hɑrmɑnlArDA	hɑrmɑnlɑrde	hɑrmɑnlɑrdɑ
hɑjɑtnHzHn	hɑjɑtnizin	hɑjɑtnɯzɯn
hiʧDA	hiʧtɑ	hiʧte
hoʃʧA	hoʃʧe	hoʃʧɑ
istemDA	istemdɑ	istemde
kyltyrmHz	kyltyrmiz	kyltyrmyz
kɑnɑllArDA	kɑnɑllerde	kɑnɑllɑrdɑ
kɑnserlAr	kɑnserlɑr	kɑnserler
kɑnunsHz	kɑnunsɯz	kɑnunsuz
komisjonmHz	komisjonmiz	komisjonmuz
komplikɑsjonlArHn	komplikɑsjonlerin	komplikɑsjonlɑrɯn
komutHn	komutin	komutun
konumsAl	konumsel	konumsɑl
koridorDA	koridortɑ	koridordɑ
kuʃɑklArHn	kuʃɑklerin	kuʃɑklɑrɯn
kutuDA	kututɑ	kutudɑ
lisɑnslAr	lisɑnsler	lisɑnslɑr
mɑkɑmlArDAn	mɑkɑmlerden	mɑkɑmlɑrdɑn
odɑmHzH	odɑmizi	odɑmɯzɯ
ortɑklH	ortɑkli	ortɑklɯ
pyryzlH	pyryzlɯ	pyryzly
pɑrʧɑʤɯklArH	pɑrʧɑʤɯkleri	pɑrʧɑʤɯklɑrɯ
pɑrʧɑlArDA	pɑrʧɑlɑrde	pɑrʧɑlɑrdɑ
pɑzɑrDAn	pɑzɑrden	pɑzɑrdɑn
reʒimA	reʒimɑ	reʒime
ruhsɑtHn	ruhsɑtin	ruhsɑtɯn
sɯnɯrA	sɯnɯre	sɯnɯrɑ
søzlykDA	søzlyktɑ	søzlykte
sɑldɯrɯlArDA	sɑldɯrɯlɑrde	sɑldɯrɯlɑrdɑ
sɑplH	sɑpli	sɑplɯ
sɑtɯrlHk	sɑtɯrlik	sɑtɯrlɯk
sempozjumlAr	sempozjumler	sempozjumlɑr
senɑtoHHn	senɑtoiin	senɑtouun
sensørlAr	sensørlɑr	sensørler
sijɑsetDAn	sijɑsettɑn	sijɑsetten
sokɑklArHn	sokɑklerin	sokɑklɑrɯn
sorumlHlAr	sorumliler	sorumlulɑr
sunuʤuHHn	sunuʤuiin	sunuʤuuun
tɑburH	tɑburi	tɑburu
tɑlɑʃlH	tɑlɑʃli	tɑlɑʃlɯ
tɑnɯHp	tɑnɯip	tɑnɯɯp
tɑnklAr	tɑnkler	tɑnklɑr
tɑnrɯlArHn	tɑnrɯlerin	tɑnrɯlɑrɯn
tɑvukʧHlHk	tɑvukʧilik	tɑvukʧuluk
ulɑʃmAlArH	ulɑʃmeleri	ulɑʃmɑlɑrɯ
vɑtɑndɑʃlArDAn	vɑtɑndɑʃlerden	vɑtɑndɑʃlɑrdɑn
jykseklHkDAki	jykseklɯkteki	jykseklikteki
jɑʃɑmnHzH	jɑʃɑmnizi	jɑʃɑmnɯzɯ
jɑklɑʃɯmlArA	jɑklɑʃɯmlere	jɑklɑʃɯmlɑrɑ
jɑsɑklArH	jɑsɑkleri	jɑsɑklɑrɯ
jolsuzlHklAr	jolsuzlɯkler	jolsuzluklɑr
zorunlulHklAr	zorunlulikler	zorunluluklɑr
ʧɯkɑrDHklArH	ʧɯkɑrdikleri	ʧɯkɑrdɯklɑrɯ
ʧɯkmAHHn	ʧɯkmeiin	ʧɯkmɑɯɯn
ʧɑmɑʃɯrlArH	ʧɑmɑʃɯrleri	ʧɑmɑʃɯrlɑrɯ
ʧɑrlHk	ʧɑrlik	ʧɑrlɯk
ɑɰɯzA	ɑɰɯze	ɑɰɯzɑ
ɑʤɯlArHn	ɑʤɯlerin	ɑʤɯlɑrɯn
ɑlɑrmH	ɑlɑrmi	ɑlɑrmɯ
ɑtlɑHp	ɑtlɑip	ɑtlɑɯp
ɑvɑntɑʒlArA	ɑvɑntɑʒlere	ɑvɑntɑʒlɑrɑ
ɑvDAn	ɑvtɑn	ɑvdɑn
ɑjgɯtlArH	ɑjgɯtleri	ɑjgɯtlɑrɯ
bølAn	bølɑn	bølen
byjymADA	byjymede	byjymete
bɑʃlɑmADA	bɑʃlɑmɑdɑ	bɑʃlɑmɑtɑ
bɑʃlɑmAlArH	bɑʃlɑmeleri	bɑʃlɑmɑlɑrɯ
bɑlɯklH	bɑlɯkli	bɑlɯklɯ
bɑromHz	bɑromiz	bɑromuz
boɰHʤH	boɰiʤi	boɰuʤu
bulunmAlArnH	bulunmelerni	bulunmɑlɑrnɯ
deɰiʃimDAn	deɰiʃimdɑn	deɰiʃimden
deɰiʃkenlArA	deɰiʃkenlɑrɑ	deɰiʃkenlere
denetimDAn	denetimdɑn	denetimden
denklHk	denklɯk	denklik
dinlenDHkDAn	dinlendiktɑn	dinlendikten
edebijɑtHn	edebijɑtin	edebijɑtɯn
ekimDAn	ekimdɑn	ekimden
ekrɑnlArH	ekrɑnleri	ekrɑnlɑrɯ
enfeksijonlArHn	enfeksijonlerin	enfeksijonlɑrɯn
fɑjlAr	fɑjler	fɑjlɑr
formylHn	formylin	formylyn
girAbilmAH	girɑbilmɑɯ	girebilmei
girHnʤAA	girinʤɑɑ	girinʤee
hɑʤimDA	hɑʤimdɑ	hɑʤimde
hɑkimA	hɑkimɑ	hɑkime
hɑlmA	hɑlmɑ	hɑlme
hususlArDAn	hususlerden	hususlɑrdɑn
ithɑlɑtHn	ithɑlɑtin	ithɑlɑtɯn
kɯsɯmlArHn	kɯsɯmlerin	kɯsɯmlɑrɯn
kømyrlAr	kømyrlɑr	kømyrler
køpyklH	køpykli	køpykly
kɑinɑtHn	kɑinɑtin	kɑinɑtɯn
kɑpɑklArHn	kɑpɑklerin	kɑpɑklɑrɯn
kɑplArDA	kɑplɑrde	kɑplɑrdɑ
kɑzɑnlArH	kɑzɑnleri	kɑzɑnlɑrɯ
kortH	kortɯ	kortu
kurtlAr	kurtler	kurtlɑr
mylkH	mylki	mylky
mɑmulHn	mɑmulin	mɑmulyn
molekylH	molekyli	molekyly
oklAr	okler	oklɑr
ordumHzHn	ordumizin	ordumuzun
pɑketDA	pɑkettɑ	pɑkette
pɑsɑportH	pɑsɑportɯ	pɑsɑportu
posterlAr	posterlɑr	posterler
progrɑmmHzHn	progrɑmmizin	progrɑmmɯzɯn
rɑhɑtsHzlHklArH	rɑhɑtsizlɯkleri	rɑhɑtsɯzlɯklɑrɯ
søzmHz	søzmiz	søzmyz
sɑllAnAn	sɑllenen	sɑllɑnɑn
sensørH	sensøri	sensøry
soɰɑnlArH	soɰɑnleri	soɰɑnlɑrɯ
sorulArmHzH	sorulɑrmizi	sorulɑrmɯzɯ
sporHHn	sporiin	sporuun
stɑtyHHn	stɑtyiin	stɑtyyyn
teknisjenlAr	teknisjenlɑr	teknisjenler
televizjonA	televizjone	televizjonɑ
temizlAAn	temizlɑɑn	temizleen
tesʤilDAn	tesʤiltɑn	tesʤilden
tijɑtroH	tijɑtroi	tijɑtrou
tutɑrlArHHn	tutɑrleriin	tutɑrlɑrɯɯn
tutulmɑlH	tutulmɑli	tutulmɑlɯ
uʧHʃH	uʧiʃi	uʧuʃu
jønetAnlArHn	jønetɑnlerin	jønetenlerin
jyklAnArAk	jyklɑnɑrɑk	jyklenerek
jɑʃɑmmHzHn	jɑʃɑmmizin	jɑʃɑmmɯzɯn
jɑnmDAki	jɑnmteki	jɑnmdɑki
jɑpɯtHn	jɑpɯtin	jɑpɯtɯn
jɑrɑrlAnmAlArH	jɑrɑrlɑnmeleri	jɑrɑrlɑnmɑlɑrɯ
jɑsɑklH	jɑsɑkli	jɑsɑklɯ
jɑvɑʃlAr	jɑvɑʃler	jɑvɑʃlɑr
jɑzmADAn	jɑzmeden	jɑzmɑtɑn
zɑmɑnmHz	zɑmɑnmiz	zɑmɑnmɯz
zɑmɑnlArDAki	zɑmɑnlɑrdeki	zɑmɑnlɑrdɑki
zehirlAnmAH	zehirlɑnmɑɯ	zehirlenmei
ʧɯkHʃHHn	ʧɯkiʃiin	ʧɯkɯʃɯɯn
ʧøkelmA	ʧøkelmɑ	ʧøkelme
øɰrenmAnHz	øɰrenmɑniz	øɰrenmeniz
øɰretmenDAn	øɰretmendɑn	øɰretmenden
ʃɑmpijonlHk	ʃɑmpijonlɯk	ʃɑmpijonluk
ɑʃɯklAr	ɑʃɯkler	ɑʃɯklɑr
ɑdɑletsHzlHk	ɑdɑletsizlɯk	ɑdɑletsizlik
ɑkɯmlArHn	ɑkɯmlerin	ɑkɯmlɑrɯn
ɑkʤiɰerlAr	ɑkʤiɰerlɑr	ɑkʤiɰerler
ɑktørlAr	ɑktørlɑr	ɑktørler
ɑnimɑsjonlArH	ɑnimɑsjonleri	ɑnimɑsjonlɑrɯ
ɑntikorlArH	ɑntikorleri	ɑntikorlɑrɯ
ɑtDHklArH	ɑttikleri	ɑttɯklɑrɯ
bykmA	bykmɑ	bykme
byjyklHklAr	byjyklikler	byjyklykler
bejɑnlArH	bejɑnleri	bejɑnlɑrɯ
bilgisɑjɑrnHzDAki	bilgisɑjɑrnizdeki	bilgisɑjɑrnɯzdɑki
bilmADHklArH	bilmetikleri	bilmedikleri
bloklArHn	bloklerin	bloklɑrɯn
bulmAlArH	bulmeleri	bulmɑlɑrɯ
bulHnʤA	bulinʤe	bulunʤɑ
butonlArH	butonleri	butonlɑrɯ
dyʃHʃA	dyʃiʃe	dyʃyʃe
dyʃmAAn	dyʃmɑɑn	dyʃmeen
dɑmɑrDAn	dɑmɑrden	dɑmɑrdɑn
delikDAn	deliktɑn	delikten
derinlArA	derinlɑrɑ	derinlere
dujHp	dujip	dujup
esnɑfHHn	esnɑfiin	esnɑfɯɯn
evnHzDAn	evnizdɑn	evnizden
geʤikmAA	geʤikmɑɑ	geʤikmee
hɑriʧDAn	hɑriʧtɑn	hɑriʧten
hɑstɑmHzHn	hɑstɑmizin	hɑstɑmɯzɯn
huzurnHzDA	huzurnizde	huzurnuzdɑ
iʧmAAn	iʧmɑɑn	iʧmeen
inʃɑɑtA	inʃɑɑte	inʃɑɑtɑ
inɑnʧlH	inɑnʧli	inɑnʧlɯ
køʃkH	køʃki	køʃky
køpryDAn	køprytɑn	køpryden
kɑlɑnlArH	kɑlɑnleri	kɑlɑnlɑrɯ
kɑlmADAn	kɑlmɑdɑn	kɑlmɑtɑn
kɑnɯtlArn	kɑnɯtlern	kɑnɯtlɑrn
kɑrɑmsɑrlHk	kɑrɑmsɑrlik	kɑrɑmsɑrlɯk
kɑsHHn	kɑsiin	kɑsɯɯn
kolDAn	kolden	koldɑn
konutlArA	konutlere	konutlɑrɑ
kojDHklArH	kojdikleri	kojduklɑrɯ
kuʃHn	kuʃin	kuʃun
myʃteriDAn	myʃteriten	myʃteriden
mɑɰdurlArHn	mɑɰdurlerin	mɑɰdurlɑrɯn
mɑlHHn	mɑliin	mɑlɯɯn
mikroplArHn	mikroplerin	mikroplɑrɯn
modylDA	modyltɑ	modylde
nikA	nikɑ	nike
oʤɑklArDAn	oʤɑklerden	oʤɑklɑrdɑn
odɑDAki	odɑteki	odɑdɑki
olɑsɯlHklArH	olɑsɯlɯkleri	olɑsɯlɯklɑrɯ
olumsuzlHklArn	olumsuzlɯklern	olumsuzluklɑrn
ortɑklɯklArHn	ortɑklɯklerin	ortɑklɯklɑrɯn
plɑtformHHn	plɑtformiin	plɑtformuun
primA	primɑ	prime
progrɑmmHzDA	progrɑmmizde	progrɑmmɯzdɑ
pullAr	puller	pullɑr
referɑnslArH	referɑnsleri	referɑnslɑrɯ
reklɑmlArH	reklɑmleri	reklɑmlɑrɯ
ruhsɑtHHn	ruhsɑtiin	ruhsɑtɯɯn
sɑrɑjlAr	sɑrɑjler	sɑrɑjlɑr
sɑjfɑmHzH	sɑjfɑmizi	sɑjfɑmɯzɯ
sɑjfɑnHzH	sɑjfɑnizi	sɑjfɑnɯzɯ
sebeplArA	sebeplɑrɑ	sebeplere
sektørmHz	sektørmiz	sektørmyz
sorumluluklArHn	sorumluluklerin	sorumluluklɑrɯn
suʧsHz	suʧsiz	suʧsuz
tymDAn	tymdɑn	tymden
tɑʃlArDAn	tɑʃlerden	tɑʃlɑrdɑn
tɑtsHz	tɑtsiz	tɑtsɯz
teknikDA	tekniktɑ	teknikte
tijɑtroHHn	tijɑtroiin	tijɑtrouun
toprɑklArDAn	toprɑklerden	toprɑklɑrdɑn
tutɑrsHz	tutɑrsiz	tutɑrsɯz
ulɑʃmAlArnH	ulɑʃmelerni	ulɑʃmɑlɑrnɯ
ulɑʃmAnHz	ulɑʃmɑniz	ulɑʃmɑnɯz
usulsHz	usulsiz	usulsyz
ujɑrɯlArDA	ujɑrɯlɑrde	ujɑrɯlɑrdɑ
uzɑtHp	uzɑtip	uzɑtɯp
jyksekokullArHn	jyksekokullerin	jyksekokullɑrɯn
jyzejlH	jyzejlɯ	jyzejli
jyzjɯlDAki	jyzjɯldeki	jyzjɯldɑki
jɑkHʃ	jɑkiʃ	jɑkɯʃ
jɑndɑʃlArH	jɑndɑʃleri	jɑndɑʃlɑrɯ
jɑnlɯʃlArHn	jɑnlɯʃlerin	jɑnlɯʃlɑrɯn
ʧɑdɯrlArDA	ʧɑdɯrlɑrde	ʧɑdɯrlɑrdɑ
ʧɑjlAr	ʧɑjler	ʧɑjlɑr
ʧoʤuklArnHzH	ʧoʤuklernizi	ʧoʤuklɑrnɯzɯ
ʧoʤuklHkDAn	ʧoʤuklɯktɑn	ʧoʤukluktɑn
ørgytlAnmAA	ørgytlɑnmɑɑ	ørgytlenmee
ʃɑnsHHn	ʃɑnsiin	ʃɑnsɯɯn
ystlenmAH	ystlenmɑɯ	ystlenmei
ɑʧɯlɯmlAr	ɑʧɯlɯmler	ɑʧɯlɯmlɑr
ɑʧDHkDAn	ɑʧdiktɑn	ɑʧtɯktɑn
ɑlkolsHz	ɑlkolsiz	ɑlkolsyz
ɑrɑʃtɯrmAlArDAn	ɑrɑʃtɯrmɑlɑrden	ɑrɑʃtɯrmɑlɑrdɑn
ɑzɯnlɯklArA	ɑzɯnlɯklere	ɑzɯnlɯklɑrɑ
bɑʃDAki	bɑʃteki	bɑʃtɑki
bɑrɑʒlArH	bɑrɑʒleri	bɑrɑʒlɑrɯ
bombɑlH	bombɑli	bombɑlɯ
bulunDHkDAn	bulundiktɑn	bulunduktɑn
dyʃynmAHn	dyʃynmɑɯn	dyʃynmein
dɑɰɯtHʤHH	dɑɰɯtiʤii	dɑɰɯtɯʤɯɯ
dɑɰlArDAn	dɑɰlɑrden	dɑɰlɑrdɑn
dɑmɑrlArHHn	dɑmɑrleriin	dɑmɑrlɑrɯɯn
dɑrlHk	dɑrlik	dɑrlɯk
durumnHz	durumniz	durumnuz
enstitymHzDA	enstitymizde	enstitymyzde
eriʃimDA	eriʃimdɑ	eriʃimde
esɑslArHn	esɑslerin	esɑslɑrɯn
fɑbrikɑmHz	fɑbrikɑmiz	fɑbrikɑmɯz
gørAnHn	gørɑnɯn	gørenin
gøstermAH	gøstermɑɯ	gøstermei
gøtyrArAk	gøtyrɑrɑk	gøtyrerek
gøzmHz	gøzmiz	gøzmyz
gyvensHz	gyvensɯz	gyvensiz
geʧinAn	geʧinɑn	geʧinen
genlAʃmA	genlɑʃmɑ	genleʃme
getirAbilmAH	getirɑbilmɑɯ	getirebilmei
getirmADA	getirmɑdɑ	getirmede
girmAHn	girmɑɯn	girmein
hɯrsɯzlAr	hɯrsɯzler	hɯrsɯzlɑr
hykymDAn	hykymdɑn	hykymden
hɑberlArDA	hɑberlɑrde	hɑberlerde
hɑlkʧH	hɑlkʧi	hɑlkʧɯ
hɑmɑmlAr	hɑmɑmler	hɑmɑmlɑr
hɑrʤɑmAlArDA	hɑrʤɑmɑlɑrde	hɑrʤɑmɑlɑrdɑ
iʧeriDAki	iʧeriteki	iʧerideki
inʤeleDHkDAn	inʤeletiktɑn	inʤeledikten
islAAn	islɑɑn	isleen
istɑsjonlArDA	istɑsjonlɑrde	istɑsjonlɑrdɑ
kyrsyDAn	kyrsytɑn	kyrsyden
kɑlAbilmA	kɑlɑbilmɑ	kɑlɑbilme
kɑnɑɑtH	kɑnɑɑtɯ	kɑnɑɑti
kɑplArHn	kɑplerin	kɑplɑrɯn
kɑtkɯlArDAn	kɑtkɯlɑrden	kɑtkɯlɑrdɑn
kilolH	kiloli	kilolu
klɑsørlAr	klɑsørlɑr	klɑsørler
konɑklArH	konɑkleri	konɑklɑrɯ
konsejHn	konsejɯn	konsejin
kurʃunlH	kurʃunli	kurʃunlu
kurɑlHn	kurɑlin	kurɑlɯn
mɑsɑllAr	mɑsɑller	mɑsɑllɑr
metinlArDAn	metinlɑrden	metinlerden
mezunlArmHzHn	mezunlɑrmizin	mezunlɑrmɯzɯn
miktɑrlArHn	miktɑrlerin	miktɑrlɑrɯn
mimɑriDA	mimɑrite	mimɑride
olimpijɑtlArH	olimpijɑtleri	olimpijɑtlɑrɯ
olHʃHHn	oliʃiin	oluʃuun
orɑnlArHn	orɑnlerin	orɑnlɑrɯn
pɑrɑnHzH	pɑrɑnizi	pɑrɑnɯzɯ
profesørlAr	profesørlɑr	profesørler
progrɑmlArmHz	progrɑmlermiz	progrɑmlɑrmɯz
progrɑmlArDAki	progrɑmlerdeki	progrɑmlɑrdɑki
rɑkɑmlArDAn	rɑkɑmlerden	rɑkɑmlɑrdɑn
rɑkiplArH	rɑkiplɑrɯ	rɑkipleri
reformHHn	reformiin	reformuun
rekɑbetDAn	rekɑbettɑn	rekɑbetten
sɯnɯflArDAn	sɯnɯflerden	sɯnɯflɑrdɑn
sɑkɑllH	sɑkɑlli	sɑkɑllɯ
sɑnɑtʧHA	sɑnɑtʧie	sɑnɑtʧɯɑ
sɑntrɑllArDA	sɑntrɑllerde	sɑntrɑllɑrdɑ
sɑvʤɯlArHn	sɑvʤɯlerin	sɑvʤɯlɑrɯn
sɑjɯlArDA	sɑjɯlɑrde	sɑjɯlɑrdɑ
silɑhlArDAn	silɑhlɑrden	silɑhlɑrdɑn
sorunlArmHzHn	sorunlɑrmizin	sorunlɑrmɯzɯn
stɑʒA	stɑʒe	stɑʒɑ
sunmADAn	sunmɑdɑn	sunmɑtɑn
tɑʃɯHp	tɑʃɯip	tɑʃɯɯp
tɑnɯtɯmlArH	tɑnɯtɯmleri	tɑnɯtɯmlɑrɯ
tekerryrH	tekerryri	tekerryry
televizjonlArHn	televizjonlerin	televizjonlɑrɯn
uʧlArHHn	uʧleriin	uʧlɑrɯɯn
vektørlAr	vektørlɑr	vektørler
viryslH	virysli	virysly
jɑʃɑmmHzH	jɑʃɑmmizi	jɑʃɑmmɯzɯ
jɑʃɑmnHzHn	jɑʃɑmnizin	jɑʃɑmnɯzɯn
jɑʃɑmADAn	jɑʃɑmɑdɑn	jɑʃɑmɑtɑn
jɑlɯtɯmlH	jɑlɯtɯmli	jɑlɯtɯmlɯ
jɑpɯmHz	jɑpɯmiz	jɑpɯmɯz
jɑrɑtHp	jɑrɑtip	jɑrɑtɯp
jɑrɑtmADA	jɑrɑtmede	jɑrɑtmɑtɑ
jɑzɯnsAl	jɑzɯnsel	jɑzɯnsɑl
jɑzlAr	jɑzler	jɑzlɑr
zɑrɑrlHlArH	zɑrɑrlileri	zɑrɑrlɯlɑrɯ
zorH	zori	zoru
ʧɑtlɑklArH	ʧɑtlɑkleri	ʧɑtlɑklɑrɯ
ʧekinArAk	ʧekinɑrɑk	ʧekinerek
ʧizmAA	ʧizmɑɑ	ʧizmee
øɰretmenlArmHzHn	øɰretmenlɑrmizin	øɰretmenlermizin
ʃɑhɯslArH	ʃɑhɯsleri	ʃɑhɯslɑrɯ
yzymH	yzymi	yzymy
ɑlHnʤAA	ɑlinʤɑɑ	ɑlɯnʤɑɑ
ɑlɯnmAlArH	ɑlɯnmeleri	ɑlɯnmɑlɑrɯ
ɑlɑʃɯmlH	ɑlɑʃɯmli	ɑlɑʃɯmlɯ
ɑnketDA	ɑnkettɑ	ɑnkette
ɑnlɑjɯʃlH	ɑnlɑjɯʃli	ɑnlɑjɯʃlɯ
ɑntrenørlHk	ɑntrenørlik	ɑntrenørlyk
ɑrɑHʃlArA	ɑrɑiʃlere	ɑrɑɯʃlɑrɑ
ɑrmutlH	ɑrmutli	ɑrmutlu
ɑtɯmlH	ɑtɯmli	ɑtɯmlɯ
ɑvɑntɑʒlArDAn	ɑvɑntɑʒlerden	ɑvɑntɑʒlɑrdɑn
ɑjɑrlArHn	ɑjɑrlerin	ɑjɑrlɑrɯn
bɯrɑkmAAʤAk	bɯrɑkmeeʤek	bɯrɑkmɑɑʤɑk
byroHHn	byroiin	byrouun
bɑɰlArHHn	bɑɰleriin	bɑɰlɑrɯɯn
bɑɰlɑHp	bɑɰlɑip	bɑɰlɑɯp
bɑʃlɯklArHHn	bɑʃlɯkleriin	bɑʃlɯklɑrɯɯn
bɑʤɑklArDA	bɑʤɑklerde	bɑʤɑklɑrdɑ
bɑkɑnlɯklArA	bɑkɑnlɯklere	bɑkɑnlɯklɑrɑ
belirlemADA	belirlemede	belirlemete
benzemAAn	benzemɑɑn	benzemeen
borsɑDAki	borsɑteki	borsɑdɑki
ʤihɑzlArDAn	ʤihɑzlerden	ʤihɑzlɑrdɑn
dyʃmɑnlArHn	dyʃmɑnlerin	dyʃmɑnlɑrɯn
dyzeltmAH	dyzeltmɑɯ	dyzeltmei
dɑlgɑHHn	dɑlgɑiin	dɑlgɑɯɯn
dɑmgɑlH	dɑmgɑli	dɑmgɑlɯ
dɑjɑnɑklArH	dɑjɑnɑkleri	dɑjɑnɑklɑrɯ
demADAn	demeden	demeten
desteklAmADA	desteklemede	desteklemete
dozlArH	dozleri	dozlɑrɯ
editørHn	editørin	editøryn
eriʃkinDA	eriʃkindɑ	eriʃkinde
essHz	essɯz	essiz
etmADHkʧA	etmetikʧɑ	etmedikʧe
etmAmAA	etmɑmɑɑ	etmemee
fɯrsɑtlArHn	fɯrsɑtlerin	fɯrsɑtlɑrɯn
fɑbrikɑDAn	fɑbrikɑtɑn	fɑbrikɑdɑn
fɑrksHz	fɑrksiz	fɑrksɯz
fenerlAr	fenerlɑr	fenerler
firmɑnHzA	firmɑnize	firmɑnɯzɑ
fijɑtlArDAn	fijɑtlerden	fijɑtlɑrdɑn
fizikDA	fiziktɑ	fizikte
fuɑrlArDA	fuɑrlɑrde	fuɑrlɑrdɑ
gøzmHzHn	gøzmizin	gøzmyzyn
gyʧlAnAn	gyʧlɑnɑn	gyʧlenen
geliʃmADAn	geliʃmɑdɑn	geliʃmeden
gemiDAn	gemiten	gemiden
hɑreketDAn	hɑrekettɑn	hɑreketten
hɑzɯrlɯklArA	hɑzɯrlɯklere	hɑzɯrlɯklɑrɑ
hissetmAA	hissetmɑɑ	hissetmee
iʧimDAki	iʧimdɑki	iʧimdeki
ihrɑʤɑtmHz	ihrɑʤɑtmiz	ihrɑʤɑtmɯz
ikiDA	ikite	ikide
imkɑnmHz	imkɑnmiz	imkɑnmɯz
istikɑmetDA	istikɑmettɑ	istikɑmette
istikrɑrsHzlHk	istikrɑrsizlɯk	istikrɑrsɯzlɯk
izɑhH	izɑhi	izɑhɯ
izlAHʤHnHn	izlɑɯʤɯnɯn	izleiʤinin
kɯzlArA	kɯzlere	kɯzlɑrɑ
kɑɰɯtlArA	kɑɰɯtlere	kɑɰɯtlɑrɑ
kɑlɯplArHn	kɑlɯplerin	kɑlɯplɑrɯn
kɑnunlArHHn	kɑnunleriin	kɑnunlɑrɯɯn
kɑpɑklArHHn	kɑpɑkleriin	kɑpɑklɑrɯɯn
kɑrbonhidrɑtlArHn	kɑrbonhidrɑtlerin	kɑrbonhidrɑtlɑrɯn
kɑtɯlɯmlArH	kɑtɯlɯmleri	kɑtɯlɯmlɑrɯ
kendinHzDAn	kendinizdɑn	kendinizden
kodA	kode	kodɑ
konuklArmHz	konuklermiz	konuklɑrmɯz
kujumʤulHk	kujumʤulɯk	kujumʤuluk
kujuA	kujue	kujuɑ
mɯsɯrlH	mɯsɯrli	mɯsɯrlɯ
myfettiʃlHk	myfettiʃlɯk	myfettiʃlik
mɑkbuzlArHn	mɑkbuzlerin	mɑkbuzlɑrɯn
mɑkinɑlH	mɑkinɑli	mɑkinɑlɯ
merɑklHlArH	merɑklileri	merɑklɯlɑrɯ
mevʤutlArH	mevʤutleri	mevʤutlɑrɯ
oʤɑklArHn	oʤɑklerin	oʤɑklɑrɯn
okumADA	okumɑdɑ	okumɑtɑ
okumADAn	okumɑdɑn	okumɑtɑn
olH	oli	olu
onurHHn	onuriin	onuruun
ortɑklArDAn	ortɑklerden	ortɑklɑrdɑn
oturumlArH	oturumleri	oturumlɑrɯ
petrolH	petroli	petroly
politikɑDAn	politikɑtɑn	politikɑdɑn
portføjHHn	portføjiin	portføjyyn
rɑflArA	rɑflere	rɑflɑrɑ
reklɑmlArDA	reklɑmlerde	reklɑmlɑrdɑ
sytunlH	sytunli	sytunlu
sɑhɑDAn	sɑhɑtɑn	sɑhɑdɑn
sɑrɯlHp	sɑrɯlup	sɑrɯlɯp
sɑjfɑlArmHz	sɑjfɑlɑrmiz	sɑjfɑlɑrmɯz
seɑnsDA	seɑnste	seɑnstɑ
sorumlHlArHHn	sorumlileriin	sorumlulɑrɯɯn
sponsorlHk	sponsorlik	sponsorluk
stoklArHn	stoklerin	stoklɑrɯn
tyketimDA	tyketimdɑ	tyketimde
tɑlimɑtHn	tɑlimɑtin	tɑlimɑtɯn
tɑlimɑtA	tɑlimɑte	tɑlimɑtɑ
tɑrɑHʤHH	tɑrɑɯʤii	tɑrɑɯʤɯɯ
tɑrihlArA	tɑrihlɑrɑ	tɑrihlere
teʃebbysHn	teʃebbysɯn	teʃebbysyn
teʃkilɑtlArH	teʃkilɑtleri	teʃkilɑtlɑrɯ
teoriDA	teorite	teoride
tiʤɑretDAn	tiʤɑrettɑn	tiʤɑretten
ulɑʃmAmHz	ulɑʃmemiz	ulɑʃmɑmɯz
vɑrlɯklArA	vɑrlɯklere	vɑrlɯklɑrɑ
vɑrsɑjAlHm	vɑrsɑjɑlim	vɑrsɑjɑlɯm
jɯldɯzlArA	jɯldɯzlere	jɯldɯzlɑrɑ
jønelmA	jønelmɑ	jønelme
jɑkɯtlH	jɑkɯtli	jɑkɯtlɯ
jɑnɯtlAmA	jɑnɯtleme	jɑnɯtlɑmɑ
jɑpmADA	jɑpmede	jɑpmɑdɑ
jɑpmAHHn	jɑpmeiin	jɑpmɑɯɯn
jɑrɑtɯklAr	jɑrɑtɯkler	jɑrɑtɯklɑr
jɑrHn	jɑrɯn	jɑrin
jerleʃmAA	jerleʃmɑɑ	jerleʃmee
jurtlArHn	jurtlerin	jurtlɑrɯn
ʧɑtɯʃmAlArDA	ʧɑtɯʃmɑlɑrde	ʧɑtɯʃmɑlɑrdɑ
ʧekiʃmAlH	ʧekiʃmɑli	ʧekiʃmeli
ølyHn	ølyin	ølyyn
ølAnlArA	ølɑnlɑrɑ	ølenlere
yʤretDAn	yʤrettɑn	yʤretten
ynvɑnlArH	ynvɑnleri	ynvɑnlɑrɯ
ɑkʤiɰerlArDA	ɑkʤiɰerlɑrde	ɑkʤiɰerlerde
ɑlkolA	ɑlkolɑ	ɑlkole
ɑnlɑmAmHz	ɑnlɑmemiz	ɑnlɑmɑmɯz
ɑnlɑtmADA	ɑnlɑtmede	ɑnlɑtmɑtɑ
ɑrkɑDAki	ɑrkɑteki	ɑrkɑdɑki
ɑjdɯnlArHn	ɑjdɯnlerin	ɑjdɯnlɑrɯn
ɑjlɯklArH	ɑjlɯkleri	ɑjlɯklɑrɯ
bølymmHzHn	bølymmizin	bølymmyzyn
bytynlAʃAn	bytynlɑʃɑn	bytynleʃen
byjykʧA	byjykʧɑ	byjykʧe
bɑʃvuruA	bɑʃvurue	bɑʃvuruɑ
beklemADA	beklemede	beklemete
belirleDHklArH	belirletikleri	belirledikleri
belirleDHkDAn	belirletiktɑn	belirledikten
bilɑnʧoHn	bilɑnʧoin	bilɑnʧoun
bilmADA	bilmɑdɑ	bilmete
birikmAH	birikmɑɯ	birikmei
ʤivɑrDAki	ʤivɑrdeki	ʤivɑrdɑki
dyɰynH	dyɰyni	dyɰyny
dyzeltmAH	dyzeltmɑɯ	dyzeltmei
demokrɑsiDA	demokrɑsite	demokrɑside
dostlArm	dostlerm	dostlɑrm
dozlAr	dozler	dozlɑr
dudɑklAr	dudɑkler	dudɑklɑr
duvɑrDAki	duvɑrdeki	duvɑrdɑki
ebevejnlAr	ebevejnlɑr	ebevejnler
enfeksijonlArHHn	enfeksijonleriin	enfeksijonlɑrɯɯn
erDHkDAn	erdiktɑn	erdikten
erkeklHk	erkeklɯk	erkeklik
esenlHk	esenlɯk	esenlik
etmAnHzA	etmɑnize	etmenize
federɑsjonA	federɑsjone	federɑsjonɑ
gørynmA	gørynmɑ	gørynme
geleʤekDAn	geleʤektɑn	geleʤekten
girmAmAH	girmɑmɑɯ	girmemei
hɑvuzDA	hɑvuzde	hɑvuzdɑ
iletkenlHk	iletkenlɯk	iletkenlik
istemADHklArH	istemetikleri	istemedikleri
ithɑlɑtHHn	ithɑlɑtiin	ithɑlɑtɯɯn
izleDHklArH	izletikleri	izledikleri
kyresAllAʃmAH	kyreselleʃmɑɯ	kyreselleʃmei
kɑrʃɯlɑʃHnʤA	kɑrʃɯlɑʃinʤe	kɑrʃɯlɑʃɯnʤɑ
kɑrɑkolH	kɑrɑkoli	kɑrɑkolu
kɑtɯlɯmʤɯlArHHn	kɑtɯlɯmʤɯleriin	kɑtɯlɯmʤɯlɑrɯɯn
kɑtɯlmAlArnH	kɑtɯlmelerni	kɑtɯlmɑlɑrnɯ
kɑtHp	kɑtip	kɑtɯp
kɑjbetDHklArH	kɑjbetdikleri	kɑjbettikleri
kɑjmɑkɑmlAr	kɑjmɑkɑmler	kɑjmɑkɑmlɑr
kenɑrlH	kenɑrli	kenɑrlɯ
kollArHn	kollerin	kollɑrɯn
konferɑnslArDA	konferɑnslerde	konferɑnslɑrdɑ
kuʃʧH	kuʃʧi	kuʃʧu
kurslArHHn	kursleriin	kurslɑrɯɯn
kurummHzHn	kurummizin	kurummuzun
kujruklAr	kujrukler	kujruklɑr
myhyrlH	myhyrli	myhyrly
mysɑbɑkɑlArDA	mysɑbɑkɑlɑrde	mysɑbɑkɑlɑrdɑ
mekɑnlArDAn	mekɑnlɑrden	mekɑnlɑrdɑn
mekɑnsAl	mekɑnsel	mekɑnsɑl
merkezijetʧH	merkezijetʧɯ	merkezijetʧi
metodlArHHn	metodleriin	metodlɑrɯɯn
metodHHn	metodiin	metoduun
oɰuzlAr	oɰuzler	oɰuzlɑr
okumAnHzH	okumɑnizi	okumɑnɯzɯ
olAbilmAnHn	olɑbilmɑnɯn	olɑbilmenin
olmAmHzH	olmemizi	olmɑmɯzɯ
olurH	oluri	oluru
piʃmA	piʃmɑ	piʃme
pilotHn	pilotin	pilotun
prensiplArA	prensiplɑrɑ	prensiplere
proʒeDAki	proʒeteki	proʒedeki
purolHk	purolik	puroluk
rɑportørlHk	rɑportørlik	rɑportørlyk
rezistɑnsH	rezistɑnsu	rezistɑnsɯ
sɯʧɑnlArDA	sɯʧɑnlɑrde	sɯʧɑnlɑrdɑ
sɯɰɯrlArDA	sɯɰɯrlɑrde	sɯɰɯrlɑrdɑ
syrmAA	syrmɑɑ	syrmee
sɑnɑjiDAki	sɑnɑjiteki	sɑnɑjideki
sigortɑlHlAr	sigortɑliler	sigortɑlɯlɑr
sorunnHz	sorunniz	sorunnuz
stresDAn	strestɑn	stresten
suʧlHH	suʧlii	suʧluu
tyjH	tyjɯ	tyjy
tɑʃɯnmɑzlAr	tɑʃɯnmɑzler	tɑʃɯnmɑzlɑr
tɑnɯmlArHHn	tɑnɯmleriin	tɑnɯmlɑrɯɯn
tɑsɑrruflArH	tɑsɑrrufleri	tɑsɑrruflɑrɯ
tɑvuklArHn	tɑvuklerin	tɑvuklɑrɯn
tɑzminɑtlAr	tɑzminɑtler	tɑzminɑtlɑr
teʤɑvyzHn	teʤɑvyzɯn	teʤɑvyzyn
tepkimA	tepkimɑ	tepkime
tutmAlArH	tutmeleri	tutmɑlɑrɯ
ulusA	uluse	ulusɑ
uzɑDHkʧA	uzɑtɯkʧɑ	uzɑdɯkʧɑ
uzɑjlAr	uzɑjler	uzɑjlɑr
vermAm	vermɑm	vermem
jynlH	jynli	jynly
jyrymADA	jyrymede	jyrymete
jɑʃɑHʃ	jɑʃɑiʃ	jɑʃɑɯʃ
jɑnɯklAr	jɑnɯkler	jɑnɯklɑr
jɑpHnʤA	jɑpinʤe	jɑpɯnʤɑ
jɑrɯʃlAr	jɑrɯʃler	jɑrɯʃlɑr
jɑtmADAn	jɑtmeden	jɑtmɑdɑn
jɑzɯlɯmlArA	jɑzɯlɯmlere	jɑzɯlɯmlɑrɑ
jɑzɯlArHHn	jɑzɯleriin	jɑzɯlɑrɯɯn
jɑzɯmHzHn	jɑzɯmizin	jɑzɯmɯzɯn
jemAn	jemɑn	jemen
jolʤuluklAr	jolʤulukler	jolʤuluklɑr
ʧɯkHʃHn	ʧɯkiʃin	ʧɯkɯʃɯn
ʧɯkDHklArH	ʧɯktikleri	ʧɯktɯklɑrɯ
ʧøzymDA	ʧøzymdɑ	ʧøzymde
ʧɑlɯʃɑnlArDAn	ʧɑlɯʃɑnlɑrden	ʧɑlɯʃɑnlɑrdɑn
ʧɑlɯʃmAmHzHn	ʧɑlɯʃmemizin	ʧɑlɯʃmɑmɯzɯn
ʧekiʃmA	ʧekiʃmɑ	ʧekiʃme
ʧimentoHn	ʧimentoin	ʧimentoun
ɯrkʧHlHk	ɯrkʧilik	ɯrkʧɯlɯk
ølmAA	ølmɑɑ	ølmee
øzetlAAn	øzetlɑɑn	øzetleen
yzernDAken	yzernteken	yzerndeken
ɑʧɯklɑmAlArDAn	ɑʧɯklɑmɑlɑrden	ɑʧɯklɑmɑlɑrdɑn
ɑhiretDA	ɑhirettɑ	ɑhirette
ɑmbɑlɑʒlH	ɑmbɑlɑʒli	ɑmbɑlɑʒlɯ
ɑnlɑʃmɑzlɯklArH	ɑnlɑʃmɑzlɯkleri	ɑnlɑʃmɑzlɯklɑrɯ
ɑrtmAHHn	ɑrtmeiin	ɑrtmɑɯɯn
ɑjɑklArDA	ɑjɑklerde	ɑjɑklɑrdɑ
ɑjlArHHn	ɑjleriin	ɑjlɑrɯɯn
ɑjrɯlɯkʧH	ɑjrɯlɯkʧi	ɑjrɯlɯkʧɯ
bølArAk	bølɑrɑk	bølerek
bɑntlArH	bɑntleri	bɑntlɑrɯ
bɑrɯʃDA	bɑrɯʃte	bɑrɯʃtɑ
bɑslAmA	bɑsleme	bɑslɑmɑ
bebekDAn	bebektɑn	bebekten
bekleDHklArH	bekletikleri	bekledikleri
binAr	binɑr	biner
birɑzDA	birɑzde	birɑzdɑ
birlikDAn	birliktɑn	birlikten
bojlArHHn	bojleriin	bojlɑrɯɯn
bulmAmHz	bulmemiz	bulmɑmɯz
bulunHʃH	bulunɯʃɯ	bulunuʃu
ʤumhurijetDAn	ʤumhurijettɑn	ʤumhurijetten
dyʃmH	dyʃmi	dyʃmy
dyʃmADA	dyʃmɑdɑ	dyʃmete
dyʃmAmA	dyʃmɑmɑ	dyʃmeme
dyʃmAmAH	dyʃmɑmɑɯ	dyʃmemei
dɑmɑrlArA	dɑmɑrlere	dɑmɑrlɑrɑ
dɑvrɑnmAlArH	dɑvrɑnmeleri	dɑvrɑnmɑlɑrɯ
deɰiʃmA	deɰiʃmɑ	deɰiʃme
deɰiʃmAlArA	deɰiʃmɑlɑrɑ	deɰiʃmelere
dinlAAlHm	dinlɑɑlim	dinleelim
doɰmADAn	doɰmeden	doɰmɑdɑn
doksɑnlH	doksɑnli	doksɑnlɯ
eɰlenmA	eɰlenmɑ	eɰlenme
ekiplArmHz	ekiplɑrmiz	ekiplermiz
fɑrkA	fɑrke	fɑrkɑ
fonlArDAn	fonlɑrden	fonlɑrdɑn
formɑtlArH	formɑtleri	formɑtlɑrɯ
gøndermAnHzH	gøndermɑnizi	gøndermenizi
geliʃmA	geliʃmɑ	geliʃme
gerekAnDAn	gerekɑndɑn	gerekenden
girmAHHn	girmɑɯɯn	girmeiin
hɑmurHn	hɑmurin	hɑmurun
hɑrʤɑmAlArnA	hɑrʤɑmelerne	hɑrʤɑmɑlɑrnɑ
hɑtlArDAn	hɑtlerden	hɑtlɑrdɑn
hormonlArH	hormonleri	hormonlɑrɯ
iʃɑretlAnmAH	iʃɑretlɑnmɑɯ	iʃɑretlenmei
ilɑʧlArHHn	ilɑʧleriin	ilɑʧlɑrɯɯn
inʃɑɑtlArHn	inʃɑɑtlerin	inʃɑɑtlɑrɯn
insɑnlArmHzA	insɑnlɑrmize	insɑnlɑrmɯzɑ
izlAnmADA	izlɑnmɑdɑ	izlenmete
kɯsɯtlAmAA	kɯsɯtlemee	kɯsɯtlɑmɑɑ
kørlAr	kørlɑr	kørler
kyltyrmHzH	kyltyrmizi	kyltyrmyzy
kɑdrolArDA	kɑdrolɑrde	kɑdrolɑrdɑ
kɑfɑlH	kɑfɑli	kɑfɑlɯ
kɑhrɑmɑnlArHn	kɑhrɑmɑnlerin	kɑhrɑmɑnlɑrɯn
kɑlkArAk	kɑlkerek	kɑlkɑrɑk
kɑpsylH	kɑpsyli	kɑpsyly
kɑpsɑmADA	kɑpsɑmɑdɑ	kɑpsɑmɑtɑ
kɑtɯlmADA	kɑtɯlmɑdɑ	kɑtɯlmɑtɑ
kemerlAr	kemerlɑr	kemerler
kesilmA	kesilmɑ	kesilme
kolDA	kolde	koldɑ
konsolosH	konsolosi	konsolosu
korkuA	korkue	korkuɑ
kojmADA	kojmɑdɑ	kojmɑtɑ
kojmAlArH	kojmeleri	kojmɑlɑrɯ
kulyplArA	kulyplɑrɑ	kulyplere
kulɑklAr	kulɑkler	kulɑklɑr
kumlAr	kumler	kumlɑr
kurbɑnlArH	kurbɑnleri	kurbɑnlɑrɯ
kurulDAn	kurultɑn	kuruldɑn
kujruklH	kujrukli	kujruklu
kujuDAn	kujutɑn	kujudɑn
myzikDA	myziktɑ	myzikte
mɑhpuslAr	mɑhpusler	mɑhpuslɑr
mɑkbulA	mɑkbulɑ	mɑkbule
mɑsrɑflH	mɑsrɑfli	mɑsrɑflɯ
mesɑfeDAki	mesɑfeteki	mesɑfedeki
modylHHn	modyliin	modylyyn
mutɑbɑkɑtA	mutɑbɑkɑte	mutɑbɑkɑtɑ
nyfuslArH	nyfusleri	nyfuslɑrɯ
nehirlAr	nehirlɑr	nehirler
operɑsjonlArHn	operɑsjonlerin	operɑsjonlɑrɯn
ojunʤɑklArH	ojunʤɑkleri	ojunʤɑklɑrɯ
pɑrklArDA	pɑrklerde	pɑrklɑrdɑ
pɑjlɑʃmADAn	pɑjlɑʃmɑdɑn	pɑjlɑʃmɑtɑn
refɑkɑtʧH	refɑkɑtʧɯ	refɑkɑtʧi
sɯfɑtlArH	sɯfɑtleri	sɯfɑtlɑrɯ
sɑɰnDAki	sɑɰnteki	sɑɰndɑki
sɑnɑjilAʃmAHn	sɑnɑjileʃmɑɯn	sɑnɑjileʃmein
sɑvH	sɑvu	sɑvɯ
semtA	semtɑ	semte
sigortɑlHlHk	sigortɑlilik	sigortɑlɯlɯk
soɰuklHk	soɰuklɯk	soɰukluk
sojɑdlArH	sojɑdleri	sojɑdlɑrɯ
tɑrihlAnAn	tɑrihlɑnɑn	tɑrihlenen
tɑzminɑtHHn	tɑzminɑtiin	tɑzminɑtɯɯn
tɑzminɑtlArH	tɑzminɑtleri	tɑzminɑtlɑrɯ
tempoDA	tempode	tempodɑ
topluluklArA	topluluklere	topluluklɑrɑ
ulɑʃmAnHzH	ulɑʃmɑnizi	ulɑʃmɑnɯzɯ
vɑkɯflArH	vɑkɯfleri	vɑkɯflɑrɯ
vermAHHn	vermɑɯɯn	vermeiin
jykA	jykɑ	jyke
jyklAnmA	jyklɑnmɑ	jyklenme
jykselmA	jykselmɑ	jykselme
jɑʃlArDAn	jɑʃlerden	jɑʃlɑrdɑn
jɑpɯtlArHHn	jɑpɯtleriin	jɑpɯtlɑrɯɯn
jɑpDHklArHHn	jɑpdikleriin	jɑptɯklɑrɯɯn
jɑrɯʃmAlArHn	jɑrɯʃmelerin	jɑrɯʃmɑlɑrɯn
jɑrdɯmʤɯmHz	jɑrdɯmʤɯmiz	jɑrdɯmʤɯmɯz
jɑsɑklArA	jɑsɑklere	jɑsɑklɑrɑ
jerjyzynDAn	jerjyzyndɑn	jerjyzynden
jolmHz	jolmiz	jolmuz
jolmHzH	jolmizi	jolmuzu
ʧɑlɯʃɑnlArDA	ʧɑlɯʃɑnlɑrde	ʧɑlɯʃɑnlɑrdɑ
ʧimentoH	ʧimentoi	ʧimentou
yreAn	yreɑn	yreen
ɑdɑlArDA	ɑdɑlɑrde	ɑdɑlɑrdɑ
ɑlɯnmADHkʧA	ɑlɯnmɑtɯkʧɑ	ɑlɯnmɑdɯkʧɑ
ɑlbymDAn	ɑlbymdɑn	ɑlbymden
ɑntikorlArHn	ɑntikorlerin	ɑntikorlɑrɯn
ɑrkɑdɑʃnHzHn	ɑrkɑdɑʃnizin	ɑrkɑdɑʃnɯzɯn
ɑrkɑdɑʃnHzA	ɑrkɑdɑʃnize	ɑrkɑdɑʃnɯzɑ
ɑrkɑdɑʃlArnHzHn	ɑrkɑdɑʃlernizin	ɑrkɑdɑʃlɑrnɯzɯn
ɑrtɯklArHHn	ɑrtɯkleriin	ɑrtɯklɑrɯɯn
ɑtlArH	ɑtleri	ɑtlɑrɯ
ɑvɑntɑʒA	ɑvɑntɑʒe	ɑvɑntɑʒɑ
ɑjɯplH	ɑjɯpli	ɑjɯplɯ
ɑjɑrlArnHzH	ɑjɑrlernizi	ɑjɑrlɑrnɯzɯ
ɑjgɯtlArHn	ɑjgɯtlerin	ɑjgɯtlɑrɯn
ɑzɑlDHkʧA	ɑzɑltɯkʧɑ	ɑzɑldɯkʧɑ
bɯʧɑklAr	bɯʧɑkler	bɯʧɑklɑr
bɯkmADAn	bɯkmeden	bɯkmɑdɑn
bɑɰlɑntɯlArDA	bɑɰlɑntɯlɑrde	bɑɰlɑntɯlɑrdɑ
bɑʃɑrɯlArHn	bɑʃɑrɯlerin	bɑʃɑrɯlɑrɯn
bɑlɯklArHHn	bɑlɯkleriin	bɑlɯklɑrɯɯn
benzerlAr	benzerlɑr	benzerler
bilgisHzlHk	bilgisizlɯk	bilgisizlik
bolmH	bolmi	bolmu
bulutH	bulutɯ	bulutu
burɑlArDAki	burɑlɑrdeki	burɑlɑrdɑki
bursHn	bursin	bursun
butonA	butone	butonɑ
ʤevɑpsHz	ʤevɑpsiz	ʤevɑpsɯz
dyʃHʃHn	dyʃiʃin	dyʃyʃyn
dɑnsH	dɑnsu	dɑnsɯ
detɑjlArHn	detɑjlerin	detɑjlɑrɯn
dosjɑlArDAn	dosjɑlɑrden	dosjɑlɑrdɑn
dujHʃsAl	dujɯʃsel	dujuʃsɑl
eʃjɑlArnHzH	eʃjɑlɑrnizi	eʃjɑlɑrnɯzɯ
ekipDA	ekiptɑ	ekipte
eksenDA	eksendɑ	eksende
eleʃtirmA	eleʃtirmɑ	eleʃtirme
emisjonlArH	emisjonleri	emisjonlɑrɯ
fɯkrɑlArDA	fɯkrɑlɑrde	fɯkrɑlɑrdɑ
fɯrɯnlArH	fɯrɯnleri	fɯrɯnlɑrɯ
fɯrtɯnɑlH	fɯrtɯnɑli	fɯrtɯnɑlɯ
felɑketDAn	felɑkettɑn	felɑketten
figyrlAr	figyrlɑr	figyrler
gɯdɑlArDA	gɯdɑlɑrde	gɯdɑlɑrdɑ
gøndermADAn	gøndermɑdɑn	gøndermeden
gynɑhH	gynɑhi	gynɑhɯ
gɑjrimenkulA	gɑjrimenkulɑ	gɑjrimenkule
giriʃimA	giriʃimɑ	giriʃime
hykymsHzlHk	hykymsizlɯk	hykymsyzlyk
hɑfifA	hɑfifɑ	hɑfife
hɑriʧDA	hɑriʧtɑ	hɑriʧte
hoʤɑmHzHn	hoʤɑmizin	hoʤɑmɯzɯn
iʧAnlArDA	iʧenlɑrde	iʧenlerde
iʃtɑhsHzlHk	iʃtɑhsizlɯk	iʃtɑhsɯzlɯk
ihtilɑflArHn	ihtilɑflerin	ihtilɑflɑrɯn
ikɑmetgɑhHHn	ikɑmetgɑhiin	ikɑmetgɑhɯɯn
ikrɑmlAr	ikrɑmler	ikrɑmlɑr
indirimDAn	indirimdɑn	indirimden
insɑnmHzA	insɑnmize	insɑnmɯzɑ
izlemADA	izlemede	izlemete
kɯsɯtlAr	kɯsɯtler	kɯsɯtlɑr
kɑlɯtɯmsAl	kɑlɯtɯmsel	kɑlɯtɯmsɑl
kɑlplArH	kɑlplɑrɯ	kɑlpleri
kɑmpɑnjɑmHz	kɑmpɑnjɑmiz	kɑmpɑnjɑmɯz
kɑrʃɯlAAbilmA	kɑrʃɯlɑɑbilmɑ	kɑrʃɯlɑɑbilme
kɑrʃɯmHzDAki	kɑrʃɯmɯzdeki	kɑrʃɯmɯzdɑki
kɑtkɯlArnHzH	kɑtkɯlernizi	kɑtkɯlɑrnɯzɯ
kɑjbetmAH	kɑjbetmɑɯ	kɑjbetmei
kɑzɑnAbilmA	kɑzɑnɑbilmɑ	kɑzɑnɑbilme
kolesterolHn	kolesterolin	kolesterolyn
konferɑnslArA	konferɑnslere	konferɑnslɑrɑ
korkmADAn	korkmeden	korkmɑdɑn
krɑllAr	krɑller	krɑllɑr
kuruDHkDAn	kurudiktɑn	kuruduktɑn
kutuDAn	kututɑn	kutudɑn
kutulArDA	kutulɑrde	kutulɑrdɑ
limɑnlArH	limɑnleri	limɑnlɑrɯ
linkA	linkɑ	linke
merdivenlArDAn	merdivenlɑrden	merdivenlerden
mesɑʒDA	mesɑʒde	mesɑʒdɑ
modlArH	modleri	modlɑrɯ
molekylHn	molekylin	molekylyn
okullArmHz	okullermiz	okullɑrmɯz
okulmHzH	okulmizi	okulmuzu
oluʃumlArA	oluʃumlere	oluʃumlɑrɑ
oluklAr	olukler	oluklɑr
onɑrɯmlArH	onɑrɯmleri	onɑrɯmlɑrɯ
ormɑnlArDA	ormɑnlɑrde	ormɑnlɑrdɑ
oruʧlArHHn	oruʧleriin	oruʧlɑrɯɯn
pɑtentDAn	pɑtenttɑn	pɑtentten
plɑkɑlH	plɑkɑli	plɑkɑlɯ
progrɑmnHz	progrɑmniz	progrɑmnɯz
rɑhɑtA	rɑhɑte	rɑhɑtɑ
rɑkɑmlH	rɑkɑmli	rɑkɑmlɯ
syrgylH	syrgyli	syrgyly
sytDAn	syttɑn	sytten
sɑbunlH	sɑbunli	sɑbunlu
sɑnɯklArH	sɑnɯkleri	sɑnɯklɑrɯ
sɑnɑtʧHlArHHn	sɑnɑtʧileriin	sɑnɑtʧɯlɑrɯɯn
sɑvʤɯHHn	sɑvʤɯiin	sɑvʤɯɯɯn
serɑlArDA	serɑlɑrde	serɑlɑrdɑ
sevmAAn	sevmɑɑn	sevmeen
stoklArA	stoklere	stoklɑrɑ
tɯrnɑklArH	tɯrnɑkleri	tɯrnɑklɑrɯ
tɑtlAr	tɑtler	tɑtlɑr
teʃekkyrH	teʃekkyri	teʃekkyry
terʤihA	terʤihɑ	terʤihe
tolerɑnsH	tolerɑnsu	tolerɑnsɯ
toplɑmlArHHn	toplɑmleriin	toplɑmlɑrɯɯn
turmHz	turmiz	turmuz
tutɑrDA	tutɑrde	tutɑrdɑ
ulusmHzHn	ulusmizin	ulusmuzun
verimA	verimɑ	verime
jyklAmAA	jyklɑmɑɑ	jyklemee
jyksekDAn	jyksektɑn	jyksekten
jyryHp	jyryip	jyryyp
jyzjɯllArDAn	jyzjɯllerden	jyzjɯllɑrdɑn
jɑɰlArDAn	jɑɰlɑrden	jɑɰlɑrdɑn
jɑpDHklArmHzH	jɑpdiklermizi	jɑptɯklɑrmɯzɯ
jɑsɑlArDAn	jɑsɑlɑrden	jɑsɑlɑrdɑn
jɑtmA	jɑtme	jɑtmɑ
jɑzAlHm	jɑzelim	jɑzɑlɯm
jenmA	jenmɑ	jenme
jerleʃArAk	jerleʃɑrɑk	jerleʃerek
jerjyzynH	jerjyzyni	jerjyzyny
jetiʃmA	jetiʃmɑ	jetiʃme
jolsuzlHklArH	jolsuzlɯkleri	jolsuzluklɑrɯ
jolsuzlHklArA	jolsuzlɯklere	jolsuzluklɑrɑ
jurtlArA	jurtlere	jurtlɑrɑ
ʧɑdɯrlArH	ʧɑdɯrleri	ʧɑdɯrlɑrɯ
ʧɑlɯʃmAnHzH	ʧɑlɯʃmɑnizi	ʧɑlɯʃmɑnɯzɯ
øɰrenmADA	øɰrenmɑdɑ	øɰrenmede
øɰretimDAki	øɰretimdɑki	øɰretimdeki
ønemDA	ønemdɑ	ønemde
ʃɑrkɯlArHn	ʃɑrkɯlerin	ʃɑrkɯlɑrɯn
ɑʧɯklɑmAlArHHn	ɑʧɯklɑmeleriin	ɑʧɯklɑmɑlɑrɯɯn
ɑɰɑʧlArA	ɑɰɑʧlere	ɑɰɑʧlɑrɑ
ɑksɑtmADAn	ɑksɑtmeden	ɑksɑtmɑdɑn
ɑlɯmlArDA	ɑlɯmlerde	ɑlɯmlɑrdɑ
ɑlmAnHzA	ɑlmɑnize	ɑlmɑnɯzɑ
ɑrkɑdɑʃlHklAr	ɑrkɑdɑʃlikler	ɑrkɑdɑʃlɯklɑr
ɑskerlHkDAn	ɑskerliktɑn	ɑskerlikten
bølymmHzA	bølymmize	bølymmyze
bɑʃɑrɯlArnHzHn	bɑʃɑrɯlernizin	bɑʃɑrɯlɑrnɯzɯn
bɑkmAmHz	bɑkmemiz	bɑkmɑmɯz
bɑnkɑDAki	bɑnkɑteki	bɑnkɑdɑki
bilgisɑjɑrnHzDAn	bilgisɑjɑrnizdɑn	bilgisɑjɑrnɯzdɑn
bilmAnHzH	bilmɑnizi	bilmenizi
bilmAArAk	bilmɑɑrɑk	bilmeerek
binɑmHzHn	binɑmizin	binɑmɯzɯn
bulHʃlArH	buliʃleri	buluʃlɑrɯ
bulHʃlArHn	buliʃlerin	buluʃlɑrɯn
ʤiltDAn	ʤilttɑn	ʤiltten
dyʃynAbiljor	dyʃynɑbiljor	dyʃynebiljor
deɰiʃiklHkDAn	deɰiʃiklɯktɑn	deɰiʃiklikten
demirbɑʃlAr	demirbɑʃler	demirbɑʃlɑr
denetimDA	denetimdɑ	denetimde
depresjonA	depresjone	depresjonɑ
desteklAnArAk	desteklɑnɑrɑk	desteklenerek
dikkɑtsHzlHk	dikkɑtsizlɯk	dikkɑtsizlik
dinlArA	dinlɑrɑ	dinlere
eʃgydymH	eʃgydymi	eʃgydymy
eʃjɑlArDAn	eʃjɑlɑrden	eʃjɑlɑrdɑn
eklemDA	eklemdɑ	eklemde
elekDAn	elektɑn	elekten
etmAAlHm	etmɑɑlim	etmeelim
etrɑfDAki	etrɑfteki	etrɑftɑki
fidɑnlArHn	fidɑnlerin	fidɑnlɑrɯn
figyrH	figyri	figyry
fiilDAn	fiiltɑn	fiilden
filmDAn	filmdɑn	filmden
filozoflArHn	filozoflerin	filozoflɑrɯn
firmɑmHzDA	firmɑmizde	firmɑmɯzdɑ
formlH	formli	formlu
gyllHk	gyllik	gyllyk
gɑlvɑnizlH	gɑlvɑnizlɯ	gɑlvɑnizli
geʧirmAAn	geʧirmɑɑn	geʧirmeen
gebelHkDAn	gebeliktɑn	gebelikten
gelAbilmA	gelebilmɑ	gelebilme
getirDHkDAn	getirdiktɑn	getirdikten
golH	goli	goly
hɑklArmHzH	hɑklermizi	hɑklɑrmɯzɯ
hɑmilHnA	hɑmilinɑ	hɑmiline
iʃlAnmA	iʃlɑnmɑ	iʃlenme
imtijɑzlAr	imtijɑzler	imtijɑzlɑr
insɑnmHzH	insɑnmizi	insɑnmɯzɯ
ishɑlA	ishɑlɑ	ishɑle
islAnmAH	islɑnmɑɯ	islenmei
ittifɑkH	ittifɑki	ittifɑkɯ
kɯlɯfH	kɯlɯfi	kɯlɯfɯ
kørH	køri	køry
kyltyrmHzA	kyltyrmize	kyltyrmyze
kyresAllAʃmAA	kyreselleʃmɑɑ	kyreselleʃmee
kɑlDHkʧA	kɑltɯkʧɑ	kɑldɯkʧɑ
kɑmpɑnjɑDAn	kɑmpɑnjɑtɑn	kɑmpɑnjɑdɑn
kɑpɯlArHHn	kɑpɯleriin	kɑpɯlɑrɯɯn
kɑrbonlH	kɑrbonli	kɑrbonlu
kɑrtmH	kɑrtmi	kɑrtmɯ
kɑtɯlmADAn	kɑtɯlmɑdɑn	kɑtɯlmɑtɑn
kɑjnɑklArmHz	kɑjnɑklermiz	kɑjnɑklɑrmɯz
kɑzɑlArDAn	kɑzɑlɑrden	kɑzɑlɑrdɑn
kesilDHkDAn	kesiltiktɑn	kesildikten
kesimDAki	kesimdɑki	kesimdeki
klɑvjeDAki	klɑvjeteki	klɑvjedeki
koʃulHHn	koʃuliin	koʃuluun
konuʃAlHm	konuʃɑlim	konuʃɑlɯm
konumlH	konumli	konumlu
kullɑnɯmlArDA	kullɑnɯmlerde	kullɑnɯmlɑrdɑ
kuruluʃnHzHn	kuruluʃnizin	kuruluʃnuzun
lyksH	lyksi	lyksy
mɑkroH	mɑkroi	mɑkrou
merɑklHH	merɑklii	merɑklɯɯ
meslektɑʃlArH	meslektɑʃleri	meslektɑʃlɑrɯ
mutsuzlHk	mutsuzlɯk	mutsuzluk
nesilDAn	nesiltɑn	nesilden
noksɑnlHklAr	noksɑnlikler	noksɑnlɯklɑr
normH	normi	normu
ordumHz	ordumiz	ordumuz
orgɑnlArDAn	orgɑnlɑrden	orgɑnlɑrdɑn
ojnɑDHklArH	ojnɑtɯkleri	ojnɑdɯklɑrɯ
perspektifDAn	perspektiftɑn	perspektiften
plɑstikDAn	plɑstiktɑn	plɑstikten
prensH	prensu	prensi
røportɑʒlAr	røportɑʒler	røportɑʒlɑr
ryzgɑrlArHn	ryzgɑrlerin	ryzgɑrlɑrɯn
ressɑmlArHn	ressɑmlerin	ressɑmlɑrɯn
restorɑnlArDA	restorɑnlɑrde	restorɑnlɑrdɑ
sɯrlH	sɯrli	sɯrlɯ
søjleʃiDA	søjleʃite	søjleʃide
søjlemADA	søjlemede	søjlemete
søzlArmA	søzlermɑ	søzlerme
sɑʧlArHn	sɑʧlerin	sɑʧlɑrɯn
sɑlonlArDA	sɑlonlɑrde	sɑlonlɑrdɑ
sektørmHzDA	sektørmizde	sektørmyzde
sorulArnHzA	sorulɑrnize	sorulɑrnɯzɑ
stɑʒlArH	stɑʒleri	stɑʒlɑrɯ
subɑjlArH	subɑjleri	subɑjlɑrɯ
tɑkiplArH	tɑkiplɑrɯ	tɑkipleri
tɑkipDA	tɑkiptɑ	tɑkipte
tɑnɯmlArA	tɑnɯmlere	tɑnɯmlɑrɑ
tɑvuklAr	tɑvukler	tɑvuklɑr
toklHk	toklɯk	tokluk
torunlArH	torunleri	torunlɑrɯ
uʧHʃA	uʧiʃe	uʧuʃɑ
ulɑʃmADA	ulɑʃmɑdɑ	ulɑʃmɑtɑ
unutmADAn	unutmeden	unutmɑdɑn
urHn	urin	urun
ujuʃturuʤuA	ujuʃturuʤue	ujuʃturuʤuɑ
vidɑlH	vidɑli	vidɑlɯ
jɯkɑHp	jɯkɑup	jɯkɑɯp
jyzmH	jyzmi	jyzmy
jyzjɯllArHn	jyzjɯllerin	jyzjɯllɑrɯn
jyzjɯllArA	jyzjɯllere	jyzjɯllɑrɑ
jɑʃɑDHkʧA	jɑʃɑtɯkʧɑ	jɑʃɑdɯkʧɑ
jɑʃɑmAlArH	jɑʃɑmeleri	jɑʃɑmɑlɑrɯ
jɑʃlArA	jɑʃlere	jɑʃlɑrɑ
jɑpɯtlArHn	jɑpɯtlerin	jɑpɯtlɑrɯn
jɑzɑrlArDAn	jɑzɑrlɑrden	jɑzɑrlɑrdɑn
jerleʃmA	jerleʃmɑ	jerleʃme
zɑmlArH	zɑmleri	zɑmlɑrɯ
zɑjɯflAmHʃ	zɑjɯflemiʃ	zɑjɯflɑmɯʃ
ʧɯkHʃA	ʧɯkiʃe	ʧɯkɯʃɑ
ʧɑdɯrDA	ʧɑdɯrde	ʧɑdɯrdɑ
ʧiftlAʃmA	ʧiftleʃmɑ	ʧiftleʃme
ɯrkH	ɯrki	ɯrkɯ
ølymlH	ølymli	ølymly
ønermA	ønermɑ	ønerme
ørgytlAnmAlAr	ørgytlɑnmɑlɑr	ørgytlenmeler
ørgytlAnmAHn	ørgytlɑnmɑɯn	ørgytlenmein
ʃykrɑnlArmHzH	ʃykrɑnlɑrmizi	ʃykrɑnlɑrmɯzɯ
ystlHk	ystlik	ystlyk
ɑʒɑnslArH	ɑʒɑnsleri	ɑʒɑnslɑrɯ
ɑldɑtmA	ɑldɑtme	ɑldɑtmɑ
ɑrɑziDAn	ɑrɑziten	ɑrɑziden
ɑrkɑdɑʃlArmHzDAn	ɑrkɑdɑʃlermizdɑn	ɑrkɑdɑʃlɑrmɯzdɑn
ɑrmɑtyrlAr	ɑrmɑtyrlɑr	ɑrmɑtyrler
ɑstɯmlH	ɑstɯmli	ɑstɯmlɯ
ɑtɯlHp	ɑtɯlup	ɑtɯlɯp
ɑtlArHn	ɑtlerin	ɑtlɑrɯn
ɑtmADAn	ɑtmeden	ɑtmɑdɑn
bytynlAʃmAHn	bytynlɑʃmɑɯn	bytynleʃmein
bɑkɯmlArDAn	bɑkɯmlerden	bɑkɯmlɑrdɑn
bɑkmADA	bɑkmede	bɑkmɑtɑ
bɑlH	bɑli	bɑlɯ
bɑsɯnʧlArH	bɑsɯnʧleri	bɑsɯnʧlɑrɯ
bɑsDHkDAn	bɑstiktɑn	bɑstɯktɑn
bertɑrɑfH	bertɑrɑfi	bertɑrɑfɯ
bilimDAn	bilimdɑn	bilimden
ʤɑmiɑHHn	ʤɑmiɑiin	ʤɑmiɑɯɯn
dɯʃmHzDA	dɯʃmizde	dɯʃmɯzdɑ
dyʃynHnʤA	dyʃyninʤe	dyʃynynʤe
dykkɑnlArDA	dykkɑnlɑrde	dykkɑnlɑrdɑ
dynjɑmHzH	dynjɑmizi	dynjɑmɯzɯ
deɰerlendirmAlArA	deɰerlendirmɑlɑrɑ	deɰerlendirmelere
depoDA	depode	depodɑ
dermA	dermɑ	derme
doktorlArA	doktorlere	doktorlɑrɑ
dostA	doste	dostɑ
durummHz	durummiz	durummuz
eklAnmA	eklɑnmɑ	eklenme
elemɑnlArDAn	elemɑnlɑrden	elemɑnlɑrdɑn
evrenDAki	evrenteki	evrendeki
fɯrɯnlArDA	fɯrɯnlɑrde	fɯrɯnlɑrdɑ
fɑkslAr	fɑksler	fɑkslɑr
fɑjlArHn	fɑjlerin	fɑjlɑrɯn
fontlAr	fontler	fontlɑr
gønyllHlArHn	gønyllilerin	gønyllylerin
gyʧlAnArAk	gyʧlɑnɑrɑk	gyʧlenerek
geliʃmAlArDA	geliʃmɑlɑrde	geliʃmelerde
gelinA	gelinɑ	geline
getirmADAn	getirmɑdɑn	getirmeden
hɯrslH	hɯrsli	hɯrslɯ
hykymlHlArA	hykymlilere	hykymlylere
hɑnɯmlArH	hɑnɯmleri	hɑnɯmlɑrɯ
hɑsɑrlArHn	hɑsɑrlerin	hɑsɑrlɑrɯn
hɑvuzlArDA	hɑvuzlerde	hɑvuzlɑrdɑ
hɑzɯrlAmADA	hɑzɯrlɑmɑdɑ	hɑzɯrlɑmɑtɑ
hissetmAH	hissetmɑɯ	hissetmei
hormonlArHHn	hormonleriin	hormonlɑrɯɯn
iʧerikDA	iʧeriktɑ	iʧerikte
iʧnHzDAn	iʧnizdɑn	iʧnizden
iʃmA	iʃmɑ	iʃme
iʃverenDAn	iʃverendɑn	iʃverenden
ispɑtlAmHʃ	ispɑtlemiʃ	ispɑtlɑmɯʃ
ijilAʃmAA	ijileʃmɑɑ	ijileʃmee
kɑjɯpsHz	kɑjɯpsiz	kɑjɯpsɯz
kɑzɑnDHkDAn	kɑzɑndiktɑn	kɑzɑndɯktɑn
kɑzɑnmADA	kɑzɑnmɑdɑ	kɑzɑnmɑtɑ
kentlAʃmAHn	kentleʃmɑɯn	kentleʃmein
koɰuʃDA	koɰuʃte	koɰuʃtɑ
kurmAnHz	kurmɑniz	kurmɑnɯz
kurHʤHnHn	kuruʤɯnɯn	kuruʤunun
kurumnHzHn	kurumnizin	kurumnuzun
liberɑllAʃmA	liberɑlleʃmɑ	liberɑlleʃme
mɑkbuzlArHHn	mɑkbuzleriin	mɑkbuzlɑrɯɯn
mɑntɑrlArHn	mɑntɑrlerin	mɑntɑrlɑrɯn
mezɑrlHklAr	mezɑrlikler	mezɑrlɯklɑr
mimɑrlArA	mimɑrlere	mimɑrlɑrɑ
mirɑsʧH	mirɑsʧi	mirɑsʧɯ
mirɑsʧHlAr	mirɑsʧiler	mirɑsʧɯlɑr
monitørH	monitøri	monitøry
muhtɑrlArH	muhtɑrleri	muhtɑrlɑrɯ
mutlulHkDAn	mutluliktɑn	mutluluktɑn
normlH	normli	normlu
okurlArmHzHn	okurlermizin	okurlɑrmɯzɯn
okurH	okuri	okuru
olmAmH	olmemi	olmɑmɯ
ortɑmlArDAn	ortɑmlerden	ortɑmlɑrdɑn
pɑrknA	pɑrkne	pɑrknɑ
pɑtronlArH	pɑtronleri	pɑtronlɑrɯ
petrolA	petrolɑ	petrole
pistDA	pisttɑ	pistte
plɑnlArDA	plɑnlɑrde	plɑnlɑrdɑ
polisDAn	polistɑn	polisten
rɑporDAki	rɑporteki	rɑpordɑki
refɑhHn	refɑhin	refɑhɯn
sɯʧAn	sɯʧen	sɯʧɑn
syrgynDA	syrgyndɑ	syrgynde
sɑrɯmsH	sɑrɯmsi	sɑrɯmsɯ
sɑjdɑmlHk	sɑjdɑmlik	sɑjdɑmlɯk
seʧmADA	seʧmede	seʧmete
semptomH	semptomi	semptomu
semtH	semtɯ	semti
semtDA	semttɑ	semtte
sejretmAA	sejretmɑɑ	sejretmee
siʤilDAn	siʤiltɑn	siʤilden
slɑjtlAr	slɑjtler	slɑjtlɑr
spektrumlH	spektrumli	spektrumlu
sporlArHHn	sporleriin	sporlɑrɯɯn
suʧHHn	suʧiin	suʧuun
tykenmA	tykenmɑ	tykenme
tytynDAn	tytyndɑn	tytynden
tɑbɑkɑDAn	tɑbɑkɑtɑn	tɑbɑkɑdɑn
tɑlimɑtlArA	tɑlimɑtlere	tɑlimɑtlɑrɑ
tɑsɑrɯmlArHHn	tɑsɑrɯmleriin	tɑsɑrɯmlɑrɯɯn
tɑsɑrɯmlArDA	tɑsɑrɯmlerde	tɑsɑrɯmlɑrdɑ
tɑsɑrruflArHn	tɑsɑrruflerin	tɑsɑrruflɑrɯn
tɑtmA	tɑtme	tɑtmɑ
tebligɑtA	tebligɑte	tebligɑtɑ
tekellAʃmA	tekelleʃmɑ	tekelleʃme
temɑslArH	temɑsleri	temɑslɑrɯ
temelnDAki	temelnteki	temelndeki
teminɑtHHn	teminɑtiin	teminɑtɯɯn
testDAn	testtɑn	testten
tolerɑnslH	tolerɑnsli	tolerɑnslɯ
toprɑkDAki	toprɑkteki	toprɑktɑki
trɑvmɑlH	trɑvmɑli	trɑvmɑlɯ
tuʃlArHn	tuʃlerin	tuʃlɑrɯn
ujgulɑHʤHH	ujgulɑɯʤii	ujgulɑɯʤɯɯ
vermAA	vermɑɑ	vermee
jønetmenlHk	jønetmenlɯk	jønetmenlik
jɑʃlHlArH	jɑʃlileri	jɑʃlɯlɑrɯ
jɑkɯtHn	jɑkɯtin	jɑkɯtɯn
jɑmɑʧlArH	jɑmɑʧleri	jɑmɑʧlɑrɯ
jɑrdɯmlArDA	jɑrdɯmlerde	jɑrdɯmlɑrdɑ
jɑjɯnlArmHz	jɑjɯnlɑrmiz	jɑjɯnlɑrmɯz
jɑzɑrlH	jɑzɑrli	jɑzɑrlɯ
jenmAH	jenmɑɯ	jenmei
jetersizlHklAr	jetersizlɯkler	jetersizlikler
jollAnAn	jollenen	jollɑnɑn
jorumlArnHzH	jorumlernizi	jorumlɑrnɯzɯ
zɑjɯflAr	zɑjɯfler	zɑjɯflɑr
zehirlAnmAlAr	zehirlɑnmɑlɑr	zehirlenmeler
ʧɯkɑrlArHn	ʧɯkɑrlerin	ʧɯkɑrlɑrɯn
ʧɑjlArH	ʧɑjleri	ʧɑjlɑrɯ
ʧekAbilmA	ʧekɑbilmɑ	ʧekebilme
ʧevremDA	ʧevremdɑ	ʧevremde
ʧevremDAki	ʧevremdɑki	ʧevremdeki
ʧukurlArA	ʧukurlere	ʧukurlɑrɑ
ølʧysHz	ølʧysiz	ølʧysyz
ʃɑrtHn	ʃɑrtin	ʃɑrtɯn
ʃekilDAn	ʃekiltɑn	ʃekilden
ynHn	ynin	ynyn
ystmHzA	ystmize	ystmyze
ɑdɑmlArHn	ɑdɑmlerin	ɑdɑmlɑrɯn
ɑdetDAn	ɑdettɑn	ɑdetten
ɑlɯmlAr	ɑlɯmler	ɑlɯmlɑr
ɑlɯnHnʤA	ɑlɯnɯnʤe	ɑlɯnɯnʤɑ
ɑldɑtHʤH	ɑldɑtiʤi	ɑldɑtɯʤɯ
ɑmɑtørlHk	ɑmɑtørlik	ɑmɑtørlyk
ɑmbɑlɑʒlArDA	ɑmbɑlɑʒlerde	ɑmbɑlɑʒlɑrdɑ
ɑmbɑrlH	ɑmbɑrli	ɑmbɑrlɯ
ɑnlɑjɯʃlAr	ɑnlɑjɯʃler	ɑnlɑjɯʃlɑr
ɑsistɑnlArHn	ɑsistɑnlerin	ɑsistɑnlɑrɯn
ɑtHʤH	ɑtiʤi	ɑtɯʤɯ
byjytAn	byjytɑn	byjyten
bɑlɯklArDA	bɑlɯklerde	bɑlɯklɑrdɑ
bɑrDA	bɑrde	bɑrdɑ
bɑroHHn	bɑroiin	bɑrouun
bɑsɑmɑklAr	bɑsɑmɑkler	bɑsɑmɑklɑr
binArAk	binɑrɑk	binerek
bordroDA	bordrode	bordrodɑ
borsɑlArDA	borsɑlɑrde	borsɑlɑrdɑ
ʤyzdɑnlArH	ʤyzdɑnleri	ʤyzdɑnlɑrɯ
ʤivɑrDA	ʤivɑrde	ʤivɑrdɑ
dyzenlemADA	dyzenlemede	dyzenlemete
dɑɰɯtArAk	dɑɰɯterek	dɑɰɯtɑrɑk
dɑlDAn	dɑltɑn	dɑldɑn
dɑllArA	dɑllere	dɑllɑrɑ
dɑmɑrlArDAn	dɑmɑrlɑrden	dɑmɑrlɑrdɑn
dɑnslAr	dɑnsler	dɑnslɑr
depoHHn	depoiin	depouun
dinlAHʤHlArHn	dinlɑɯʤilerin	dinleiʤilerin
direnmA	direnmɑ	direnme
dijɑloglAr	dijɑlogler	dijɑloglɑr
doɰDHkDAn	doɰdiktɑn	doɰduktɑn
dozHHn	doziin	dozuun
durmADA	durmɑdɑ	durmɑtɑ
durumDAken	durumdeken	durumdɑken
durumnHzH	durumnizi	durumnuzu
dujgulArmHzH	dujgulɑrmizi	dujgulɑrmɯzɯ
ertesinDA	ertesindɑ	ertesinde
esirgemAAn	esirgemɑɑn	esirgemeen
esnɑflAr	esnɑfler	esnɑflɑr
etkilAnmADAn	etkilɑnmɑdɑn	etkilenmeden
etkinlHkDAn	etkinlɯktɑn	etkinlikten
festivɑlA	festivɑlɑ	festivɑle
filozoflAr	filozofler	filozoflɑr
firmɑlArmHzHn	firmɑlɑrmizin	firmɑlɑrmɯzɯn
fijɑtlArmHz	fijɑtlermiz	fijɑtlɑrmɯz
fonksijonA	fonksijone	fonksijonɑ
gɯdɑlArDAn	gɯdɑlɑrden	gɯdɑlɑrdɑn
gørynymHn	gørynymin	gørynymyn
gøryntyHHn	gøryntyiin	gøryntyyyn
gøzlArmA	gøzlermɑ	gøzlerme
gylymseAn	gylymseɑn	gylymseen
gymrykDAn	gymryktɑn	gymrykten
geʧAbilmA	geʧebilmɑ	geʧebilme
geʧAbilmAH	geʧebilmɑɯ	geʧebilmei
geʤikmAHn	geʤikmɑɯn	geʤikmein
gerekAnHn	gerekɑnɯn	gerekenin
grɑmlHk	grɑmlik	grɑmlɯk
hɑfiflHk	hɑfiflɯk	hɑfiflik
hɑritɑlArDA	hɑritɑlɑrde	hɑritɑlɑrdɑ
hɑstɑmHz	hɑstɑmiz	hɑstɑmɯz
hɑvuzHHn	hɑvuziin	hɑvuzuun
huzurlArnHzDA	huzurlernizde	huzurlɑrnɯzdɑ
iʧmHzDAn	iʧmizdɑn	iʧmizden
iʧlAr	iʧlɑr	iʧler
iddiɑHHn	iddiɑiin	iddiɑɯɯn
ihrɑʤɑtʧHA	ihrɑʤɑtʧie	ihrɑʤɑtʧɯɑ
ihtijɑtlH	ihtijɑtli	ihtijɑtlɯ
inmAH	inmɑɯ	inmei
istɑsjonlArHn	istɑsjonlerin	istɑsjonlɑrɯn
itibɑrlH	itibɑrli	itibɑrlɯ
kɯvrɯmlH	kɯvrɯmli	kɯvrɯmlɯ
kɑbullAnmA	kɑbullɑnmɑ	kɑbullenme
kɑlpDAn	kɑlptɑn	kɑlpten
kɑosA	kɑose	kɑosɑ
kɑtegoriDAki	kɑtegoriteki	kɑtegorideki
kenɑrlArA	kenɑrlere	kenɑrlɑrɑ
klimɑlH	klimɑli	klimɑlɯ
kodlArHHn	kodleriin	kodlɑrɯɯn
kombinɑsjonlArH	kombinɑsjonleri	kombinɑsjonlɑrɯ
konuʃmAlArHHn	konuʃmeleriin	konuʃmɑlɑrɯɯn
korumADA	korumɑdɑ	korumɑtɑ
kriterlArDAn	kriterlɑrden	kriterlerden
kuʃɑklArH	kuʃɑkleri	kuʃɑklɑrɯ
kurAʤAklArH	kurɑʤɑkleri	kurɑʤɑklɑrɯ
myzisjenlAr	myzisjenlɑr	myzisjenler
mɑʧlArDA	mɑʧlɑrde	mɑʧlɑrdɑ
mɑɰɑzɑlArDAn	mɑɰɑzɑlɑrden	mɑɰɑzɑlɑrdɑn
mɑkbuzA	mɑkbuze	mɑkbuzɑ
mektuplArHn	mektuplerin	mektuplɑrɯn
metotlArHHn	metotleriin	metotlɑrɯɯn
odɑklAr	odɑkler	odɑklɑr
oklArH	okleri	oklɑrɯ
okurjɑzɑrlHk	okurjɑzɑrlik	okurjɑzɑrlɯk
olmAnHzA	olmɑnize	olmɑnɯzɑ
onlH	onli	onlu
otlArHn	otlerin	otlɑrɯn
ovɑHHn	ovɑiin	ovɑɯɯn
rɑjlAr	rɑjler	rɑjlɑr
romɑnlArH	romɑnleri	romɑnlɑrɯ
søzmH	søzmi	søzmy
sɑldɯrɯlArHHn	sɑldɯrɯleriin	sɑldɯrɯlɑrɯɯn
sɑntrɑllArHHn	sɑntrɑlleriin	sɑntrɑllɑrɯɯn
sɑjmHzHn	sɑjmizin	sɑjmɯzɯn
senɑrjoHn	senɑrjoin	senɑrjoun
senɑrjoH	senɑrjoi	senɑrjou
sendromHHn	sendromiin	sendromuun
senetDA	senettɑ	senette
sergilAnmAA	sergilɑnmɑɑ	sergilenmee
sevinʧDAn	sevinʧtɑn	sevinʧten
soruDAn	sorutɑn	sorudɑn
sorumlHlArHn	sorumlilerin	sorumlulɑrɯn
stɑndlAr	stɑndler	stɑndlɑr
tɯklADHkDAn	tɯkletiktɑn	tɯklɑdɯktɑn
tɑʃɯtHn	tɑʃɯtin	tɑʃɯtɯn
tɑblolArDAn	tɑblolɑrden	tɑblolɑrdɑn
tɑhminlArA	tɑhminlɑrɑ	tɑhminlere
tɑsɑrɯmlArA	tɑsɑrɯmlere	tɑsɑrɯmlɑrɑ
tɑzminɑtA	tɑzminɑte	tɑzminɑtɑ
telgrɑflAr	telgrɑfler	telgrɑflɑr
titreAn	titreɑn	titreen
tohumlArHn	tohumlerin	tohumlɑrɯn
tutɑnɑklArHHn	tutɑnɑkleriin	tutɑnɑklɑrɯɯn
uʧHʃlAr	uʧiʃler	uʧuʃlɑr
jyksekʧA	jyksekʧɑ	jyksekʧe
jyzjɯllHk	jyzjɯllik	jyzjɯllɯk
jɑkAlAAbilmA	jɑkɑlɑɑbilmɑ	jɑkɑlɑɑbilme
jɑrɯjɯllHk	jɑrɯjɯllik	jɑrɯjɯllɯk
jɑstɯklArH	jɑstɯkleri	jɑstɯklɑrɯ
jɑvɑʃlAmAH	jɑvɑʃlemei	jɑvɑʃlɑmɑɯ
jokuʃH	jokuʃɯ	jokuʃu
jolʤuluklArDA	jolʤuluklerde	jolʤuluklɑrdɑ
zeminDAn	zemindɑn	zeminden
